deftige	หรู
deftige	แฟนซี
vrot	เน่า
sts	sts
partytjies	ปาร์ตี้
deursigtig	โปร่งแสง
deursigtig	โปร่งใส
deursigtig	โปร่ง
deursigtig	โปร่งแสง
chabarofsk	khabarovsk
dok	หมอ
poskaart	โปสการ์ด
poskaart	ไปรษณียบัตร
gevries	frozen
gevries	อายัด
gevries	แข็ง
longman	longman
sage	เซจ
toegedraai	ห่อ
aandete	ดินเนอร์
lily	ลิลลี่
cool	เท่ห์
cool	เท่
cool	เจ๋ง
cool	เย็น
gfdl	gfdl
nan	แนน
nan	น่าน
druppel	วาง
druppel	หย่อน
druppel	หยด
druppel	ดรอป
regbank	ตุลาการ
aartappel	potato
kubus	ลูกบาศก์
epe	epe
batman	batman
middagete	เที่ยง
kappa	kappa
grafika	กราฟิก
dagestan	dagestan
pedersen	pedersen
camillo	camillo
kers	เทียน
kers	เทียนไข
skuiwe	moves
tartu	tartu
eustatius	eustatius
doch	doch
amen	สาธุ
amen	อาเมน
amen	เมน
saba	สะ
moctezuma	moctezuma
tech	เทค
tech	เทคโนโลยี
angkor	นคร
bussy	bussy
manu	มานู
manu	manu
gelling	แกลลอน
omgee	แคร์
omgee	สน
omgee	สนใจ
ost	ost
mississippian	mississippian
lavender	ลาเวนเดอร์
vasari	vasari
ilse	ilse
mioseen	miocene
seleukidiese	seleucid
cuba	คิวบา
eekhoring	กระรอก
teleostei	teleostei
sinus	ไซน์
kole	ถ่าน
kole	ถ่านหิน
higgins	higgins
duck	เป็ด
lexikon	lexikon
intervensie	แทรกแซง
neal	นีล
klier	ต่อม
landmerk	landmark
aandrywer	ไดรเวอร์
aandrywer	ไดรเวอร์
aandrywer	ไดรฟ์
aandrywer	ไดร์ฟ
africanum	africanum
warrior	นักรบ
arxiv	arxiv
wittgenstein	wittgenstein
vurk	ส้อม
dot	ดอท
dot	dot
dot	จุด
ridpath	ridpath
partytjie	พรรค
partytjie	ปาร์ตี้
phoenicurus	phoenicurus
milieu	milieu
biochemie	ชีวเคมี
sims	sims
pret	สนุก
pret	สนุกสนาน
pootjies	อุ้งเท้า
pootjies	อุ้งมือ
subfamilia	subfamilia
eggo	ก้อง
kleinletters	ลด
kleinletters	ต่ำ
kleinletters	ล่าง
rick	ริค
rick	ริก
bantoestan	มาตุภูมิ
aves	aves
tsjeljabinsk	chelyabinsk
fronte	fronte
ontlasting	อุจจาระ
iphoto	iphoto
dvorak	dvorak
tirion	tirion
pair	peerage
civitas	civitas
redgrave	redgrave
fußball	fußball
chef	เชฟ
strokiesverhaal	การ์ตูน
kontroleer	เช็ค
kontroleer	ตรวจ
jas	โค้ท
jas	ตรา
verslaaf	ติด
jona	jona
aande	ไนท์
aande	ค่ำคืน
aande	คืน
aande	ราตรี
moulin	moulin
soi	ซอย
ups	ups
royale	รอยัล
franciscus	franciscus
titlestyle	titlestyle
leidrade	ทิป
brussels	บรัสเซลส์
nach	nach
sianied	ไซยาไนด์
schelde	scheldt
rolverdeling	นำแสดง
wolfsburg	wolfsburg
kalenders	ปฏิทิน
fiji	ฟิจิ
bella	bella
zeit	zeit
feesvieringe	พรรค
feesvieringe	ปาร์ตี้
sensor	เซ็นเซอร์
uitgelig	แนะนำ
sakke	ถุง
sakke	กระเป๋า
neu	neu
ietermagog	manis
loopbane	อาชีพ
wewenaar	หม้าย
estado	estado
lowell	โลเวลล์
toegemaak	ปิด
snake	งู
menschen	menschen
abessiniese	abyssinian
polaris	polaris
mallorca	mallorca
xxx	xxx
sanssouci	sanssouci
kostroma	kostroma
etal	etal
genie	อัจฉริยะ
broad	กว้าง
heliopolis	heliopolis
hemde	เสื้อ
basketball	บาสเกตบอล
asturië	asturias
krasnojarsk	krasnoyarsk
zeitung	zeitung
leonidas	leonidas
labour	แรงงาน
labour	labour
ion	ไอออน
nocat	nocat
piesang	กล้วย
benaderde	ประมาณ
krasnodar	krasnodar
edu	edu
gerieflik	สะดวก
tug	ชัก
sabina	sabina
fatih	fatih
singapoerse	สิงคโปร์
silvestris	silvestris
klawer	คลับ
klawer	สโมสร
klawer	ดอกจิก
klawer	จิก
snaakse	ขัน
snaakse	ตลก
snaakse	ขำ
rwd	rwd
continental	ทวีป
mendelejef	mendeleev
kenyatta	kenyatta
produktief	ประสิทธิ์
overture	โหมโรง
spat	สาด
république	république
hina	hina
concord	คอร์ด
herbst	herbst
astrachan	astrakhan
fleurs	fleurs
bayern	bayern
webbediener	สำรอง
flow	ไหล
flow	กระแส
wulf	wulf
betrekkings	งาน
afspraak	นัด
hal	ฮาล
diagramme	ไดอะแกรม
tethys	tethys
prentjies	รูป
prentjies	แม่ค้า
ulm	ulm
plakkate	โปสเตอร์
brachiosaurus	brachiosaurus
doe	โด
doe	ใสๆ
ganges	คงคา
tunis	ตูนิส
günter	günter
mick	มิค
mick	มิก
ing	ing
berou	เสียใจ
berou	เสียดาย
waugh	waugh
burma	พม่า
dief	ขโมย
dief	โจร
reptilia	reptilia
skerpioene	แมงป่อง
vannes	vannes
nis	nis
losstaande	standalone
pcupdate	pcupdate
katrol	รอก
commune	คอมมูน
kêrel	แฟน
kemerowo	kemerovo
temp	ชั่วคราว
rupestris	rupestris
heroes	วีรบุรุษ
heroes	heroes
heroes	ฮีโร่
weiß	weiß
dane	เดนมาร์ก
eve	อีฟ
eve	eve
leila	ไลลา
pocock	pocock
orientales	orientales
maharashtra	maharashtra
mineur	mineur
drywer	ไดรเวอร์
android	android
subst	subst
gale	เกล
veroudering	ริ้ว
nette	ตาข่าย
hindernis	อุปสรรค
bokkie	เจี๊ยบ
bokkie	ลูกไก่
alfons	alfons
gek	โง่
gek	หลอก
relations	สัมพันธ์
soefisme	sufism
universität	universität
sjef	เชฟ
osnabrück	osnabrück
lip	ลิป
lip	lip
petite	petite
newa	newa
lan	ลาน
beiroet	เบรุต
neckar	neckar
verbande	แบน
gore	กอร์
roomys	ไอศกรีม
gordyne	ม่าน
gem	เฉลี่ย
gem	อัญมณี
whiskey	วิสกี้
prospero	prospero
demo	สาธิต
wuppertal	wuppertal
monza	monza
nyx	nyx
verbygaan	ผ่าน
yesno	yesno
thys	thys
sans	sans
pallidus	pallidus
bril	แว่น
bril	แว่นตา
bril	แก้ว
andrzej	andrzej
turf	ถิ่น
koninklijke	koninklijke
exhibition	นิทรรศการ
brønsted	brønsted
slapende	นอน
olav	olav
lepel	ช้อน
samevatting	สรุป
farmer	เกษตรกร
farmer	ชาวไร่
farmer	ชาวนา
nylon	nylon
nylon	ไนลอน
charlottenburg	charlottenburg
taxa	taxa
piekniek	ปิกนิก
xxi	xxi
sung	ซอง
sung	ซุง
luise	luise
amarna	amarna
dubai	dubai
dubai	ดูไบ
wta	wta
algol	algol
ruhr	ruhr
wageningen	wageningen
topkapi	topkapi
springfield	สปริงฟิลด์
khaled	khaled
higginbotham	higginbotham
foraminifera	foraminifera
roetine	กิจวัตร
eudicots	eudicots
skande	ละอาย
skande	เสียดาย
hael	ลูกเห็บ
borrels	ฟอง
piaget	piaget
worms	หนอน
aanslae	คะแนน
mishandel	สาว
mishandel	สาวๆ
caspar	caspar
prisma	prisma
kolmogorov	kolmogorov
bae	เบ
bae	เบเบ
bae	ที่รัก
bae	เบย์
bae	เบย
antineutrino	antineutrino
aanwys	ชี้
knaagdier	แทะ
passion	กิเลส
passion	ตัณหา
aethiopicus	aethiopicus
chirurg	ศัลยแพทย์
lccn	lccn
philippines	ฟิลิปปินส์
diewe	ขโมย
diewe	โจร
legacy	มรดก
pub	ผับ
toemaak	ปิด
toemaak	ใกล้
toemaak	ปก
toemaak	cover
toemaak	ปกปิด
geurige	เผ็ด
dophou	นาฬิกา
dophou	ชม
dophou	ดู
sharpe	sharpe
alleenloper	สันโดษ
bao	เปา
bao	bao
län	län
elwe	เอลฟ์
allgemeine	allgemeine
sich	sich
sigmaringen	sigmaringen
dff	dff
tnt	tnt
ronaldo	ronaldo
wenn	wenn
tru	ทรู
rho	โร
laurentius	laurentius
honneur	honneur
philosophie	philosophie
olympique	olympique
spoeg	คาย
rowers	ขโมย
rowers	โจร
zoid	zoid
afgewys	ปฏิเสธ
mel	เมล
sorbonne	sorbonne
forensiese	นิติ
forensiese	นิติกรรม
braking	เบรก
finch	ฟินช์
finch	ฟินซ์
brain	สมอง
rodium	rhodium
ferretti	ferretti
hdtv	hdtv
publicationdate	publicationdate
sind	sind
wir	wir
pavilion	ศาลา
brs	brs
beast	อสูร
beast	สู
mcleod	mcleod
staff	พนักงาน
oomblikke	moments
bloch	bloch
bms	bms
novas	novas
except	ยกเว้น
emmer	ถัง
hoes	ไอ
hoes	โสเภณี
ostia	ostia
dcs	dcs
luidsprekers	ลำโพง
nageregte	dessert
papillon	papillon
septimius	septimius
verwarrend	สับสน
rossini	rossini
bewonderaars	แฟนๆ
asean	อาเซียน
crane	เครน
verpletter	crush
verpletter	ปิ๊ง
verpletter	ขยี้
tam	tam
tam	แทม
accent	สำเนียง
worlds	โลก
wehrmacht	wehrmacht
wonderlik	เยี่ยม
wonderlik	วิเศษ
wonderlik	เยี่ยม
wonderlik	ยอด
palmas	palmas
abs	abs
gestremdheid	พิการ
suburbs	ชานเมือง
sum	ซำ
modes	fashion
modes	แฟชั่น
liggewig	เบา
brel	brel
rekeningkundige	บัญชี
dividend	ปันผล
koördinaat	ประสาน
anargie	อนาธิปไตย
suurlemoen	เลมอน
suurlemoen	มะนาว
chan	จัน
chan	ชาน
struggle	ดิ้นรน
getargs	getargs
bewapen	อาวุธ
hasselt	hasselt
nier	ไต
subpages	subpages
psigiatrie	จิตเวชศาสตร์
psigiatrie	เวชศาสตร์
général	général
polish	โปแลนด์
jekaterinburg	yekaterinburg
ard	ard
meteora	meteora
tres	tres
vojvodina	vojvodina
podium	แท่น
heupe	สะโพก
verneder	เขิน
verneder	อาย
viktoria	viktoria
thessaloniki	thessaloniki
urgell	urgell
wittenberg	wittenberg
fat	อ้วน
fat	อ้วนๆ
goose	ห่าน
ergaster	ergaster
lemoen	ส้ม
dateformat	dateformat
heat	ร้อน
greifswald	greifswald
nuuskierig	สงสัย
concat	concat
though	แม้ว่า
trudeau	trudeau
skyfies	สไลด์
handvatsel	รับมือ
handvatsel	จัดการ
steur	รบกวน
sonny	ซันนี่
opium	ฝิ่น
chirurgie	ศัลยกรรม
chirurgie	ผ่าตัด
rowe	rowe
józef	józef
henryk	henryk
api	api
arboretum	arboretum
blaai	แถว
knesset	knesset
fly	ฟลาย
fly	บิน
shuttleworth	shuttleworth
ratte	เกียร์
profesie	ศาสดา
hartjie	heart
hartjie	ใจ
hartjie	หัวใจ
hokkaido	ฮอกไกโด
morgen	morgen
fahrenheit	ฟาเรนไฮต์
tomsk	tomsk
vajrayana	vajrayana
internazionale	internazionale
domesticus	domesticus
slae	จังหวะ
slae	beats
passe	passe
swd	swd
birdlife	birdlife
colley	colley
agterstand	โจทก์
chembox	chembox
disleksie	dyslexia
gesorteer	สั่ง
unga	unga
sorge	ห่วง
djakarta	จาการ์ตา
subsp	subsp
bnp	bnp
deir	deir
gebraaide	ผัด
gebraaide	ทอด
striatus	striatus
mono	โมโน
mono	mono
rame	กรอบ
rame	เฟรม
elegans	elegans
libertas	libertas
nagklub	ไนต์คลับ
mosterd	มัสตาร์ด
machel	machel
rasionale	ตรรก
raiatea	raiatea
homme	homme
schule	schule
dart	โผ
valerius	valerius
skroewe	ใบพัด
pêrels	ไข่มุก
noël	noël
kussings	หมอน
rekeninge	บัญชี
leidraad	ใบ้
frost	ฟรอสท์
marburg	marburg
peterson	peterson
teatro	teatro
poor	คนจน
poor	ยากจน
apparate	gadgets
naked	เปลือย
eks	ภายนอก
agri	เกษตร
lieflike	หวานๆ
lieflike	หวาน
jaart	สนาม
jaart	ลาน
usgs	usgs
abba	abba
amber	อำพัน
vespucci	vespucci
danzig	danzig
pols	ชีพจร
gidse	โฟลเดอร์
gidse	ลวด
ondersteunde	สนับสนุน
fransen	fransen
pelvis	เชิงกราน
spit	คาย
singende	ร้อง
reggemaak	ตายตัว
reggemaak	ซ่อมแซม
nazis	นาซี
torvalds	torvalds
gebooie	บัญญัติ
albino	albino
til	จนถึง
parkering	จอด
naturalisme	naturalism
kimon	cimon
sensors	เซ็นเซอร์
vuurwerke	พลุ
fry	ทอด
mies	mies
brjansk	bryansk
verein	verein
ugc	ugc
sorbe	sorbs
lachaise	lachaise
kongolese	คองโก
tsjerkessië	cherkessia
latente	แฝง
outre	outre
fantasties	เยี่ยม
mikroverwerker	microprocessor
kabardino	kabardino
wologda	vologda
cowboy	คาวบอย
turku	turku
frigië	phrygia
lindbergh	lindbergh
eriksson	eriksson
blau	blau
bosnies	บอสเนีย
sept	กันยายน
sio	sio
bipm	bipm
vida	beef
ibsen	ibsen
ciconia	ciconia
prawda	pravda
aragón	aragón
chapel	โบสถ์
svenska	svenska
innemende	ต้อนรับ
rjazan	ryazan
taiwannese	ไต้หวัน
ind	ind
centrum	centrum
messenger	messenger
phase	เฟส
kay	เคย์
chase	เชด
chase	เชส
michele	michele
checktype	checktype
edessa	edessa
mellifera	mellifera
kanadees	แคนาดา
berlinale	berlinale
spyskaart	เมนู
slowake	slovaks
bonaventura	bonaventura
sonar	โซนาร์
sonar	โซนา
perpignan	perpignan
verbale	วาจา
tolk	เปลือก
tolk	เชลล์
utf	utf
moral	คุณธรรม
vriendskappe	มิตรภาพ
gabriele	gabriele
volmaak	กรอก
volmaak	เติม
rodrigues	rodrigues
masters	มาสเตอร์
knud	knud
siècle	siècle
kanji	จิ
beetle	ด้วง
superciliosus	superciliosus
caterina	caterina
maritimes	maritimes
wurm	หนอน
treasure	สมบัติ
hale	เฮล
ars	ars
svt	svt
holt	โฮลท์
holt	โฮล์ท
holt	โฮลต์
neanderthalensis	neanderthalensis
buch	buch
anz	anz
blow	เป่า
ferrand	ferrand
pectoralis	pectoralis
rosetta	rosetta
ole	ole
dai	นั้น
dai	ที่
dai	ว่า
dai	นั่น
fencing	ฟันดาบ
eerlike	ซื่อสัตย์
stokke	ไม้
fashion	fashion
fashion	แฟชั่น
sonderburg	sonderburg
oorloop	ล้น
boucher	boucher
gladys	gladys
floor	พื้น
plioseen	pliocene
arias	arias
uitgesit	ระงับ
takbokke	กวาง
schwarzenegger	schwarzenegger
ipa	ipa
boude	ก้น
boude	ตูด
seas	ทะเล
bediende	คนใช้
justus	justus
mental	จิต
vhs	vhs
edelstene	อัญมณี
stéphane	stéphane
kyi	kyi
esprit	esprit
clef	clef
seewier	สาหร่าย
eso	eso
nigra	nigra
hammer	ค้อน
nar	joker
nar	โจ๊ก
nar	nar
scene	ฉาก
stol	stol
ntupdate	ntupdate
phone	โทรศัพท์
wadi	wadi
tuinier	คนสวน
arch	อาร์ช
hank	แฮง
hank	แฮงค์
ruficollis	ruficollis
hcl	hcl
produce	ผลิต
kaartjie	ตั๋ว
kaartjie	ใบสั่ง
kaartjie	บัตร
skoen	รองเท้า
offenbach	offenbach
benn	benn
blaaier	เบราว์เซอร์
whitehall	ไวต์ฮอล
país	país
glasnost	glasnost
iapetus	iapetus
łódź	łódź
vitamiene	วิตามิน
impact	impact
kerry	kerry
paleoseen	paleocene
fsv	fsv
speyer	speyer
inlig	แจ้ง
leith	ลีต
leith	ลีท
leith	ลีธ
ira	ira
karabakh	karabakh
plutonium	พลูโทเนียม
eos	eos
skuilname	มัก
skuilname	เสมอ
skuilname	ตลอด
skuilname	นามแฝง
hansa	hansa
cassino	cassino
kahn	คาห์น
pernambuco	pernambuco
korrupte	ทุจริต
korrupte	คอรัปชั่น
maclean	maclean
aung	ออง
spieëlbeeld	กระจกเงา
spieëlbeeld	กระจก
kew	kew
meningspeiling	โพล
meningspeiling	โพลล์
proteus	proteus
waffen	waffen
pakkie	แพ็คเกจ
demonstrasies	สาธิต
demonstrasies	demos
oïl	oïl
plants	พืช
cock	จู๋
pamphilj	pamphilj
tsg	tsg
echo	ก้อง
echo	echo
ballets	ballets
lgbt	lgbt
madagascariensis	madagascariensis
reuters	reuters
glücksburg	glücksburg
addo	addo
stress	ความเครียด
stress	เครียด
skaduwees	เงามืด
skaduwees	เงา
sula	sula
buckinghamshire	buckinghamshire
passief	passive
geduldig	คนไข้
geduldig	อดทน
deursigtigheid	สี
deursigtigheid	สีสัน
deursigtigheid	โปร่งแสง
deursigtigheid	โปร่งใส
aroma	หอม
pit	หลุม
pit	บ่อ
parnassos	parnassus
mandeville	mandeville
regstelling	แก้
astra	astra
busch	busch
breslau	breslau
kwynende	น้อยใจ
beatrix	beatrix
alanië	alania
tigers	เสือ
mérida	mérida
perestroika	perestroika
leesbaarheid	readability
harp	ฮาร์ป
harp	พิณ
bean	ถั่ว
puy	puy
passant	passant
pringle	pringle
ois	ois
balkarië	balkaria
vlinders	ผีเสื้อ
sneller	ไก
passau	passau
tested	ทดสอบ
gesinchroniseerde	ซิงค์
wade	เวด
skootrekenaars	แล็ปท็อป
pawel	pawel
ongemaklik	อึดอัด
peoples	ชนชาติ
kwagga	quagga
legion	légion
sens	sens
bourke	bourke
cyprus	ไซปรัส
wallenstein	wallenstein
tbl	tbl
sambo	sambo
boerjatië	buryatia
merker	แท็ก
parthiese	parthian
vleiland	wetland
poppe	ตุ๊กตา
timon	timon
bygeloof	ไสยศาสตร์
parfuum	น้ำหอม
voorskou	ตัวอย่าง
moe	โม
moe	moe
quam	quam
verkenningstuig	orbiter
ontwyk	เลี่ยง
kostuum	ชุด
singing	ร้อง
guichard	guichard
bra	บรา
sonneblom	ทานตะวัน
vuis	ถุง
schönberg	schönberg
begum	begum
triumph	triumph
hybrid	ลูกผสม
rsfsr	rsfsr
cerro	cerro
psigiater	จิตแพทย์
rangskik	เรียง
rangskik	ลำดับ
pampoen	ฟักทอง
griseus	griseus
reina	reina
chanel	chanel
raaisels	ปริศนา
sebastián	sebastián
simferopol	simferopol
antónio	antónio
fenisië	phoenicia
gesellig	อบอุ่น
gesellig	สบาย
tübingen	tübingen
wikiquote	wikiquote
autoconfirmed	autoconfirmed
nuclear	นิวเคลียร์
staffordshire	staffordshire
boulenger	boulenger
trump	ทรัมพ์
trump	ทรัมป์
trump	ทรัม
trump	trump
piedmont	piedmont
hotcat	hotcat
wernher	wernher
erlangen	erlangen
rochefort	rochefort
flits	flash
flits	แฟลช
wiener	ไส้กรอก
regressie	ถดถอย
gazeta	gazeta
copper	ทองแดง
copper	copper
kalmikië	kalmykia
hooi	ฟาง
hooi	hay
ntsc	ntsc
nasser	nasser
wikimapia	wikimapia
vorarlberg	vorarlberg
riverside	riverside
japonica	japonica
saale	saale
britten	britten
zim	zim
famous	ดัง
pauling	pauling
technique	เทคนิค
teller	เคาน์เตอร์
teller	counter
paderborn	paderborn
rca	rca
mtbe	mtbe
scalemajor	scalemajor
navbar	navbar
ponde	ปอนด์
ponde	ปอน
psi	psi
reënbuie	ฝักบัว
poitou	poitou
ballonne	บอลลูน
fig	ฟิก
fig	ฟิค
dome	โดม
honour	เกียรติ
khz	khz
geskeer	โกน
heldhaftige	พระเอก
scala	scala
hoi	หอย
cave	ถ้ำ
nha	nha
glase	แว่น
glase	แว่นตา
glase	แก้ว
graduate	บัณฑิต
skootrekenaar	แล็ปท็อป
deleuze	deleuze
ampezzo	ampezzo
ching	จิง
ching	ชิง
wenk	ทิป
montagne	montagne
elimineer	ขจัด
fête	fête
wan	wan
wan	วาน
campus	วิทยาลัย
campus	วิทยาเขต
campus	มหาวิทยาลัย
skisofrenie	โรคจิตเภท
hee	ฮี
palms	ฝ่ามือ
palms	ปาล์ม
yttrium	yttrium
mordowië	mordovia
ontologie	ontology
terrace	ระเบียง
patologie	พยาธิ
joanna	joanna
foneem	phoneme
preußen	preußen
walpole	walpole
koekies	คุกกี้
holm	เนิน
woiwodskappe	voivodship
dunam	dunam
regulasie	ระเบียบ
potsdamer	potsdamer
vasa	vasa
chinon	chinon
théâtre	théâtre
bloom	บลูม
donderweer	ฟ้าร้อง
donderweer	ฟ้าผ่า
rap	แร็พ
pia	เพียร์
voetnota	เชิงอรรถ
voetnota	อรรถ
dictionnaire	dictionnaire
speakers	ลำโพง
schiphol	schiphol
inkopies	ชอปปิ้ง
pound	ปอนด์
schröder	schröder
transit	การขนส่งมวลชน
éireann	éireann
duo	duo
alberti	alberti
invincible	คงกระพัน
ulaanbaatar	ulaanbaatar
bones	กระดูก
bones	โบนส์
nabootsing	จำลอง
nums	nums
radiometriese	radiometric
nike	nike
profit	กำไร
quis	quis
cambodia	กัมพูชา
herlaai	พร้อม
pardus	pardus
hoc	hoc
manche	manche
rec	rec
rec	สันทนาการ
stewels	บูต
moth	เม่า
psoe	psoe
salerno	salerno
vale	เวลล์
virale	ไวรัส
khanate	khanate
gaspard	gaspard
troeteldier	pet
kommas	จุลภาค
carte	carte
norsk	norsk
comics	การ์ตูน
église	église
radionuklied	radionuclide
programmeerders	โปรแกรมเมอร์
presisie	ป้องกัน
elasmobranchii	elasmobranchii
tweestryd	แมตช์
damara	เคิร์ก
ordovisium	ordovician
basjkortostan	bashkortostan
turkestan	turkestan
swap	สลับ
hysbak	ลิฟท์
aosta	aosta
bourgogne	bourgogne
temminckii	temminckii
motto	คติพจน์
motto	คำขวัญ
hyogo	hyogo
skale	เกล็ด
skale	ตาชั่ง
itf	itf
blum	blum
meuse	meuse
gloei	โบว์ลิ่ง
yangtze	yangtze
secam	secam
poole	พูล
burgenland	burgenland
lakens	ผ้าปูที่นอน
boulton	boulton
cbe	cbe
chennai	chennai
stawropol	stavropol
valentyn	วาเลนไทน์
luzern	lucerne
kondisie	เงื่อนไข
kondisie	สภาพ
goa	กัว
mielie	ข้าวโพด
mielie	ข้าวโพด
ondertoe	ลง
ondertoe	ดาวน์
guerra	guerra
buigbare	ยืดหยุ่น
bet	พนัน
taj	ทัช
achenaten	akhenaten
megalodon	megalodon
movies	หนัง
movies	ภาพยนต์
movies	ภาพยนตร์
ola	ola
magda	julia
soda	โซดา
gedraaide	บิด
int	int
cliff	หน้าผา
ayumu	ayumu
orvieto	orvieto
morus	morus
mpa	mpa
lauren	ลอว์เรน
lauren	ลอเรน
daidalos	daedalus
pardalis	pardalis
apb	apb
supermark	ซุปเปอร์มาร์เก็ต
waverley	waverley
rohe	rohe
afskrifte	สำเนา
sandwich	แซนด์วิช
kleed	สูท
rayleigh	rayleigh
mud	โคลน
rum	รัม
woronezj	voronezh
bona	bona
essential	สำคัญ
strix	strix
cars	รถยนต์
cars	รถ
bruxelles	bruxelles
antiquark	antiquark
clans	เผ่า
scuderia	scuderia
poskaarte	โปสการ์ด
nagy	nagy
nfr	nfr
henricus	henricus
warriors	warriors
warriors	นักรบ
voedingswaarde	โภชนาการ
mikrofoon	ไมโครโฟน
vase	แจกัน
skulpvis	หอย
clay	เคลย์
clay	ดิน
petro	petro
nederig	เจียม
nederig	ถ่อม
styles	สไตล์
hawks	hawks
delle	delle
opportunity	โอกาส
plotarea	plotarea
fiksheid	ฟิตเนส
fiksheid	สมรรถภาพ
hamburgers	แฮมเบอร์เกอร์
hap	แฮป
eddy	eddy
skull	กะโหลก
ethiopia	เอธิโอเปีย
jahre	jahre
lai	ลาย
kfc	kfc
setmetatable	setmetatable
athelstan	athelstan
lupus	ลูปัส
narkose	ยาสลบ
rivière	rivière
knm	knm
agricultural	การเกษตร
agricultural	เกษตรกรรม
agricultural	เกษตร
rank	อันดับ
saldo	สมดุล
fer	fer
fer	แฟร์
valskerm	ชูชีพ
basiliscus	basiliscus
hipparcos	hipparcos
atx	atx
fate	ชะตา
eksperimenteel	ทดลอง
csv	csv
adsl	adsl
skeef	คด
skeef	เบี้ยว
léopold	léopold
spn	spn
almere	almere
franken	franken
kenilworth	kenilworth
noaa	noaa
direktoraat	directorate
superminimotor	supermini
abstraksie	นามธรรม
wilderness	รกร้าง
ribbes	ซี่โครง
slalom	slalom
ruby	ทับทิม
gamal	gamal
drapeau	drapeau
nec	nec
timeaxis	timeaxis
farewell	อำลา
geograph	geograph
chrome	chrome
chrome	โครม
pierce	เพียซ
furukawa	furukawa
raven	raven
wise	ฉลาด
delisted	delisted
ontwikkelingsgemeenskap	sadc
oeljanofsk	ulyanovsk
lol	lol
lol	ฮ่าๆ
lin	หลิน
waaier	พัดลม
waaier	fan
waaier	แฟนๆ
waaier	แฟน
loxodonta	loxodonta
vertroude	ไว้ใจ
sek	วินาที
sek	sec
fighting	สู้
genius	อัจฉริยะ
berne	berne
wikibooks	wikibooks
bello	เบลโล
rocket	จรวด
dagmar	dagmar
chung	ชัง
chung	ชุง
msn	msn
humbert	humbert
gazetteer	gazetteer
seoul	โซล
arrondissements	arrondissements
strachan	strachan
asemhaal	หายใจ
anaxagoras	anaxagoras
pelecanus	pelecanus
simón	simón
bundestag	bundestag
kerrie	กะหรี่
kerrie	แกง
kerrie	curry
bing	บิง
bing	bing
sovereign	อภิสิทธิ์
rudd	รัดรูป
rudd	รัด
microsystems	microsystems
csa	csa
buitelug	outdoor
joséphine	joséphine
zahn	zahn
bark	เห่า
vanadium	vanadium
bayreuth	bayreuth
cane	เฆี่ยน
archaeopteryx	archaeopteryx
savo	savo
kwantiteit	ปริมาณ
alignbars	alignbars
tjips	ชิป
islas	islas
générale	générale
wjatsjeslaf	vyacheslav
nilo	nilo
spy	สปาย
tamar	tamar
afghaanse	อัฟกานิสถาน
kierie	เฆี่ยน
unity	สามัคคี
unity	unity
unity	เอกภาพ
ymca	ymca
braid	เปีย
perske	ท้อ
perske	พีช
saarbrücken	saarbrücken
katastrofe	หายนะ
katastrofe	เซียน
severn	severn
zee	ซี
dalian	เหลียน
mangifera	มะม่วง
konvolusie	convolution
kieslys	เมนู
mekong	โขง
andromedae	andromedae
rauma	rauma
textstyle	textstyle
drum	กลอง
bulgaria	บัลแกเรีย
ghz	ghz
władysław	władysław
avec	avec
tellings	คะแนน
dab	dab
anargistiese	อนาธิปไตย
sprint	sprint
oorgeslaan	ข้าม
latino	ละติน
gerry	gerry
helmholtz	helmholtz
friuli	friuli
cha	ชะ
cha	ชา
coronatus	coronatus
dino	dino
zemlja	zemlya
huistoe	บ้าน
huistoe	home
huistoe	บาน
vervals	ปลอม
tere	tere
elegant	หรูหรา
boyd	บอยส์
boyd	บอยด์
karol	karol
onmiddelik	ทันที
sos	sos
eno	eno
hordes	ปีก
laidlaw	laidlaw
nilotica	nilotica
revival	ฟื้นฟู
holly	ฮอล
tao	เต๋า
tao	เต่า
tao	เทา
tao	tao
tribute	ส่วย
tribute	บรรณาการ
nigeria	ไนจีเรีย
nig	มืด
vivo	vivo
wikinews	wikinews
ubi	ubi
centro	centro
terrible	แย่
terrible	สาหัส
heffing	ประจุ
heffing	ชาร์ต
heffing	ชาร์จ
tricolor	tricolor
ier	ier
corporate	องค์กร
teaching	สอน
saag	เห็น
archivedate	archivedate
angiosperms	angiosperms
boon	บุญ
locomotives	locomotives
zwingli	zwingli
fleck	แร่
modusse	โหมด
sadat	sadat
macht	macht
weggegooi	ละทิ้ง
techniques	เทคนิค
proterosoïkum	proterozoic
altus	altus
bluebird	บลูเบิร์ด
kultur	kultur
comodoro	comodoro
koord	คอร์ด
playhouse	playhouse
tampere	tampere
kyiv	kyiv
tovar	tovar
suetonius	suetonius
gestand	เกียรติ
obe	obe
seminare	สัมมนา
franck	franck
bevan	bevan
éditions	éditions
fraksie	เศษส่วน
eunug	ขันที
factor	factor
factor	ตัวประกอบ
factor	ปัจจัย
collège	collège
kampanië	campania
ligbreking	refraction
leadership	ผู้นำ
alcock	alcock
ace	ace
gazella	gazella
adm	adm
castello	castello
bloomsbury	bloomsbury
milvus	milvus
ria	ria
sncf	sncf
leonhard	leonhard
curry	กะหรี่
curry	แกง
curry	curry
laurel	ลอเรล
sentreer	กึ่งกลาง
sentreer	กลาง
sentreer	ศูนย์
sentreer	ศูนย์กลาง
sentreer	กึ่งกลาง
sentreer	ศูนย์
sentreer	ศูนย์กลาง
distrito	distrito
heine	heine
comarca	comarca
osama	osama
tjoemen	tyumen
dts	dts
camel	อูฐ
ari	อารีย์
ari	อารี
mönchengladbach	mönchengladbach
concise	กระชับ
lover	lover
richthofen	richthofen
chuck	ชัค
chuck	chuck
cream	ครีม
skrynwerker	ช่างไม้
wawel	wawel
duane	ดวน
adele	อะเดล
adele	อเดล
belediging	ดูถูก
cid	cid
rip	ฉีก
rip	rip
ntu	ntu
wmflabs	wmflabs
resistivity	resistivity
quiet	เงียบ
legio	legio
rhodesian	rhodesian
vols	vols
ghirlandaio	ghirlandaio
indef	indef
invoeg	แทรก
rona	rona
halliday	halliday
halfpenny	halfpenny
innocent	บริสุทธิ์
stallman	stallman
fuego	fuego
rugsteun	สำรอง
ain	อัยน์
smile	ยิ้ม
smile	smile
navrae	สอบถาม
navrae	คำถาม
superman	superman
origenes	believers
jacek	jacek
giants	ยักษ์
beth	เบ็ธ
beth	เบ็ท
beth	เบ็ต
beth	เบธ
kreuzberg	kreuzberg
rosette	rosette
oligoseen	oligocene
tsjoewasjië	chuvashia
fsa	fsa
mariano	mariano
gozo	gozo
pepi	pepi
orenburg	orenburg
trastevere	trastevere
bibliotheca	bibliotheca
jubatus	jubatus
gutiérrez	gutiérrez
hefboom	โยก
hefboom	ฉลาด
ora	ora
eensaam	เหงา
stepanakert	stepanakert
sessies	เซสชั่น
sessies	เซสชัน
moonlight	แสงจันทร์
slap	ตบ
karakoroem	karakorum
ignaz	ignaz
diamonds	เพชร
ibiza	ibiza
junction	ชุม
hts	hts
bekostigbaar	ย่อมเยา
eco	eco
veearts	สัตวแพทย์
wikivoyage	wikivoyage
otter	นาก
brevirostris	brevirostris
leeuwenhoek	leeuwenhoek
clt	clt
historische	historische
mclachlan	mclachlan
vrolik	ร่าเริง
polis	polis
waleri	valeri
dromme	กลอง
schott	schott
paddington	paddington
simulasie	จำลอง
sigblad	สเปรดชีต
formal	ทางการ
vegetariese	มังสวิรัติ
gefermenteerde	หมัก
sanae	sanae
attenborough	attenborough
cuxhaven	cuxhaven
blaaiers	บราวเซอร์
ant	มด
nuestra	nuestra
abdel	abdel
espn	espn
carr	คาร์
tsi	tsi
ultimate	ultimate
ríos	ríos
omajjadiese	umayyad
wong	วอง
wong	หวง
runner	runner
dove	พิราบ
bewonderaar	พัดลม
bewonderaar	fan
bewonderaar	แฟนๆ
bewonderaar	แฟน
liz	ลิส
liz	ลิซ
savage	เถื่อน
vetdruk	หนา
sejm	sejm
drup	หยด
mollis	mollis
valenciennes	valenciennes
aran	aran
jugend	jugend
böhlke	böhlke
tyson	tyson
sanitasie	สุขาภิบาล
willi	willi
kuipers	kuipers
bybelgenootskappe	สังคม
abbé	abbé
gevorderd	ก้าวหน้า
npov	npov
yun	ยุน
neues	neues
armor	เกราะ
noon	บ่าย
noon	เที่ยง
wordsworth	wordsworth
kendall	kendall
infraordo	infraordo
pga	pga
huiswerk	การบ้าน
geblok	บล็อก
geblok	บล็อค
zdf	zdf
eli	ไล
eli	อีไล
pulp	pulp
palacio	palacio
elektronegatiwiteit	electronegativity
muscicapidae	muscicapidae
knights	อัศวิน
aps	aps
sue	ซู
sue	sue
bibcode	bibcode
prospekt	ฝึกงาน
bewolkte	เมฆ
philander	philander
lanius	lanius
uusimaa	uusimaa
lumière	lumière
vittata	vittata
orangerie	orangerie
sim	ซิม
sim	sim
casno	casno
dennett	dennett
beenvisse	osteichthyes
centrale	centrale
pgc	pgc
barron	barron
citationclass	citationclass
loc	loc
peña	peña
sambreel	ร่ม
nang	นาง
egypte	egypte
strike	strike
foon	โทรศัพท์
ride	ขี่
vent	ระบาย
tandarts	ทันตแพทย์
tsaredom	tsardom
clio	clio
maritimus	maritimus
dry	แห้ง
dry	แล้ง
dry	แห้งๆ
slr	slr
kader	kader
algarve	algarve
rosales	rosales
dora	dora
derm	derm
dufresne	dufresne
engines	เครื่องยนต์
foods	อาหาร
foods	ฟู้ด
snr	snr
bey	bey
blogspot	blogspot
priscus	priscus
fluminense	fluminense
versperrings	อุปสรรค
sprei	แพร่
sprei	กระจาย
backgroundcolors	backgroundcolors
gorm	gorm
legends	ตำนาน
sèvres	sèvres
faire	faire
borrie	ขมิ้น
borromeo	borromeo
toastmasters	toastmasters
ging	ging
icio	icio
cdt	cdt
irriteer	รำคาญ
diagnoseer	วินิจฉัย
ibero	ibero
meine	meine
drumpel	เกณฑ์
lago	lago
kyd	kyd
mew	มิว
kaloega	kaluga
estados	estados
domínguez	domínguez
sydenham	sydenham
westen	westen
farrar	farrar
fanerosoïkum	phanerozoic
roundel	roundel
klant	ลูกค้า
clerk	เสมียน
unitary	unitary
duero	duero
feliks	feliks
muntjak	เก้ง
würzburg	würzburg
cisalpina	กอล
wittelsbach	wittelsbach
superscalar	superscalar
docklands	docklands
guys	พวก
hrsg	hrsg
tld	tld
vauban	vauban
hawelose	จร
hawelose	จรจัด
metropolis	เมโทรโปลิส
metropolis	มหานคร
mommsen	mommsen
iban	iban
jef	jef
guise	guise
acres	เอเคอร์
tall	สูง
seekat	ปลาหมึก
bsd	bsd
ser	เซอร์
charge	ประจุ
charge	ชาร์ต
charge	ชาร์จ
phantom	phantom
dunlop	dunlop
pelote	pelota
probus	probus
ley	ley
nds	nds
imageright	imageright
skandeerder	สแกน
engl	engl
qingdao	qingdao
gatwick	gatwick
orjol	oryol
goeddunke	ดุลยพินิจ
goeddunke	วิจารณญาณ
simptoom	อาการ
gays	เกย์
brookes	brookes
könig	könig
weitz	weitz
wikilink	wikilink
tcp	tcp
atlantique	atlantique
piacenza	piacenza
diao	diao
diaries	ไดอารี่
sakdoek	ผ้าเช็ดหน้า
rainer	rainer
vibreer	สั่น
std	std
denisova	denisova
milne	milne
vaak	ง่วง
voorbode	ลาง
rosids	rosids
bells	ระฆัง
bells	กระดิ่ง
liefhebbers	คู่รัก
mola	mola
whisky	วิสกี้
zoem	ขยาย
zoem	ซูม
mises	mises
nbc	nbc
trotsky	trotsky
