vosloo	vosloo
chapman	chapman
basil	basil
orsini	orsini
trane	lăn
mafeking	mafeking
vark	lợn
vark	thối
vark	heo
vark	đẻ
karma	karma
gable	gable
halle	halle
bottel	chai
opmerkings	comments
tsonga	tsonga
herold	herold
léon	léon
gly	slide
gly	trượt
gly	trượt
twer	tver
naderende	sắp
omslag	bìa
omslag	cover
omslag	che
dauphin	dauphin
córdoba	córdoba
mtv	mtv
madonna	madonna
geklee	mặc
geklee	đeo
gestapo	gestapo
preston	preston
alexis	alexis
billboard	billboard
job	nghề
job	việc
biko	biko
melodie	giai
melodie	melody
koppelteken	dash
bokmål	bokmål
actinopterygii	actinopterygii
rommel	rommel
nixon	nixon
bora	bora
madison	madison
lat	lats
gloucester	gloucester
natalie	natalie
chrysler	chrysler
tydlyn	chronos
skakerings	shades
skakerings	toner
irr	irr
woody	woody
semantiese	semantic
din	din
lund	lund
xml	xml
xml	xm
toevoer	feed
senegalensis	senegalensis
magic	thuật
magic	magic
manetho	manetho
beit	beit
doug	doug
audrey	audrey
panele	bảng
cuvier	cuvier
rodrigo	rodrigo
hohenzollern	hohenzollern
geskok	sốc
blake	blake
spoke	bu
spoke	hù
spoke	boo
juweliersware	sỉ
skandaal	scandal
pasternak	pasternak
knie	gối
anhalt	anhalt
beyer	beyer
grasse	grasse
augsburg	augsburg
oeral	ural
mitte	mitte
rhea	rhea
omskakel	converts
marsh	marsh
adad	adad
ineengestort	sập
minnie	minnie
trevor	trevor
geleier	conductor
oenanthe	oenanthe
dekker	dekker
logos	logo
vinger	finger
tenoor	tenor
broederskap	fraternity
broederskap	brotherhood
barack	barack
baas	sếp
baas	boss
theophilus	theophilus
dolfyn	dolphin
oeste	oeste
miss	miss
miss	nhớ
jerome	jerome
leslie	leslie
kleef	kleve
cut	cut
cut	cắt
cut	méo
cut	chém
skerms	cảnh
heks	thuỷ
heks	thủy
bertha	bertha
nizjni	nizhny
lucy	lucy
morales	morales
hinomaru	hinomaru
stogastiese	stochastic
mahatma	mahatma
weiss	weiss
ella	ella
jungle	rừng
jungle	jungle
pal	pahlavi
pal	pal
olyf	olive
olyf	ôliu
sex	sex
cullinan	cullinan
sinclair	sinclair
sartre	sartre
gelofte	thề
polêre	cực
fbi	fbi
fbi	cục
kortliks	bài
kortliks	ngắn
kortliks	short
kortliks	lá
gerrard	gerrard
gerrard	gerard
pizza	pizza
thorn	thorn
thorn	torn
colenso	colenso
gans	ngỗng
gans	goose
weles	veles
auvergne	auvergne
jay	bum
jay	jay
eds	eds
abchasië	abkhazia
glans	glossy
bamberger	bamberger
banda	banda
cold	lạnh
loper	bishop
bratislava	bratislava
prioriteit	ưu
agteruit	ngược
agteruit	ngược
agteruit	ngược
gereserveer	reserved
immanuel	immanuel
vedder	vedder
oorleg	phủ
falcon	falcon
touch	touch
touch	ống
touch	sờ
touch	chạm
interpreteer	vẽ
ooreengestem	khớp
sigismund	sigismund
lek	lek
ibrahim	ibrahim
sandra	sandra
blog	blog
brad	brad
helmut	helmut
molibdeen	molypden
mon	mon
nina	nina
radon	radon
gnostisisme	gnosticism
petra	petra
une	une
homeriese	homeric
transaksies	deals
benedetto	benedetto
quest	quest
quest	tr
selfoon	mobile
selfoon	mobil
braai	nướng
braai	bbq
ede	ede
spasies	khoảng
afkoel	ngầu
afkoel	tuyệt
afkoel	mát
afkoel	cool
epsilon	epsilon
fremantle	fremantle
yahoo	yahoo
rwy	rwy
kramer	kramer
onkruid	cỏ
onkruid	weed
hilton	hilton
ban	bali
magma	nham
neutron	neutron
deventer	deventer
herodotos	herodotus
dallas	dallas
riviera	riviera
borja	borja
koi	koi
khomeini	khomeini
giulio	giulio
skerpioen	scorpio
skerpioen	cạp
skerpioen	scorpion
skerpioen	accordion
duc	duc
pakkette	gói
pakkette	gói
pakkette	packs
aviv	aviv
tendens	trend
rylaan	peak
guild	guild
cecilia	cecilia
bandera	bandera
conti	conti
smart	minh
smart	khôn
gillis	gillis
carolus	carolus
mugabe	mugabe
ultra	ultra
rügen	rügen
scriba	scriba
pioneer	pioneer
almazán	almazán
tommy	tommy
klaus	klaus
fetus	fetus
gloria	gloria
havana	havana
café	café
bureau	bureau
bureau	cục
doyle	doyle
rita	rita
hals	hals
sagter	hạ
wikimania	wikimania
lagos	lagos
wyses	cách
werksgeleenthede	jobs
bisse	bit
dreigende	đe
rockwell	rockwell
amanda	tô
amanda	amanda
loch	hồ
mus	lạch
mus	creek
amundsen	amundsen
nairobi	nairobi
addis	addis
société	société
toruń	torun
weggesteek	phone
weggesteek	ẩn
kgalagadi	kgalagadi
pagina	pagina
sant	sant
troyes	troyes
edi	edi
halifax	halifax
merops	merops
skilpad	rùa
eindhoven	eindhoven
briljante	brilliant
rhode	rhode
göttingen	göttingen
drievoudige	ba
drievoudige	triple
modena	modena
graz	graz
cfa	cfa
girolamo	girolamo
sammy	sammy
heinz	heinz
vfb	vfb
barbarossa	barbarossa
buis	ống
polisieman	cớm
polisieman	cop
raadslede	councillors
onskuldige	tội
commonwealth	commonwealth
fonetiek	phonetics
tbilisi	tbilisi
babelsberg	babelsberg
dreineer	drain
hector	hector
papa	papa
louisa	louisa
descartes	descartes
ground	đất
supersport	supersport
addclass	addclass
tostring	tostring
mussolini	mussolini
vertebrata	vertebrata
jeremia	jeremiah
andre	andre
andre	andré
salaam	salaam
oswald	oswald
piri	piri
pou	pou
pou	pavo
batterye	bình
batterye	pin
brooks	brooks
iowa	iowa
stella	stella
drankies	uống
mitford	mitford
molly	molly
zeppelin	zeppelin
wim	wim
hoesein	hussein
vic	vic
alberts	alberts
niccolò	niccolò
skouer	vai
angels	angels
subclassis	subclassis
milde	milde
curie	curie
houghton	houghton
pseudo	pseudo
buurman	xóm
burlington	burlington
hertz	hertz
rolling	lướt
bath	bad
bath	bath
bath	tắm
amersfoort	amersfoort
oefeninge	gỉa
leibniz	leibniz
viktor	viktor
burggraaf	viscount
margate	margate
theresa	theresa
henriette	henriette
sirius	sirius
granada	granada
pap	cháo
pap	papiamento
edwards	edwards
sokrates	socrates
definitiewe	bum
demetri	demetri
histoire	histoire
blason	blason
alemanne	alemanni
marcellus	marcellus
deutscher	deutscher
sevilla	sevilla
sevilla	seville
excelsior	excelsior
tutu	xòe
tutu	tutu
dell	dell
gerald	gerald
lac	lac
hubert	hubert
ekwatoriaal	equatorial
dronk	say
dronk	xỉn
dronk	drunk
dors	khát
kirgisië	kyrgyzstan
kitts	kitts
thatcher	thatcher
ferrara	ferrara
epinephelus	epinephelus
rubens	rubens
ahmed	mathieu
ahmed	ahmed
telegram	tín
gekleur	sơn
velden	velden
waarhede	truths
rossellini	rossellini
tente	lều
battery	pháo
battery	pin
knoppie	button
knoppie	nút
winnie	winnie
portal	portal
portal	cổng
oortollige	thụ
jürgen	jürgen
jürgen	jurgen
jürgen	jurgen
konrad	konrad
pastorale	pastorale
afgekap	khối
verona	verona
hongare	hungary
habermas	habermas
judea	judea
diefstal	trộm
seksie	phần
kosmos	cosmos
planck	planck
kobalt	coban
kobalt	cobalt
chun	chun
chun	xuân
siamese	xiêm
brandt	brant
brandt	brandt
dsm	dsm
boodskapper	perl
wêrelde	worlds
neville	neville
mohammad	mohammad
daryl	daryl
subphylum	subphylum
avant	avant
rath	rath
dharma	dharma
midway	midway
aalborg	aalborg
buzz	buzz
shelley	shelley
sjoe	chà
sjoe	wow
sjoe	oi
sjoe	omg
bela	bela
southampton	southampton
bennett	bennett
bennett	bennet
blitz	blitz
ester	ester
ester	este
cairns	cairns
kamtsjatka	kamchatka
bastille	bastille
jaroslaf	yaroslav
belize	be
belize	belize
boven	boven
terra	terra
r}}	r}}
holocaust	holocaust
vfl	vfl
emanuel	emanuel
patriargaat	patriarchate
halloween	halloween
verstrek	scripting
deutsch	deutsch
claire	claire
damasus	đamasô
cope	cope
clift	clift
merkers	thẻ
merkers	tags
normal	chuẩn
normal	thường
cullen	cullen
paula	paula
smolensk	smolensk
arno	arno
stoute	bẩn
stoute	hủ
stoute	dơ
allende	allende
vista	vista
vanuatu	vanuatu
marita	marita
hosea	hosea
sciëntologie	scientology
generiese	generic
wilhelmus	wilhelmus
kingston	kingston
visualeditor	visualeditor
durf	dám
sop	soup
sop	súp
sop	cháo
afvoer	xuất
mog	mog
ipod	ipod
bien	bien
bien	biên
flickr	flickr
diocletianus	diocletianus
outo	auto
hayward	hayward
taung	taung
istanbul	istanbul
qin	tần
beurse	bóp
beurse	ví
tune	tune
stoep	hiên
stoep	sân
cda	cda
negentien	nineteen
richter	richter
num	num
renier	renier
rhein	rhein
richards	richards
lanseer	launch
lanseer	phóng
fleming	fleming
picchu	picchu
shirley	shirley
glukose	glucose
qui	qui
commando	commando
bouer	builder
nottingham	nottingham
edmond	edmond
nida	nida
lopez	lopez
paragraaf	đoạn
obelisk	obelisk
ares	ares
verbeteringe	vá
geskakel	tráng
clara	clara
freddie	freddie
raf	raf
beverly	beverly
gustave	gustave
rush	rush
barr	barr
mango	xoài
mango	mango
inn	inn
vlamme	lửa
chronologiese	chronological
olympia	olympia
murat	murad
radar	radar
radar	rađa
ortografie	orthography
randers	randers
christine	christine
cor	cor
oidipus	oedipus
factbook	factbook
spellings	spellings
oproer	loạn
oproer	riot
branson	branson
sud	sud
brent	brent
brent	thiêu
garcia	garcia
methuen	methuen
levy	levy
uitsending	phát
forbes	forbes
alte	alte
laude	laude
clermont	clermont
kipling	kipling
icloud	icloud
peak	peak
iris	iris
nippon	nippon
afsluiting	đóng
afsluiting	cận
giorgio	giorgio
komen	komen
afrigters	coaches
franca	franca
aischylos	aeschylus
prometheus	prometheus
grimaldi	grimaldi
fidel	fidel
nijmegen	nijmegen
filter	lọc
britz	britz
skrik	dọa
skrik	scare
luftwaffe	luftwaffe
michaelis	michaelis
judas	judas
grenoble	grenoble
sandy	sandy
federico	federico
hut	chòi
hut	cabin
nebraska	nebraska
gauss	gauss
insel	insel
totalcaps	totalcaps
academica	academica
rns	rna
rns	arn
colony	khu
accessdate	accessdate
sacha	sacha
damian	damian
jennifer	jennifer
bennington	bennington
sws	sws
emberiza	emberiza
weser	weser
amoen	amun
kykers	sổ
kykers	views
cuscuta	cuscuta
dessau	dessau
geskeur	jacket
clare	clare
lingen	lingen
tablet	tablet
totalgoals	totalgoals
bernhard	bernhard
gal	mật
norton	norton
nsdap	nsdap
impressionisme	impressionism
gondwana	gondwana
morton	morton
hough	hough
bevinding	finding
chubut	chubut
sophokles	sophocles
con	con
irc	irc
vou	gấp
aalwyn	aloe
esperanto	esperanto
ariel	ariel
mill	mill
stormvoël	pterodroma
drift	trôi
oceanodroma	oceanodroma
truman	truman
porter	toang
porter	porter
mimi	mimi
vonds	quỹ
tjello	cello
halo	quầng
halo	halo
kirill	kirill
misdadigers	phạm
novalis	novalis
transistors	transistors
skaam	nhục
kaunda	kaunda
akwarium	aquarium
hamburger	hamburger
gian	gian
opstelling	setup
adriatiese	adriatic
frelimo	frelimo
petit	petit
kuhn	kuhn
rasmussen	rasmussen
mayer	mayer
heathrow	heathrow
richardson	richardson
faraday	faraday
cas	cas
watts	watt
watts	watts
fantasia	fantasia
karas	karas
akwariums	aquariums
asyn	giấm
asyn	dấm
expo	expo
tenzing	tenzing
binding	binding
chamonix	chamonix
saul	saul
speurder	tracker
torch	torch
torch	đuốc
muntstuk	xấp
muntstuk	xu
brunswick	brunswick
lourenço	lourenço
jaroslawl	yaroslavl
transistor	transistor
royce	royce
emosioneel	bênh
motorfietse	môtô
penny	penelope
penny	penny
leonid	leonid
ontsluit	unlock
méxico	méxico
méxico	mêxico
comune	comune
vernon	vernon
vernon	dượng
jure	jure
carnegie	carnegie
edge	mép
edge	edge
edge	rìa
edge	cạnh
pic	pic
madeira	madeira
reid	reid
dominica	dominica
demonstrasie	demo
stomp	giậm
babbage	babbage
broenei	brunei
charismatiese	charismatic
lambert	lambert
machu	machu
purcell	purcell
galápagos	galápagos
puk	puk
persephone	persephone
hirundo	hirundo
eksoplaneet	exoplanet
bestellings	lệnh
sonnige	nắng
sonnige	sunny
ashton	ashton
seattle	seattle
seattle	seatle
mynwese	mỏ
wicca	wicca
flemming	flemming
pirates	pirates
cohen	cohen
petersen	petersen
rod	rod
jens	jens
elgar	elgar
rochester	rochester
edt	edt
#die	#cái
#die	#những
#die	#the
#die	#nó
burroughs	burroughs
azur	azur
portland	portland
batista	batista
catarina	catarina
leicester	leicester
filippo	filippo
outydse	vintage
gregorio	gregorio
esa	esa
judith	judit
judith	judith
emile	emile
kunst	kunst
hetiete	hittites
beauvoir	beauvoir
korinthe	corinth
manet	manet
hannah	hannah
lier	lier
deimos	deimos
bram	bram
osborne	osborne
osborne	osbourne
drankie	uống
drankie	ly
tianjin	tianjin
samestellende	constituent
tartaros	tartarus
senna	senna
ensiem	enzyme
ensiem	enzym
mistral	mistral
diagonale	chéo
seal	seal
ethnologue	ethnologue
kuifie	tintin
hiperbool	hyperbol
orakel	oracle
djoser	djoser
dyke	dyke
nimfe	nymphs
acta	acta
randall	randall
augusto	augusto
narva	narva
kanaän	canaan
ulrich	ulrich
dorothea	dorothea
outoriteit	bang
vyftiende	fifteen
oppenheimer	oppenheimer
rene	rené
rene	rene
sama	sama
papirus	papyrus
gerber	gerber
sic	sic
sylt	sylt
horizons	horizons
hyde	hyde
callisto	callisto
compagnie	compagnie
bylae	lịch
irl	irl
ursus	ursus
kosmologiese	cosmological
arseen	arsenic
mrt	mrt
telegraph	telegraph
karin	karin
malaysia	malaysia
rohan	rohan
kuala	kuala
lumpur	lumpur
hutte	khoang
haan	rooster
shetland	shetland
dione	dione
bernoulli	bernoulli
shane	shane
ruben	ruben
hebride	hebrides
mantsjoerye	manchuria
filip	philippe
filip	filip
colonna	colonna
rune	nguyen
aleksandra	aleksandra
driehoeke	tam
sms	sms
swartberg	swartberg
resistors	resistors
pulsar	pulsar
niue	niue
sul	sul
kempton	kempton
ingewande	ruột
sami	sami
uile	cú
uile	owl
gemoed	mood
sprache	sprache
goddard	goddard
troy	troy
corolla	corolla
lamp	lamp
lamp	đèn
grenada	grenada
guam	guam
phu	phú
phu	phú
phu	phu
plak	dán
plak	dã
constance	constance
savoie	savoie
cern	cern
narbonne	narbonne
bon	bon
mummie	mummy
ingolstadt	ingolstadt
gewigte	weights
gewigte	tạ
farnese	farnese
cdu	cdu
stadt	stadt
tracy	tracy
bam	bam
july	tuấn
july	jun
hok	lồng
hok	chuồng
barlow	barlow
schumann	schumann
camus	camus
primrose	primrose
heath	phuc
heath	heath
ftp	ftp
laterale	lateral
nok	nok
îles	îles
theropoda	theropoda
mia	mia
wenera	venera
macbeth	macbeth
moederland	motherland
labeo	labeo
nunavut	nunavut
angolensis	angolensis
gesang	gesang
euler	euler
ami	ami
irish	irish
williamson	williamson
argon	argon
barbados	barbados
koopman	koopman
arabia	rập
bakker	baker
bakker	bakker
bartolomeo	bartolomeo
vuurwapens	súng
doesn	doesn
chomsky	chomsky
akko	akko
makedonië	macedonia
mafia	mafia
domingo	domingo
osma	osma
mapungubwe	mapungubwe
okavango	okavango
nikephoros	nikephoros
armada	armada
griffiths	griffiths
aangenaam	pleasant
welstand	wellness
kgb	kgb
caleb	caleb
abe	abe
fonda	fonda
kou	kou
sao	sò
bls	bls
maximus	maximus
lowe	lowe
dykstra	dykstra
guadalajara	guadalajara
nsw	nsw
eienaardige	curious
eienaardige	mò
ovidius	ovid
medina	medina
antoninus	antoninus
kadmium	cadimi
omhulsel	bìa
omhulsel	cover
omhulsel	che
platz	platz
maer	mỏng
maer	gầy
maer	thin
sepc	sepc
samsung	samsung
jsp	jsp
lance	lance
quattro	quattro
knoppies	nút
diogenes	diogenes
cabo	cabo
ontkenning	disclaimer
harding	harding
günther	günther
atatürk	atatürk
orgasme	orgasm
kroate	croats
iberië	iberia
delmas	delmas
celtic	celtic
banier	banner
chevalier	chevalier
motte	motte
koningsberg	königsberg
gertrude	gertrude
rafael	rafael
norwich	norwich
martins	martins
eintracht	eintracht
kees	keith
korsika	corse
korsika	corsica
kake	kake
lavey	lavey
swift	yến
swift	swift
geschiedenis	geschiedenis
toendra	tundra
taxi	taxi
gil	gil
gil	quát
gil	hét
teëls	lát
ögedei	ögedei
msg	msg
oro	oro
parabool	parabol
krediet	credit
krediet	gmail
isak	isak
horst	horst
colonia	colonia
gorilla	gorilla
kaartjies	vé
ethelred	æthelred
bofbal	chày
ontbyt	sáng
verdi	verdi
sonskyn	nắng
hertogenbosch	hertogenbosch
tgv	tgv
mhz	mhz
lorraine	lorraine
skedule	lịch
moor	maori
moor	moor
soon	sớm
soon	sắp
herskryf	rewrite
eindige	finite
davidson	davidson
maj	maj
atoem	atum
robbe	robbe
elia	elia
hood	mui
hood	hood
wrc	wrc
dion	dion
abdul	abdul
dikker	thicker
carmen	carmen
tor	tor
butterworth	butterworth
gom	keo
juliet	juliet
memel	memel
hephaistos	hephaestus
kaczyński	kaczyński
placid	placid
milan	milan
milan	milano
cathcart	cathcart
witte	witte
mergedrow	mergedrow
arme	nghèo
arme	nghiệp
vektore	vectors
locke	locke
merriman	merriman
brooke	brooke
dna	adn
dna	dna
junta	junta
auschwitz	auschwitz
konstanz	konstanz
armand	armand
kuier	pal
hidalgo	hidalgo
sharif	sharif
italia	italia
mier	kiến
bei	bei
mayotte	mayotte
triton	triton
ankara	ankara
pauline	pauline
vtec	vtec
breuke	fractions
breuke	hướng
manor	manor
eur	eur
becker	becker
alchemie	alchemy
vertelling	narration
lansdowne	lansdowne
strooi	rơm
eisenstein	eisenstein
palme	palme
andersen	andersen
burgo	burgo
geseënd	phước
havel	havel
carlton	carlton
sulla	sulla
materialisme	materialism
chalcedon	chalcedon
dhl	dhl
angela	angela
delaware	delaware
toppunt	peak
minas	minas
hormone	hormone
hormone	hormon
ruik	mùi
ruik	mùi
ruik	thúi
escoffier	escoffier
lausitz	lausitz
hume	hume
volta	volta
tus	tus
worrall	worrall
lüneburg	lüneburg
gonzález	gonzález
fitzgerald	fitzgerald
mach	mach
rina	rina
mhnt	mhnt
amstel	amstel
wits	bidvest
dem	dem
umaga	umaga
asma	hen
reuben	reuben
manfred	manfred
emilio	emilio
seme	seme
schalke	schalke
venesiese	venetian
herberg	inn
grof	dính
grof	sticky
calvados	calvados
saddam	saddam
schwerin	schwerin
brando	brando
karelië	karelia
tsumeb	tsumeb
hayden	xuan
hayden	hayden
nasdaq	nasdaq
uitgaan	thoát
studios	studios
bladwisselende	deciduous
peel	peel
colombo	colombo
serengeti	serengeti
presley	presley
toilet	toilet
adler	adler
roebel	rubel
bengaalse	bengal
foo	foo
spil	hub
eliot	eliot
selim	selim
soen	hôn
soen	kiss
amelia	amelia
mechelen	mechelen
bonus	bonus
bonus	thưởng
parus	parus
elliott	elliott
amour	amour
alamos	alamos
diane	diane
rem	phanh
para	para
bulletin	bulletin
dram	dram
fuchs	fuchs
kambrium	cambrian
flynn	flynn
wolfe	wolfe
mall	mall
calvinisme	calvinism
herbarium	herbarium
selassie	selassie
caicos	caicos
evalueer	unplugged
kristal	crystal
beddens	giường
trente	trente
currentclub	currentclub
harm	hại
sojoes	soyuz
rok	váy
rok	áo
giuliano	giuliano
erickson	erickson
midlands	midlands
gesellschaft	gesellschaft
kafee	cafe
kafee	café
booth	booth
xavier	xavier
lelik	xấu
lelik	xau
lelik	xí
grange	grange
malmö	malmö
beaux	beaux
devoon	devonian
messias	messiah
aasvoëls	vulture
tate	tate
saarland	saarland
geesdriftige	zealous
nikita	nikita
queens	queens
kwalifiserende	qualifying
winchester	winchester
trope	tropics
snork	ngáy
bremer	bremer
energieke	energetic
salon	salon
katrina	katrina
república	república
wocke	wocke
papeete	papeete
kasimir	kasimir
spesery	spice
ensemble	ensemble
amy	amy
janet	janet
libre	libre
paz	paz
higgs	higgs
swaarkry	nhọc
waterdraer	aquarius
peroen	perun
pty	pty
hannibal	hannibal
formasies	formations
edwardiaanse	edwardian
step	bước
bartolomeus	bartolomeu
terry	terry
faal	fail
sheffield	sheffield
veiliger	dòm
szczecin	szczecin
meul	mill
weegskaal	libra
pier	pier
britannia	britannia
medwedef	medvedev
derek	derek
perspektiewe	perspective
willemse	willemse
corpus	corpus
smithsonian	smithsonian
arnhem	arnhem
kde	kde
coma	mê
hilda	hilda
volharding	grit
volharding	persistence
champlain	champlain
baxter	baxter
eukaryota	eukaryota
neill	neill
torres	torres
dominique	dominique
rama	rama
margot	margot
fonologie	phonology
vasberade	quyết
clement	clement
kerse	nến
abnormale	abnormal
shannon	shannon
québécois	québécois
woolf	woolf
mallet	mallet
assurbanipal	ashurbanipal
dana	dana
corrie	corrie
verpak	gói
verpak	quấn
verpak	pack
dec	dec
root	root
root	chủ
madame	madame
abd	abd
hibiscus	hibiscus
onewe	lẻ
severus	severus
insulien	insulin
gewerweldes	vertebrate
dijk	dijk
henrietta	henrietta
vito	vito
hay	hay
daan	daniel
interview	phỏng
hedwig	jadwiga
asp	asp
sewastopol	sevastopol
spd	spd
fletcher	fletcher
knoffel	tỏi
enceladus	enceladus
fotograwe	photographers
mutual	chung
pax	pax
mitanni	mitanni
theoi	theoi
tenochtitlan	tenochtitlan
townships	townships
bafokeng	bafokeng
cyril	cyril
drew	lê
drew	drew
rufus	rufus
chester	chester
donderstorms	giông
laps	laps
antonie	antonie
straße	straße
unita	unita
daisy	daisy
sterretjie	nhàn
sterretjie	tern
cellspacing	cellspacing
germain	germain
rodney	rodney
verkoper	nhã
sergio	sergio
namakwa	namaqua
deo	deo
coins	xu
eufraat	euphrates
jonah	jonah
oclc	oclc
owens	owens
kore	kore
wolfram	tungsten
wolfram	vonfram
wolfram	wolfram
rainier	rainier
shark	shark
shark	carcharhinus
opul	opec
geyer	geyer
oryx	oryx
vodacom	vodacom
yves	yves
ceti	ceti
ronnie	ronnie
cricinfo	cricinfo
delft	delft
osman	osman
swa	swa
sanders	sanders
williston	williston
wesley	wesley
sites	sites
nahuatl	nahuatl
almeida	almeida
jenny	jenny
franche	franche
delphi	delphi
koerdistan	kurdistan
apalis	apalis
slak	ốc
ludovico	ludovico
mentor	mentor
namur	namur
chelmsford	chelmsford
brouery	ngọt
eldoret	eldoret
emo	emo
bicolor	bicolor
honecker	honecker
perugia	perugia
hull	hull
demeter	demeter
amet	amet
tito	tito
tragedies	tragedies
par	par
par	parr
brezjnef	brezhnev
solaris	solaris
michalak	michalak
vitae	vitae
skitterende	nến
skitterende	glowing
flip	lật
manila	manila
entebbe	entebbe
goldblatt	goldblatt
moffat	moffat
gastehuis	lodge
wilkinson	wilkinson
deco	deco
féin	féin
welt	welt
baleariese	balearic
sankt	sankt
peso	peso
csstext	csstext
galaxy	galaxy
dio	cassius
psv	psv
muishond	mongoose
subiaco	subiaco
edvard	edvard
mikhail	mikhail
korrektiewe	correctional
productions	production
productions	productions
moss	mose
moss	rêu
batis	batis
indosjina	indochina
stephanie	stephanie
ornithischia	ornithischia
lagrange	lagrange
nefski	nevsky
agtertoe	ngược
umberto	umberto
nikon	nikon
mantua	mantua
troos	comfort
koersk	kursk
ode	ode
malo	malo
kerr	kerr
voorst	voorst
lydia	phuong
lydia	lydia
rangers	rangers
rangers	kích
javascript	javascript
krause	krause
trentino	trento
tomlinson	tomlinson
motacilla	motacilla
kultivar	cultivar
volunteer	nguyện
frankfurter	frankfurter
casino	casino
sutton	sutton
cam	cam
marguerite	marguerite
saliese	salic
kei	kei
erica	erica
gpl	gpl
euwe	euwe
swemmers	swimmers
gerais	gerais
stein	stein
kassie	ngực
perón	perón
eoc	eoc
shore	bờ
shore	shore
tafels	bảng
tafels	bàn
aston	aston
toro	toro
nokia	nokia
hubbard	hubbard
doors	cửa
wieg	nôi
lichtenstein	lichtenstein
ngk	ngk
multikulturele	multicultural
matig	vừa
bernardo	bernardo
mai	maithili
irkoetsk	irkutsk
amenhotep	amenhotep
marne	marne
pinochet	pinochet
sigmund	sigmund
wilder	wilder
pissarro	pissarro
towenaar	wizard
antoinette	antoinette
huil	khốc
huil	cry
huil	khóc
huil	khóc
xenon	xenon
klap	vỗ
dee	dee
barre	barre
puma	puma
sally	sally
lemoene	cam
abbas	abbas
swawel	sulfur
marilyn	marilyn
skoenlapper	butterfly
skoenlapper	bướm
cherry	cherry
kiribati	kiribati
mpv	mpv
montmartre	montmartre
vespasianus	vespasianus
eduardo	eduardo
dolby	dolby
hanoi	hanoi
jalta	yalta
flevoland	flevoland
gemis	lỡ
infraphylum	infraphylum
makemake	makemake
aquino	aquino
muse	muse
graeme	graeme
flash	nháy
flash	flash
crusoe	crusoe
buller	buller
endeavour	tr
parades	diễu
menslik	human
agricola	agricola
klaipėda	klaipėda
lothar	lothar
keynote	keynote
aristokrasie	aristocracy
creed	creed
arkansas	arkansas
meridiaan	meridian
laurie	laurie
karate	karate
gelre	guelders
andersson	andersson
nicholson	nicholson
lough	lough
wembley	wembley
powiat	powiat
zach	zach
simeon	simeon
mikroskoop	microscope
mikroskoop	phức
cesare	cesare
brouerye	breweries
gorillas	gorillas
reichstag	reichstag
hawk	hawk
urartu	urartu
tribune	tribune
nos	nos
eads	eads
geo	geo
algiers	bến
paranthropus	paranthropus
montserrat	montserrat
katharine	katharine
ariese	aryan
coke	coke
coke	coca
coke	soda
coke	cola
félix	bollaert
overstrand	overstrand
eksplisiet	dâm
pigment	pigment
hampstead	hampstead
nix	nix
keats	keats
afer	afer
lap	patch
teresa	têrêsa
teresa	teresa
petrograd	petrograd
valens	valens
sachalin	sakhalin
apis	api
apis	apis
ethernet	ethernet
sinatra	sinatra
geest	geest
alida	alida
govan	govan
warrenton	warrenton
aankope	mua
orpheus	orpheus
is,	là,
kimi	kimi
suffolk	suffolk
aldrin	aldrin
karatsjai	karachay
kyle	kyle
formosus	formosus
blu	blu
ego	ego
ego	echo
faber	faber
wladiwostok	vladivostok
bonaire	bonaire
uppsala	uppsala
civic	civic
benelux	benelux
belle	belle
horace	horace
raspoetin	rasputin
potlood	chì
loer	peek
dorset	dorset
palmerston	palmerston
kenya	kenya
luca	luca
habilis	habilis
ocinsoutput	ocinsoutput
boergondiërs	burgundian
transnistrië	transnistria
politkofskaja	politkovskaya
kirk	kirk
stok	lòi
stok	stick
races	xáo
sullivan	sullivan
makro	macro
float	float
float	nổi
deutsches	deutsches
lancashire	lancashire
aspirasies	tr
orkeste	bands
bernardino	bernardino
fleet	fleet
bride	bride
wenen	viên
wenen	vienna
tromp	tromp
sportsoort	sport
ongeskik	rude
irma	irma
minsk	minsk
biomassa	biomass
piccolomini	piccolomini
marmara	marmara
guildford	guildford
ankers	anchors
burns	cháy
betty	betty
ipad	ipad
palmer	palmer
bridges	bridges
bridges	cầu
carroll	carroll
beeldmateriaal	footage
chen	chen
chen	trần
kaak	lộ
archibald	archibald
nwl	nwl
passing	thủ
passing	khớp
aanvoer	dẫn
aanvoer	chì
cora	cora
benevento	benevento
tribus	tribus
haus	haus
cory	cory
archimedes	archimedes
lawless	lawless
lexington	lexington
kobe	kobe
heston	heston
dpm	dpm
fulda	fulda
cry	khốc
cry	cry
cry	khóc
mist	mist
cristina	cristina
pavia	pavia
aspirien	aspirin
sjostakowitsj	shostakovich
quechua	quechua
opdateer	update
supercup	supercup
velvet	velvet
velvet	nhung
