lokaal	vieta
selim	selim
soen	bučinys
amelia	amelija
mechelen	mechelen
bonus	bonus
bonus	premija
seile	vela
parus	zylės
gebare	gestų
amour	amour
liggings	vietose
liggings	vietovės
liggings	vieta
diane	diana
rem	stabdys
rem	stabdžiai
rem	stabdžių
rem	stabdymas
para	para
kleurvolle	spalvingų
kleurvolle	spalvinga
dram	dram
fuchs	fuchs
flynn	flinas
asiese	azijos
calvinisme	kalvinizmas
selassie	selasie
caicos	kaikoso
kristal	kristalų
domineer	dominuoti
beddens	lovos
trente	trente
currentclub	currentclub
sojoes	soyuz
rok	suknelė
rok	apranga
rok	suknele
rok	aprangos
giuliano	giuliano
kafee	cafe
lelik	baisi
lelik	bjaurus
grange	grange
malmö	malmė
prag	prag
messias	messiah
krokodil	krokodilas
tate	teit
saarland	saro
nikita	nikita
queens	karalienes
kwalifiserende	tinkamumas
ouditorium	auditorijoje
winchester	vinčesterio
onsigbaar	nematomas
bremer	bremer
energieke	energingas
katrina	katrina
papeete	papeetė
kasimir	kasimir
spesery	spice
ensemble	ansamblis
amy	eimė
janet	sudomino
libre	libre
betekenisvol	prasmingas
higgs	higso
pty	pts
hiëna	hiena
hannibal	hanibalas
snor	ūsai
szczecin	ščecino
britannia	britannia
medwedef	medvedev
corpus	corpus
smithsonian	smithsonian
arnhem	arnhemas
kde	kde
coma	koma
coma	komos
hilda	hilda
volharding	patvarumas
champlain	champlain
eukaryota	eukaryota
neill	neill
torres	torres
sekte	sekta
rama	rama
eusebius	euzebijus
fonologie	fonologija
clement	clement
abnormale	nenormali
abnormale	nenormalus
abnormale	nenormalūs
shannon	shannon
woolf	woolf
homogene	vienalytis
assurbanipal	ašurbanipalas
tiananmen	tiananmenio
dana	dana
root	root
madame	madam
insulien	insulino
insulien	insulinas
gewerweldes	stuburinių
hindernisse	kliūtis
galerie	galerie
henrietta	henrietos
hay	šieno
naweke	savaitgaliais
daan	daniel
hedwig	jadwiga
kleuterskool	darželio
sewastopol	sevastopolis
spd	bpd
fletcher	fletcher
uitgegaan	nutraukė
knoffel	česnakų
knoffel	česnako
fotograwe	fotografai
mitanni	mitanija
tenochtitlan	tenočtitlanas
bafokeng	bafokeng
pterocles	pterocles
cyril	cyril
motorsport	motorsport
rufus	rufas
juris	juris
chester	česteris
unita	unita
daisy	deizė
tartare	totoriai
cellspacing	cellspacing
germain	germain
philosophical	filosofinius
verkoper	pardavėjo
verkoper	pardavėjas
sergio	sergio
deo	deo
coins	monetos
eufraat	eufratas
legal	teisinių
oclc	oclc
wiskundig	matematiškai
kore	korė
wolfram	volframo
rainier	rainier
shark	ryklys
shark	rykliai
swakste	blogiausias
swakste	blogiausia
oryx	oriksas
illusie	iliuzija
delft	delft
deugde	gabumus
goedkeur	patvirtinti
osman	osman
wesley	wesley
nahuatl	nahuatl
almeida	almeida
jenny	dženi
foreign	užsienio
franche	franche
tydsduur	ilguma
tydsduur	ilgis
koerdistan	kurdistano
slak	sraigė
ludovico	ludovico
mentor	apmokymą
gevolgtrekkings	išvados
emo	emo
bicolor	beždžionvarlė
perugia	perugia
demeter	demetra
rau	rau
tito	tito
tragedies	tragedijų
maskers	kaukės
skitterende	švyti
sterreteken	astrologija
deco	deco
welt	welt
baleariese	balearų
innovasie	naujovė
innovasie	naujovės
ascension	žengimo
peso	pesas
csstext	csstext
dio	kasijus
psv	psv
muishond	mangusta
segmente	segmentai
edvard	edvard
mikhail	michailas
moss	sumaišyti
indosjina	indokinija
stephanie	stefani
nefski	nevskis
agtertoe	atgal
umberto	umberto
nikon	nikon
troos	komforto
troos	paguodos
koersk	kursko
ode	odė
bakterie	bakterijų
bakterie	bakterijas
bakterie	bakterija
bakterie	bakterijos
malo	malo
uitputting	išnaudojimas
rangers	eiguliai
javascript	javascript
krause	krause
trentino	trentino
tomlinson	tomlinson
nemunas	nemuno
motacilla	motacilla
volunteer	savanorišką
frankfurter	frankfurter
casino	kazino
sutton	sutton
cam	cam
marguerite	marguerite
singer	dainininkė
erica	erica
erica	erika
bobbejaan	pavianas
swemmers	plaukikai
stein	stein
kassie	krūtinės
perón	perón
eoc	eoc
shore	kranto
shore	krantas
waardevol	vertinga
waardevol	vertingas
commodore	komandoras
aston	aston
toro	toro
inspireer	įkvėpti
nokia	nokia
hubbard	hubbard
doors	durys
doors	duris
doors	durų
subatomiese	subatominė
matig	vidutinis
bernardo	bernardo
irkoetsk	irkutskas
amenhotep	amenchotepas
vertering	irimo
wilder	wilder
pissarro	pissarro
towenaar	vedlys
towenaar	burtininkas
towenaar	magas
hangende	kol
antoinette	antuanetė
huil	verkti
huil	verkia
sally	salis
sally	sale
maltees	maltos
maltees	maltiečių
lemoene	apelsinai
abbas	abbas
marilyn	marilyn
skoenlapper	drugelis
cherry	vyšnių
cherry	vyšnios
kiribati	kiribačio
varkvleis	kiaulienos
varkvleis	kiauliena
montmartre	montmartre
vespasianus	vespasianas
eduardo	eduardo
dolby	dolby
jalta	jaltos
flevoland	flevolando
ontdekte	atrado
ontdekte	aptikta
makemake	makemake
aquino	aquino
muse	mūza
onderhandeling	derybos
flash	flash
crusoe	kruzo
fasiliteer	palengvina
teleurgesteld	nusivylęs
endeavour	stengiasi
parades	paradų
menslik	žmonijos
menslik	žmogaus
menslik	žmogus
agricola	agricola
lothar	lothar
geraamte	skeletas
aristokrasie	aristokratija
creed	creed
arkansas	arkanzaso
meridiaan	meridian
werknemer	darbuotojui
werknemer	darbuotojas
karate	karate
andersson	andersson
nicholson	nicholson
euklidiese	euklidinė
wembley	wembley
skitiërs	skitai
voorgeskiedenis	priešistorė
kontrole	kontrolė
mikroskoop	mikroskopu
cesare	cesare
hawk	sakalas
urartu	urartija
tribune	tribune
geo	geo
antibiotika	antibiotikų
antibiotika	antibiotikai
antibiotika	antibiotikas
kannibalisme	kanibalizmas
holdings	ūkiai
holdings	ūkiuose
holdings	ūkių
holdings	valdos
handskrif	rašysena
ariese	arijai
coke	kokso
coke	koksas
pigment	pigmentas
gebalanseerde	subalansuotas
gebalanseerde	subalansuota
nix	nix
naamlose	bevardis
afer	afer
teresa	teresa
sachalin	sachalino
apis	apis
cholera	choleros
sinatra	sinatra
alida	alida
attr	attr
filologie	filologija
aanspreeklik	atsakingus
aankope	pirkimas
aankope	pirkti
aankope	pirkimo
aankope	pirkimo
aankope	pirkimai
aankope	pirkimas
aankope	pirkimo
orpheus	orfėjas
afwisselende	kintamoji
afwisselende	saulėtos
kimi	kimi
suffolk	safolko
ego	ego
ego	aidas
wladiwostok	vladivostoko
bonaire	boneras
uppsala	uppsala
civic	pilietinių
civic	pilietinis
belle	belle
passasier	keleivis
passasier	keleivinis
horace	horacijus
raspoetin	rasputinas
skending	pažeidimas
skending	pažeidimo
manipulasie	manipuliavimo
potlood	pieštukas
moroka	moroka
kenya	kenijoje
kenya	kenija
kenya	kenijos
habilis	habilis
onvolledig	išsamūs
ocinsoutput	ocinsoutput
kirk	kirk
races	lenktynes
sullivan	sullivan
makro	makro
deutsches	deutsches
aspirasies	siekius
aspirasies	siekiai
schmitt	schmitt
entalpie	entalpija
bernardino	bernardino
toevallige	atsitiktinio
fleet	laivyno
fleet	laivynas
tromp	tromp
sportsoort	sportui
sportsoort	sporto
sportsoort	sportas
arte	arte
irma	irma
minsk	minsko
biomassa	biomasė
biomassa	biomasės
piccolomini	piccolomini
veras	veras
geforseer	priverstinis
ankers	inkarai
burns	dega
betty	betty
ipad	ipad
bridges	tiltai
carroll	carroll
chen	čen
archibald	archibald
stokperdjie	hobis
aanvoer	švino
cora	kora
bodhisattva	bodhisatva
benevento	benevento
tribus	tribus
haus	haus
cory	cory
archimedes	archimedas
lexington	leksingtono
kobe	kobe
heston	heston
dpm	dpm
fulda	fulda
cry	verkti
mist	rūko
quechua	kečua
gewete	tikėjimo
gewete	tikėjimas
gewete	įsitikinimas
velvet	velvet
payne	payne
gestroop	reidus
gdansk	gdansko
oproepe	skambučius
bale	bale
grootouers	seneliai
hansen	hansen
centropus	centropus
friedman	friedman
warwick	warwick
equus	equus
baäl	baalas
thrakië	trakijos
rit	ri
exeter	exeter
pythagoras	pitagoras
mates	matavimo
mates	matavimas
mates	matavimai
antigua	antigva
hirosjima	hirosima
neon	neonas
rat	žiurkės
rat	žiurkė
tokelau	tokelau
stringe	stygas
jahn	jahn
verstryk	eksportuoti
verstryk	eksportas
verstryk	baigęs
betoging	protestas
betoging	protestuoti
netanyahu	netanyahu
amfibieë	varliagyviai
humanisme	humanizmas
opvoeders	pedagogai
turbine	turbina
guadeloupe	gvadelupa
lojale	ištikimas
jenkins	jenkins
zen	zen
opsporing	aptikimas
opsporing	aptikimo
sorghum	sorgų
passeriformes	passeriformes
gebid	meldėsi
desperate	beviltiška
cornell	kornelio
logistieke	logistika
logistieke	logistikos
joost	joost
clarendon	clarendon
misleidend	klaidinantis
misleidend	klaidinančios
misleidend	klaidinanti
whitney	whitney
resies	lenktynių
archangelsk	archangelskas
halfgeleier	puslaidininkių
poznań	poznanėje
ara	ara
ffa	ffa
wisotski	vysockis
spier	raumenys
spier	raumenų
orientalis	orientalis
kosmologie	kosmologija
mamelodi	mamelodi
combined	kombinuotosios
melissa	melisa
soldier	kareivis
soldier	karys
uittreksel	ekstraktas
uittreksel	išrašas
uittreksel	ištrauka
vloek	prakeiksmas
amenemhat	amenemis
oplosbaarheid	tirpumas
barberini	barberini
belge	belge
dracula	drakula
erfurt	erfurt
schwartz	schwartz
mae	mae
plantae	plantae
begeer	trokšta
jstor	jstor
yukon	jukonas
saamtrek	ralio
chamberlain	chamberlain
wegkruip	slepiasi
robustus	robustus
lengtegraad	ilguma
lengtegraad	ilgumos
gekoördineerde	koordinuoti
kaneel	cinamono
cossypha	cossypha
zac	zac
bekostigbare	prieinamas
zoroastrisme	zoroastrizmas
verpligting	pareiga
verpligting	įsipareigojimas
verpligting	įpareigojimas
heining	tvoros
heining	tvora
intern	vidaus
sellulêre	ląstelių
bee	bitės
bee	bičių
bee	bi
worstel	kovoja
blantyre	blantairas
fascisme	fašizmas
hernán	hernán
fawkes	fawkes
deling	kvadratas
lwif	lvovo
berger	berger
sus	susu
tand	dantis
tand	dantų
lokval	spąstai
lokval	gaudyklė
lokval	gaudyklės
wierook	smilkalus
onvolledige	išsamūs
eindelose	begalines
rossi	rossi
installasies	įrenginiai
installasies	įrengimai
optimisme	optimizmo
toulon	tulono
griffith	griffith
université	université
aardbol	gaublį
eerlik	atvirai
liefdadigheid	labdara
liefdadigheid	labdaros
amplitude	amplitudės
niagara	niagaros
ndola	ndola
opsetlik	tyčia
maät	maat
duidelikheid	aiškumas
duidelikheid	aiškumo
ancona	ancona
koöperatiewe	kooperatyvas
byeboerdery	bitininkystės
fanny	fani
vauxhall	vauxhall
growth	augimas
growth	augimo
allianz	allianz
opus	opus
klinieke	klinikų
vermis	trūksta
bantam	bantam
mustang	mustang
herskep	atkurti
sysop	sysop
sorteer	trumpa
sorteer	trumpi
sorteer	trumpai
sorteer	trumpas
playstation	playstation
hiragana	hiragana
imf	tvf
fiesta	fiesta
dieter	dieter
vytautas	vytautas
geyser	geizeris
skouspel	coachella
jasper	jaspers
vrymoedigheid	suvartojimas
vrymoedigheid	sunaudojimas
railways	geležinkeliai
versoenbaar	suderinama
kwasar	kvazaras
davy	deivis
wingerd	vynuogynų
nimf	nimfa
göring	göring
ruiz	ruiz
hawke	hawke
kaizer	kaizer
donkie	asilas
dukkha	dukkha
chopin	šopeno
sharon	šeron
datsun	datsun
lucien	lucien
munro	munro
hemp	marškiniai
hemp	marškinėliai
geblokkeer	užblokuotas
tvl	tuvalu
rover	rover
lila	lilė
aya	hagia
aya	aya
beat	nugalėti
galba	galba
georgi	georgijus
markgraaf	markgrafas
zedong	dzedunas
bjorn	bjorn
yao	yao
roa	roa
matte	matinis
vettel	vettel
opgebruik	išnaudojimas
basoetoland	basutolandas
wikisource	vikišaltiniai
hippodroom	hipodromas
gum	guma
gum	derva
gum	gumos
mining	kasyba
mining	kasybos
gallinago	gallinago
forseer	force
afra	afra
chaplin	čaplinas
blameer	kaltinti
glimlag	šypsena
glimlag	šypsenos
glimlag	šypsosi
xix	xix
husserl	husserl
basters	šunsnukiai
michelin	michelin
gerief	patogumo
jaguar	jaguar
wolff	wolff
damon	deimonas
yvonne	yvonne
cellpadding	cellpadding
avon	avon
fermi	fermi
dolor	dolor
thor	toras
penn	penn
absint	absento
ling	ling
herorganiseer	reorganizuoti
hendricks	hendriksas
baptist	baptistų
estetika	estetika
tierra	tierra
clan	klano
mystery	marijos
mystery	paslaptis
wand	lazdelė
codex	codex
vor	vir
imagesize	imagesize
cluny	kliuni
sirkonium	cirkonio
kundiges	ekspertai
barset	barset
hodgson	hodgson
fahd	fahd
marty	marti
noble	inertinių
mpla	mpla
borrel	burbulas
noag	nojus
hibried	hibridų
hibried	hibridai
rosso	rosso
fin	fin
gagarin	gagarinas
tommaso	tommaso
schiller	šilerio
weiveld	pievų
weiveld	pievos
caf	caf
kameelperd	žirafa
gunstelinge	mėgstami
gunstelinge	mėgstamiausių
abrahams	abrahams
flavius	flavijus
spoleto	spoleto
fsb	fsb
kaïda	qaeda
ipv	ipv
roofdier	carnivora
sirkus	cirko
sirkus	cirkas
dye	dažai
dye	dažiklis
dye	dažų
etes	valgius
prostitute	prostitutė
felidae	katiniai
seep	muilo
seep	muilas
stowe	stowe
gemoedstoestand	nuotaikos
gemoedstoestand	nuotaika
uci	uci
korean	korėjos
wsewolod	vsevolodas
palanga	palanga
palanga	palangos
hollander	olandas
lucky	pasisekė
paramaribo	paramaribas
sulawesi	sulavesis
arab	arabų
karlsruhe	karlsruhe
padua	padua
pergamon	pergamas
sikloon	ciklono
austen	austen
nabokov	nabokovas
cro	cro
vicente	vicente
gyatso	gyatso
imola	imola
athena	athena
oesters	austrių
oesters	austrės
heerlike	super
parthenon	partenonas
biosfeer	biosferos
geanimeerde	animacinis
hartman	hartman
anatomiese	anatominių
aden	adeno
edmonton	edmonton
eugenio	eugenio
elder	vyresnysis
liggaamsbou	bodybuilding
klassiek	klasikinis
poemas	poemas
speak	kalbėk
speak	kalbėti
mosaïek	mozaikos
belt	diržo
belt	diržas
geweldadige	smurtinių
wendy	vendi
turkish	turkijoje
turkish	turkija
turkish	turkų
turkish	turkijos
gurdjieff	gurdžijevas
voetnotas	išnašas
voetnotas	išnašos
semen	sperma
semen	spermos
aries	aries
tatra	tatrų
challenge	iššūkis
gala	gala
geure	kvapų
demone	demonai
rites	apeigomis
cassius	dio
guinness	gineso
arsenal	arsenal
sino	sino
wisjnoe	višnaus
verslaggewers	žurnalistų
elise	eliza
koerdies	kurdų
intens	intensyvus
intens	intensyvi
katherine	katerina
odusseus	odisėjas
narmer	narmeras
balke	barų
transatlantiese	transatlantinės
paartjies	porų
pompe	siurbliai
exploration	žvalgyba
exploration	žvalgybos
exploration	žvalgymo
raaisel	molekulių
chewa	čevų
gearriveer	atvyko
lekkergoed	saldainis
oppad	ateina
oppad	ateinu
oppad	ateis
logaritme	logaritmas
rocco	roko
isfahan	isfahanas
bono	bono
heidelbergensis	heidelbergensis
jos	džoso
trondheim	trondheimas
isabelle	izabele
sapporo	saporas
domitianus	domicianas
cortina	kortina
atkinson	atkinson
hominidae	hominidai
wegbreek	pabėgimo
bert	bert
pmid	pmid
keynes	keynes
tarentaal	patarška
verkoeling	šaldymo
naturalis	naturalis
qatar	kataras
gemaklike	laisvai
adverteer	reklamuoti
tyler	taileris
tyler	smėlis
apteek	vaistinės
apteek	vaistinė
ramón	ramón
rosberg	rosberg
amiens	amiens
tiwa	tuva
cnn	cnn
athlone	athlone
laboratoriums	labs
laboratoriums	laboratorijos
laboratoriums	laboratorijų
dragon	dragon
nowosibirsk	novosibirskas
kaiser	kaiser
ieee	ieee
gerhardt	gerhardt
gen	gen
stefano	stefano
miquelon	mikelonas
dassault	dassault
amalia	amalia
helper	padėjėjas
helper	pagalbininkas
ismail	ismail
nagereg	desertas
toetankamen	tutanchamonas
sfsr	sfsr
salmon	lašišos
salmon	lašiša
interval	intervalas
vanielje	vanilės
tasman	tasmano
maseru	maseru
hutchinson	hutchinson
besmette	užkrėsta
kemal	kemal
bolívar	bolivaras
winfrey	winfrey
pritchard	pritchard
masker	kauke
masker	kaukė
iaaf	iaaf
gallium	galio
gestremde	išjungti
kierkegaard	kierkegaard
sforza	sforza
mariner	mariner
manipuleer	manipuliuoti
ongelykheid	nelygybė
donkerte	tamsa
duiwels	demonai
brocken	brokeno
kartel	kartelis
kartel	kartelio
geoffroy	geoffroy
jeanette	žaneta
dir	dir
nam	nam
isla	isla
volt	voltas
vrywilliger	savanorišką
farrell	farrell
aanbreek	konferencija
engineers	inžinieriai
ontruiming	evakuacija
indium	indžio
vice	vice
excel	excel
bemesting	trąšų
bemesting	trąšos
lublin	liublino
graffiti	graffiti
mouton	mouton
agrippa	agripa
interieur	interieur
boots	apsimeta
spvgg	spvgg
isn	isn
nicole	nicole
liststyle	liststyle
swan	gulbė
artes	artes
fortaleza	fortaleza
romano	romano
agtervoegsels	priesagos
veto	veto
somaliese	somalio
vesta	vesta
gmina	palenkės
entoesiasme	entuziazmo
entoesiasme	entuziazmas
reinheid	grynumas
volvo	volvo
dominansie	dominavimo
gottlob	gottlob
bali	balio
mil	mil
maud	maud
krisisse	krizių
pretty	gan
pretty	gana
werkloos	bedarbiai
werkloos	bedarbis
porta	porta
tamatie	pomidorų
tamatie	pomidorai
brahmi	brahmi
ottoman	osmanų
oortuigende	įtikinamas
oortuigende	įtikinama
zane	zane
strandkiewiet	kirlikas
versending	laivybos
versending	laivyba
versending	shipping
celine	celine
eliza	elzė
benguela	bengelos
austronesiese	austronezinės
koëffisiënt	koeficientas
nowiki	nowiki
opgradering	atnaujinimas
opgradering	atnaujinta
opgradering	modernizavimas
krale	karoliukai
betrap	nuošalėje
trompet	trimitas
usd	usd
darren	darren
verkenner	skautų
verkenner	explorer
joey	džo
installering	diegiamos
vyfkamp	penkiakovė
holoseen	holocenas
juk	itch
konsolideer	konsoliduoti
prostitusie	prostitucija
inkomende	gauta
inkomende	ateinantys
memoirs	memuarus
ilja	ilja
stonehenge	stounhendžas
abdullah	abdullah
giambattista	giambattista
deskundige	specialistų
onderskep	perėmimas
gewelddadig	smurtinių
edouard	edouard
académie	académie
geaktiveer	įjungtas
kara	kara
bradbury	bredberio
sitkamer	lounge
villages	kaimų
villages	kaimai
roses	rožės
bray	bray
roald	roald
anno	anno
horizonte	horizontė
šiauliai	šiauliai
šiauliai	šiauliuose
šiauliai	šiaulių
chang	chang
kameel	camel
gateway	vartai
sheila	šeila
bandeira	bandeira
aymara	aimarų
interior	interjero
jaloers	pavydžiu
jaloers	pavydi
singh	singh
rower	plėšikas
doelgerigte	suderintų
messe	peilius
messe	peiliai
germanicus	germanikas
fusie	sintezės
haumea	haumea
uri	uri
vragmotor	sunkvežimis
zip	zip
tiran	tironas
uli	uli
verdof	blur
schloss	schloss
hausa	hausų
faq	duk
refleksie	atspindys
refleksie	atspindžio
leander	leander
sesium	cezio
beledig	žeidžia
beledig	įžeidimų
rewolwer	revolveris
workers	darbininkai
workers	darbuotojai
workers	darbininkų
pskof	pskovo
pride	pasididžiavimas
achille	achille
turing	tiuringo
reginald	reginald
toch	toch
kinshasa	kinšasa
tica	tica
fenotipe	fenotipas
mergedtoprow	mergedtoprow
bradshaw	bradshaw
mayo	majas
mcintyre	mcintyre
instem	sutinka
taliban	talibano
regensburg	rėgensburgas
diplomate	diplomate
sie	sie
verewig	amžinai
stormloop	rush
marcello	marcello
aangehoor	girdėjau
colt	colt
mika	mika
feminisme	feminizmas
mufulira	mufulira
vrot	supuvę
patagonië	patagonia
hemingway	hemingvėjus
bevoorregte	privilegijuotas
erika	erika
chabarofsk	chabarovske
dolly	dolly
championship	čempionatas
championship	čempionato
dok	doc
poskaart	atvirukas
eksistensialisme	egzistencializmas
gevries	užšaldyti
oval	ovalios
sage	sage
toegedraai	suvynioti
meso	mezo
serge	serge
entropie	entropija
teenstrydighede	konfliktų
aandete	vakarienė
trauma	trauma
lily	lily
sigbaarheid	prieiga
sigbaarheid	prieinamumo
sigbaarheid	prieinamumas
cool	jėga
cool	kietai
willis	willis
choefoe	cheopsas
białystok	balstogės
coventry	coventry
gfdl	gfdl
enlil	enlilis
concordia	concordia
ame	amg
doppler	doplerio
poitiers	puatjė
arlington	arlingtonas
rutherford	rutherford
druppel	atleisti
regbank	teismai
aartappel	bulvės
aartappel	bulvių
kubus	kubą
epe	epe
cornwallis	kornvaliso
batman	betmenas
vure	gaisrai
vure	gaisrų
hui	hujų
middagete	pietus
middagete	pietų
middagete	pietūs
mendelssohn	mendelssohn
hai	haida
punk	punk
dagestan	dagestane
camillo	camillo
morawië	moravijos
hymn	giesmė
altieri	altieri
juno	juno
wording	formuluotė
oskar	oskar
rodriguez	rodriguez
kers	žvakė
capricorn	ožiaragis
rek	siekiu
eustatius	eustatijus
dudley	dudley
pocket	kišenės
albani	albani
volstruis	strutis
amen	amen
bleu	bleu
conan	conan
karmapa	karmapa
saba	saba
moctezuma	montesuma
lemme	peiliukai
kommentator	komentatorius
flensburg	flensburgas
tech	tech
graves	duobes
corbusier	corbusier
angkor	ankor
matthews	matthews
manu	manu
ost	ost
vasberadenheid	ryžtas
guerre	guerre
vasari	vasari
ilse	ilse
innovasies	naujovės
stamp	antspaudas
mioseen	miocenas
seleukidiese	seleukidų
eekhoring	voverė
sinus	sine
frodo	frodo
valparaíso	valparaiso
kole	anglys
kole	anglis
rabbi	rabinas
belgica	galija
duck	and
duck	antis
hassan	hasanas
doha	dohos
kriek	kriek
intervensie	intervencija
casablanca	kasablankos
publius	publius
klier	liauka
aandrywer	vairuotojai
aandrywer	vairuotojų
aandrywer	vairuotojo
aandrywer	mašinistas
aandrywer	vairuotojas
aandrywer	vykdyti
warrior	karys
arxiv	arxiv
achmatowa	achmatova
wittgenstein	wittgenstein
durand	durand
vurk	šakės
vermeerdering	stiprintuvas
gravitasie	trauka
baird	baird
bariton	baritonas
phoenicurus	raudonuodegės
kriptografie	kriptografija
quintus	kvintas
sahel	sahel
biochemie	biochemija
nellie	nellie
drs	daktarus
sims	sims
pret	smagu
pret	smagiai
pret	linksma
pret	linksmai
felice	felice
deborah	debora
pootjies	letenas
hergé	hergé
luanda	luanda
eggo	skardus
naak	nude
rick	rikai
montoya	montoya
berbers	berberai
bantoestan	tėvynę
kubisme	kubizmo
hampton	hampton
pyplyn	vamzdynų
pyplyn	vamzdynas
tsjeljabinsk	čeliabinskas
lennon	lenonas
calvin	kalvinai
micene	mikėnai
courier	kurjeris
mama	mama
lilongwe	lilongvė
challenger	arenos
civitas	civitas
kleinschmidt	kleinschmidt
annette	anetė
fußball	fußball
chef	šefas
medusa	medūza
strokiesverhaal	comics
alegre	alegre
jas	paltą
adriana	adriana
moulin	moulin
cuculus	cuculus
matrix	matrica
matrix	matricos
ups	ups
waarskuwings	įspėjimai
royale	royale
generator	generatorių
generator	generatorius
titlestyle	titlestyle
gelug	gelug
aha	aha
dou	dou
reilly	reilly
sianied	cianidas
sianied	cianido
helene	helena
stephenson	stephenson
guerrilla	partizanų
bikini	bikini
epilepsie	epilepsija
epilepsie	epilepsijos
hartley	hartley
uitsonderlik	išskirtinės
uitsonderlik	išimtiniais
uitsonderlik	išimtinės
teenstrydige	prieštaringų
prairie	prerijų
mills	gamyklų
cyrillies	kirilica
fiji	fidžis
fiji	fidžio
saône	sona
bella	bella
slovo	slovo
sensor	jutiklio
skenker	donorų
skenker	donoras
loopbane	karjerai
loopbane	karjera
loopbane	karjeros
opsy	būstas
estado	estado
soto	soto
toegemaak	uždaryta
toegemaak	uždara
stavanger	stavangeris
haydn	haydn
snake	gyvatės
snake	gyvate
snake	gyvatė
georgetown	wau
menschen	menschen
vergetelheid	oblivion
herroeping	panaikinimas
abessiniese	abisinijos
eoseen	eocene
torre	torre
polaris	polaris
rotorua	rotorua
bourgeoisie	buržuazija
xxx	xxx
kostroma	kostroma
kafka	kafka
etal	etal
genie	genijus
genie	džinas
broad	platus
broad	plati
nîmes	nîmes
dorje	dorje
hemde	marškiniai
nuuskierigheid	smalsumo
basketball	krepšinio
tórshavn	torshaunas
krasnojarsk	krasnojarsko
byrd	byrd
gasvryheid	svetingumą
zeitung	zeitung
mamma	mamma
tinto	tinto
ion	jonų
helios	helios
insidente	incidentų
insidente	incidentai
nocat	nocat
piesang	bananų
benaderde	apytikslis
jacqueline	jacqueline
konserwatisme	konservatizmo
krasnodar	krasnodar
feuerbach	feuerbach
coris	coris
dispute	ginčai
tug	vilkiko
tug	vilkikas
dalarna	dalarnos
sabina	sabina
cosworth	cosworth
fatih	fatih
bergson	bergson
illustreerder	iliustratorius
bestuiwing	apdulkinimo
silvestris	silvestris
klawer	klubai
blanco	blanco
snaakse	juokinga
rwd	rwd
continental	continental
mendelejef	mendelejevas
indiensneming	užimtumas
indiensneming	įdarbinimas
kenyatta	kenyatta
bursa	bursa
jérôme	jérôme
inisiatiewe	iniciatyvas
inisiatiewe	iniciatyvos
derrida	derrida
produktief	produktyvus
magnetisme	magnetizmas
piero	piero
overture	uvertiūra
weir	weir
carcharhinus	carcharhinus
hina	hina
romulus	romulas
morne	morn
arras	arasas
tupolev	tupolev
vieringe	šventės
juliana	juliana
herbst	herbst
astrachan	astrachanės
dwight	dwight
hertzsprung	hercšprungo
vulgaris	vulgaris
bayern	bayern
baja	baja
voltaire	voltaire
kundige	ekspertas
skildklier	skydliaukės
epistemologie	epistemologija
flow	srauto
flow	srautas
wulf	wulf
nordic	šiaurės
besoekte	lankėsi
helaas	deja
kapsule	kapsulė
kapsule	kapsulės
dauphiné	dauphiné
hatsjepsoet	hačepsuta
asbes	asbesto
asbes	asbestas
atticus	atikas
shizuoka	šidzuokos
tshabalala	tshabalala
diagramme	schemos
wylie	vailio
ina	ina
tethys	tetija
boogskiet	lankininkų
ulm	ulmas
kraakbeen	kremzlių
plakkate	plakatai
nadine	nadine
karmeliete	karmelitai
landings	iškrovimo
repin	repinas
doe	doe
bevredigende	atitinkančiu
ganges	ganga
brahms	bramsas
windpomp	malūnas
mick	mikai
sunda	sundos
pogroms	pogromų
arturo	arturo
burma	birmos
burma	birma
burma	birmoje
dief	vagis
jomo	jomo
skerpioene	scorpions
burgess	burgess
vannes	vannes
walton	walton
kirsten	kirsten
keller	keller
pcupdate	pcupdate
kêrel	vaikinas
bradford	bradford
kemerowo	kemerovas
oahu	oahu
ongelooflik	nuostabu
ongelooflik	nuostabus
ongelooflik	nuostabi
ongelooflik	neįtikėtina
chandra	chandra
heroes	didvyriai
weiß	weiß
julien	julien
bhp	bhp
eve	ieva
imam	imam
leila	leila
pocock	pocock
orientales	kantonuose
maharashtra	maharaštros
drywer	vairuotojo
drywer	mašinistas
drywer	vairuotojas
android	android
seti	seti
subst	subst
portsmouth	portsmouth
gale	neteisingą
pulitzer	pulicerio
veroudering	senėjimo
nette	tinklai
andaman	andamanų
funksioneel	funkcinė
funksioneel	funkcinis
funksioneel	funkcinių
evelyn	evelina
hindernis	kliūtis
blonde	blondinė
alfons	alfons
bernstein	bernstein
gek	apgauti
soefisme	sufizmas
universität	universität
sjef	šefas
lindgren	lindgren
konkordaat	konkordatas
fellini	fellini
limes	laimai
patrollie	patruliavimo
lip	lūpų
madre	madre
petite	petite
freda	freda
martínez	martínez
varus	varus
iraniërs	iraniečiai
skroef	velniop
arafat	arafat
avalon	avalon
dumas	diuma
claus	klausas
swiss	šveicarijos
swiss	šveicarija
pacelli	pacelli
lan	lan
ulysses	ulysses
neckar	neckar
verbande	uždraustos
gore	gore
gordyne	užuolaidos
gem	gem
mapuche	mapudungunų
esau	esau
whiskey	viskio
whiskey	viskis
prospero	prosperas
monza	monza
yesno	yesno
grave	kapo
landgraaf	landgrafas
elba	elba
wagon	vagonas
wagon	vežimo
syn	syn
kennisgewings	pranešimai
sitrus	citrusinių
bril	akiniai
claudia	claudia
benetton	benetton
pappa	tėti
pappa	tėtis
exhibition	parodos
exhibition	paroda
slapende	miegas
slapende	miega
slapende	miegu
djainisme	džainizmas
olav	olav
nicolai	nicolai
ava	ava
lepel	šaukštu
wreedheid	žiaurumas
billiton	billiton
kopal	kopalis
lordi	lordi
romana	romana
samevatting	virškinti
spinoza	spinoza
amateurs	mėgėjai
marlon	marlon
farmer	ūkininkas
administreer	daromi
mathilde	mathilde
nylon	nailono
kitwe	kitvė
sung	sung
maksimiliaan	maximilian
dubai	dubajaus
kathleen	karin
uwe	nuoširdžiai
vidal	vidal
katanga	katanga
azof	azovo
elektromagnetisme	elektromagnetizmo
afdrukke	spausdina
augustin	augustin
salle	salle
kazimierz	kazimieras
fontaine	fontaine
topkapi	topkapi
nikolaus	nikolaus
polio	poliomielito
voog	globėjas
trok	sunkvežimis
khaled	khaled
middleton	middleton
duisburg	duisburg
skande	gėda
hael	šlovė
hael	kruša
tiaan	taileris
tiaan	smėlis
polimere	polimerai
polimere	polimerų
inmeng	kištis
worms	kirmėlių
aanslae	reitingais
aanslae	reitingų
aanslae	reitingai
mishandel	mergaitės
mishandel	mergaites
mishandel	merginos
caspar	kasparas
sienna	sienna
mahmoed	mahmud
peer	kriaušės
peer	kriaušių
lacaille	lacaille
paradoks	paradoksas
sunny	saulėta
jalisco	chalisko
poets	suplanuotas
whitman	whitman
bae	bae
entente	antantė
inleidende	įvadinė
inleidende	įvadinis
knaagdier	graužikų
knaagdier	graužikai
bahn	bahn
marathi	marathų
passion	aistra
donetsk	donecko
chirurg	chirurgas
lccn	lccn
benny	benny
philippines	filipinai
aftrek	atimtis
ereksie	erekcijos
diewe	vagys
haut	haut
simons	simons
magnum	magnum
pueblo	pueblo
biskaje	biskajos
demille	demille
sid	sidamo
legacy	palikimas
toemaak	uždaryti
toemaak	glaudžiai
toemaak	užverti
wolgograd	volgogrado
niobium	niobio
geurige	aštrus
regina	regina
dophou	saugok
dophou	prižiūrėti
alleenloper	vienišius
c++	c++
kaserne	kareivines
elwe	elfai
clifford	clifford
alphonse	alfonsas
veracruz	verakrusas
díaz	díaz
futuna	futūna
christophe	christophe
tnt	tnt
irritasie	dirginimo
irritasie	dirginimas
persona	persona
defence	gynyba
defence	gynybos
ronaldo	ronaldo
indica	indica
honneur	honneur
mata	mata
houtwerk	dailidžių
instruksie	instrukcijos
instruksie	mokymas
begonia	modifikavo
olympique	olympique
emmys	emmys
kreool	kreolų
witt	witt
rowers	vagys
yunnan	junano
frida	frida
haakon	hakonas
bradley	bradley
hernuwing	atnaujinimas
hernuwing	atnaujinimo
hernuwing	pratęsimas
punta	punta
braking	stabdymo
braking	stabdžiai
braking	stabdymas
mickey	mikis
mickey	miki
brain	smegenys
brain	smegenų
hdtv	hdtv
haile	haile
publicationdate	publicationdate
bagration	bagrationas
wir	wir
pavilion	paviljone
beast	žvėris
mcleod	macleod
oomblikke	momentus
oomblikke	akimirkos
oomblikke	momentai
oomblikke	akimirka
oesbekies	uzbekų
bloch	bloch
childeric	childerikas
bms	bms
hoes	kosulys
hoes	kapliai
tjek	čekių
tjek	čekis
fregat	fregata
stoke	stoke
leek	porai
cayenne	cayenne
cholesterol	cholesterolio
formosa	formosa
luidsprekers	kalbėtojai
luidsprekers	kalbėtojų
annan	annan
nageregte	desertai
nageregte	desertas
borges	borges
discolor	discolor
septimius	septimijus
hadid	hadid
mummies	mumijos
patrys	kurapka
verwarrend	paini
blackburn	blackburn
senoesret	senusretas
wien	wien
bewonderaars	fanai
twain	tvenas
roepee	rupija
brendon	brendon
vroom	vroom
onbeperk	bevardis
crane	kranas
troues	vestuvės
troues	vestuves
konsultant	konsultantas
verpletter	naikinimas
azteca	azteca
miracle	stebuklas
rano	rano
accent	akcentas
worlds	pasauliai
gips	gipso
wehrmacht	vermachto
mammals	žinduoliai
mammals	žinduoliams
wonderlik	nuostabios
wonderlik	nuostabu
wonderlik	nuostabūs
wonderlik	nuostabus
wonderlik	nuostabaus
wonderlik	nuostabu
wonderlik	nuostabios
wonderlik	nuostabus
wonderlik	nuostabi
wonderlik	puikiai
wonderlik	puiku
wonderlik	puiki
seychelles	bethel
abs	abs
gestremdheid	negalia
gestremdheid	negalią
forrest	forestas
trokke	sunkvežimiai
trokke	sunkvežimių
rider	raitelis
