alfonso	alfons
alfonso	alfonso
milner	milner
orion	orion
orion	orió
bst	bst
ogg	ogg
movement	moviment
molekule	molècula
garde	avantguardes
alba	alba
mini	mini
johns	johns
kabel	cable
igor	ígor
igor	igor
voorvaders	avantpassats
knope	nusos
eksklusiewe	exclusiu
eksklusiewe	exclusiva
wallace	wallace
beampte	oficial
sparta	esparta
konsentrasies	concentracions
schmidt	schmidt
erectus	erectus
kapitalisme	capitalisme
speaker	altaveu
kubrick	kubrick
yslands	islandès
jeff	jeff
voorvoegsel	prefix
osiris	osiris
pot	olla
luigi	luigi
muir	muir
philips	philips
argaïese	arcaic
walvis	balena
namibia	namíbia
behulpsaam	útils
sleutels	claus
sleutels	tecles
rebels	rebels
zanzibar	zanzíbar
kirchner	kirchner
julia	julia
julia	júlia
hardeware	maquinari
anas	anas
imperial	imperial
voorgeskryf	prescrit
uitdaging	challenge
uitdaging	repte
uitdaging	desafiament
emmanuel	emmanuel
gelykheid	igualtat
dale	dale
koen	koen
lint	pelussa
balkan	balcànica
jeffrey	jeffrey
modernisme	modernisme
parade	desfilada
parade	rua
detroit	detroit
hun	hun
algoritme	algorisme
algoritme	algoritme
palm	palm
bosbou	forestal
uitgeput	exhaurit
uitgeput	esgotat
uitgeput	esgotats
uitgeput	esgotada
uitgeput	drenada
realistiese	realista
realistiese	realistes
ajax	ajax
foster	foster
pype	pipes
pype	canonades
pype	focs
linden	linden
urban	urban
opgelaai	pujat
zur	zur
ontspanning	recreació
ontspanning	esbarjo
ontspanning	oci
ontspanning	lleure
promosie	promo
promosie	promoció
robin	robin
simba	simba
fortuin	fortuna
monopolie	monopoly
monopolie	monopoli
diamond	diamond
diamond	diamant
etiese	ètic
brandwag	sentinel
oudio	àudio
lama	lama
mig	mib
vergroting	creixent
geraas	soroll
romp	tors
neurenberg	nuremberg
tekening	dibuix
lawa	lava
swembad	piscina
ritme	beat
kas	cas
uss	uss
gewas	quist
streef	perseguir
orléans	orleans
deelnemer	participant
paneel	panell
paneel	plafó
formate	formats
griep	grip
marmer	marble
marmer	marbre
alkoholiese	alcohòlica
alkoholiese	alcohòlic
andrews	andrews
viëtnamese	vietnamita
viëtnamese	vietnamites
beethoven	beethoven
komende	pròximes
komende	propers
komende	properes
subordo	subordo
dapperheid	valentia
bord	tauler
bord	junta
lombard	lombard
hol	fondalada
hol	hollow
haute	haute
versterkte	reforçat
aurora	aurora
michelangelo	michelangelo
titus	tit
titus	titus
plig	deure
filippynse	filipí
iberiese	ibèric
hiërargie	jerarquia
unix	unix
ruan	ruan
lowry	lowry
burg	burg
patriot	patriota
dyk	dyk
eksentrisiteit	excentricitat
haïti	haití
wedersydse	mutual
wedersydse	mútues
wedersydse	mútua
wedersydse	mutu
calais	calais
mehmet	mehmet
jamestown	jamestown
connecticut	connecticut
dick	dick
afrodite	afrodita
aap	mico
aap	cercopitec
pleistoseen	plistocè
motivering	motivació
guillaume	guillaume
aftree	jubilar
simfonie	simfonia
djengis	genghis
sinagoge	sinagoga
proteïen	proteïna
proteïen	proteïnes
tenk	tanc
stoel	cadira
klade	clade
herdruk	reimpressió
digbundel	antologia
reguleer	pràctiques
sophie	sophie
miguel	miguel
oorweging	consideració
oorweging	contraprestació
edik	edicte
galaktiese	galàctic
galaktiese	galàctica
centauri	centauri
jefferson	jefferson
vertonings	espectacles
dickinson	dickinson
verde	verde
lening	préstec
spesifikasies	especificacions
opgehou	aturat
tegnies	tècnicament
gaia	gaia
diaspora	diàspora
desimale	decimal
konferensies	conferències
sony	sony
sony	playstation
rogers	rogers
geweer	fusell
geweer	rifle
verdrae	tractats
gottfried	gottfried
turyn	torí
inkwisisie	inquisició
diktator	dictador
ussr	urss
arriveer	arriba
kritieke	crític
jeremy	jeremy
kleindogter	néta
herald	herald
oorblyfsel	romanent
bobby	bobby
rade	rade
naturelle	naturelle
gamma	gamma
verhuur	arrendament
aankondiging	anunci
beoordeel	taxa
blair	blair
hef	càrrec
regters	magistrats
regters	jutges
diskriminasie	discriminació
verpligtinge	obligacions
plymouth	plymouth
kia	kia
padda	granota
genereer	generar
genereer	genera
reagan	reagan
volwassene	adult
kleredrag	indumentària
kleredrag	confecció
austin	austin
asem	alè
eskader	esquadró
thom	thom
sven	sveinn
allah	allah
heritage	patrimoni
rustige	pacífica
maraton	marató
maraton	marathon
impliseer	implica
dance	dansa
sterte	inclina
sterte	inclinació
sterte	cues
riefenstahl	riefenstahl
never	mai
hoed	barret
onderhandelings	negociacions
implementering	implementació
versoening	conciliació
spook	ghost
spook	fantasma
mabel	mabel
oklahoma	oklahoma
wilhelmina	guillemina
yellow	groc
charadrius	charadrius
inter	inter
amazon	amazon
amazon	amazona
ren	ren
clarke	clarke
hel	hel
loire	loira
loire	loire
woordelys	glossari
njassaland	nyasalàndia
honduras	hondures
beale	beale
drake	drake
lus	mizo
lus	repeteix
lus	bucle
hera	hera
kobus	kobus
verkieslik	preferiblement
verkieslik	preferentment
guardian	tutor
guardian	guardià
guardian	guardian
lessing	lessing
deurlopende	continuat
deurlopende	continuada
pollock	pollock
albrecht	albrecht
aanhouding	retenció
bomme	bombes
ambisieuse	ambiciós
ambisieuse	ambiciosos
hillary	hillary
kolomme	columnes
erich	erich
maine	maine
joernalistiek	periodisme
argiewe	arxius
artillerie	artillerie
stadions	estadis
innsbruck	innsbruck
maagdenburg	magdeburg
beck	beck
miranda	miranda
koors	febre
agtien	divuit
atlanta	atlanta
mod	mod
smithfield	smithfield
uitbreidings	connectors
uitbreidings	extensions
uitbreidings	pròrrogues
uitbreidings	ampliacions
uitbreidings	descripció
lille	lille
rudi	rudi
sean	sean
afhanklikheid	dependència
potter	potter
botter	mantega
car	carib
kosbare	valuós
kosbare	valuosa
theodorus	theodore
theodorus	teodor
balk	barra
balk	bar
peyper	peyper
krimp	encongeix
bespeur	detectats
bespeur	detectat
kilometers	kilòmetres
michiel	michiel
paschalis	pasqual
arles	arle
muise	ratolins
bauhaus	bauhaus
temple	temple
duik	busseig
duik	salts
duik	immersió
auguste	auguste
tamil	tamil
roussillon	rosselló
verpligtend	obligatori
hester	hester
korporatiewe	corporatives
korporatiewe	corporativa
ffff	ffff
bin	bini
aboe	abu
eurasië	euràsia
stilte	silenci
netto	net
burundi	burundi
antille	antilles
gotha	gotha
toere	tours
hop	hop
hop	rebota
sisulu	sisulu
brunswyk	braunschweig
yuan	yuan
kabeljou	bacallà
falkland	falkland
veelsydige	versàtil
beers	beers
beers	cerveses
spieël	mirall
cézanne	cézanne
karnaval	carnaval
karnaval	carnestoltes
voyageur	voyageur
eagle	àguila
eagle	àliga
tegnologieë	tecnologies
perseus	perseu
charon	caront
verbeterings	millores
vandalisme	vandalisme
freud	freud
youthyears	youthyears
nineve	nínive
abell	abell
besmet	infectats
bevoegdhede	atribucions
bevoegdhede	competències
bevoegdhede	poders
claremont	claremont
binêre	binària
binêre	binari
hitchcock	hitchcock
vandale	vàndals
diagnose	diagnosi
diagnose	diagnòstic
omsingel	envolten
vennote	socis
ervare	perit
ervare	expert
australis	australis
bewustheid	conscienciació
bewustheid	sensibilització
simpatie	condol
katalaanse	catalan
katalaanse	català
verdrink	ofegar
doodmaak	kill
doodmaak	mata
valse	fals
valse	fake
debatte	debats
chemikalieë	químics
dahmer	dahmer
bulgare	búlgars
antwoorde	respostes
antwoorde	respostes
antwoorde	respostes
ontslag	abocament
vierkant	quadrat
vierkant	plaça
adresse	adreces
jamaika	jamaica
indiana	indiana
redding	rescat
redding	salvament
skaap	ovella
skaap	ovelles
skaap	oví
sewentien	disset
tent	tenda
tent	carpa
panthera	panthera
verstaanbaar	comprensible
omar	umar
promoveer	promoguin
haat	odi
korporasie	corporació
korporasie	plc
tiberius	tiberi
hannes	hannes
beheerde	gestionades
beheerde	gestionat
wikitext	wikitext
caroline	caroline
mal	boig
demokrate	demòcrates
pale	pale
ongepubliseerde	inèdita
ongepubliseerde	inèdits
ongepubliseerde	inèdit
mededingende	competitiu
mededingende	competitiva
irving	irving
leone	leone
aflaai	descàrrega
aflaai	descarrega
aflaai	recarrega
ingevoerde	entrat
ingevoerde	importat
ingevoerde	importada
mij	mij
slade	slade
animasie	anima
animasie	animació
animasie	definició
pionier	pioneer
sve	cpu
boulevard	boulevard
boulevard	bulevard
bach	bach
supernovas	supernoves
lisa	lisa
marine	marine
norfolk	norfolk
cardiff	cardiff
omgekeer	reverteix
onwaarskynlik	improbable
denver	denver
philipp	philipp
webjoernaal	blog
webjoernaal	bloc
nasaret	nazaret
nasaret	natzaret
stralsund	stralsund
bel	convocatòria
bel	trucada
resepte	receptes
loubser	crèdits
klaas	klaas
bristol	bristol
greenwich	greenwich
altvar	altvar
abc	abc
ondermyn	empenyent
ondermyn	impulsant
baha	baha
skenking	donació
arnoldus	arnoldus
boheme	bohèmia
verklein	encongeix
verklein	minimitza
presbiteriaanse	presbyterian
christina	christina
internationale	internationale
kitchener	kitchener
janse	janse
bester	bester
romagna	romanya
tobie	tobie
helikopter	helicòpter
swapo	swapo
doek	llenç
resep	recepta
bekommerd	preocupat
joel	joel
kentucky	kentucky
musical	musical
pittsburgh	pittsburgh
mowbray	mowbray
harrison	harrison
pakket	paquet
pakket	envàs
pakket	manada
pakket	pack
voetbal	futbol
kemp	kemp
pinyin	pinyin
gekruis	creuat
kalifaat	sokoto
plaza	plaça
gregory	gregori
gregory	gregory
panorama	panorama
vita	vita
jerewan	erevan
clarens	clarens
berry	berry
palermo	palerm
ammoniak	amoníac
levant	levante
werker	treballador
aangedrewe	adeptes
gespikkelde	coral
gespikkelde	corall
nagorno	nagorno
guevara	guevara
identiese	idèntiques
identiese	idèntic
carol	carol
speletjies	jocs
eksperiment	experiment
medikasie	medicació
geïgnoreer	ignoren
geïgnoreer	ignorat
geïgnoreer	ignorats
geesteswetenskappe	humanitats
gister	ahir
shaun	shaun
linie	linie
frits	frits
liechtenstein	liechtenstein
tristan	tristan
telekommunikasie	telecomunicació
telekommunikasie	telecomunicacions
nagte	nits
nêrens	enlloc
genesis	gènesi
genesis	genesis
theodore	theodore
theodore	teodor
versterking	guany
numeriese	numèric
numeriese	numèrica
bahrein	bahrain
wonde	ferida
brett	brett
nikolai	niko
laval	laval
aantekeninge	nota
eddie	eddie
hunne	huns
serie	serie
serie	serial
nsu	nsu
bom	bomba
krappe	crancs
stoot	push
stoot	empeny
estádio	estádio
bundy	bundy
dortmund	dortmund
ptah	ptah
silvester	sylvester
neutrino	neutrí
balle	pilotes
balle	boles
jon	jon
ioniese	jònica
geteister	assetjat
vleuels	wings
vleuels	ales
etanol	etanol
swakopmund	swakopmund
rostof	rostov
che	che
kansas	kansas
herhaling	recurrència
simbolies	simbòlica
simbolies	simbòlics
simbolies	simbòlic
kanariese	canàries
kanariese	canari
pearl	pearl
pearl	perla
vuurpyl	coet
montevideo	montevideo
loof	elogi
loof	elogis
malaria	malària
reisiger	viatger
afmetings	geometria
ikone	icones
zosterops	zosterops
macmillan	macmillan
bakoe	baku
olimpiade	olimpíada
justice	justicia
justice	justícia
mexico	mèxic
vashou	restringeix
kwartaal	trimestre
hervorm	reforma
seymour	seymour
geschichte	geschichte
samestellings	composicions
samestellings	compostos
aanhalings	cotitzacions
duet	duet
duet	duo
ipairs	ipairs
skakelaar	interruptor
skakelaar	canvia
speletjie	partida
speletjie	joc
speletjie	gamer
blind	cecs
blind	cec
koppelvlak	interfície
koppelvlak	interceptar
artistieke	artístic
artistieke	artística
artistieke	artístics
ham	pernil
ham	ham
benadeel	desfavorits
benadeel	desfavorides
benadeel	avinença
ossetië	ossètia
henk	henk
minnesota	minnesota
clovis	clodoveu
watervalle	cataractes
mausoleum	mausoleu
sprekende	parlant
lotus	lotus
village	poble
village	aldea
gardner	gardner
pat	ofegat
bissau	bissau
mainz	magúncia
honolulu	honolulu
elektronika	electrònica
elsie	elsie
moeders	mares
ingewikkeld	complicat
terugvoer	opinions
terugvoer	feedback
versmelt	fusiona
versmelt	fusionar
hoofde	caps
stres	estrès
meshid	meshid
bermuda	bermudes
inmenging	interferència
orkaan	huracà
qing	qing
woede	colera
woede	ràbia
utah	utah
ledemate	extremitats
registrasie	matriculació
registrasie	inscripció
skop	puntada
hello	hola
kleine	kleine
chi	chi
kontant	cash
kontant	efectiu
worldcat	worldcat
kassier	caixer
andes	andes
vlermuis	bat
superintendent	superintendent
ron	ron
morrison	morrison
dias	dias
alexandria	alexandria
harper	harper
koburg	coburg
avontuur	aventura
rebel	rebel
voorouer	avantpassat
niels	niels
sussex	sussex
firefox	firefox
mozilla	mozilla
bekyk	universal
bekyk	vista
bekyk	visualitza
bekyk	visualització
cite	citar
bevoordeel	benefici
uitsaai	emissió
uitsaai	radiodifusió
hokkie	hoquei
vegter	warrior
vegter	guerrer
maggie	maggie
metropolitan	metropolitan
verdamping	evaporació
verdun	verdum
geleidingsvermoë	conductivitat
homoseksuele	gai
homoseksuele	gay
vrywillig	voluntàriament
vrywillig	voluntària
handleiding	manual
quo	quo
reus	gegant
dinosauria	dinosauria
sosiologie	sociologia
martelaar	màrtir
alberta	alberta
shire	comarca
geometriese	geomètric
geometriese	geomètrica
christo	christo
silesië	silèsia
gletser	glacera
émile	émile
felipe	felipe
buren	buren
zambia	zàmbia
alonso	alonso
veranderende	transformant
lausanne	lausana
lausanne	begues
grootpad	autopista
gekose	seleccionat
gekose	seleccionats
pol	pol
cannes	canes
cannes	cannes
klagtes	denúncies
klagtes	queixes
aruba	aruba
chevrolet	chevrolet
hobhouse	hobhouse
saamgevoeg	fusionat
lou	lou
butch	butch
gekopieer	copiat
transport	transports
transport	transport
gnome	gnome
dapper	valents
dapper	valenta
dapper	brave
dapper	valent
phobos	fobos
toelating	permís
lesse	lliçons
lesse	ensenyaments
cornelia	cornelia
bevredig	satisfer
gemaklik	calaixera
gemaklik	còmodes
freiburg	friburg
elsa	elsa
koei	vaca
geloofsbelydenis	confessió
versteek	amagat
versteek	oculta
versteek	amaga
bewerking	funcionament
bewerking	operació
loodreg	perpendicular
ouderdomme	edats
samesprekings	consultes
sauer	sauer
cinnyris	cinnyris
lübeck	lübeck
uitheemse	alien
tekstiele	tèxtils
gustaf	gustaf
dekking	cobertura
isa	isa
dieptes	profunditats
swazi	swazi
byt	mossega
byt	mossegada
wessex	wessex
feb	tob
feb	hed
vriendelik	simpàtica
vriendelik	amistós
presteer	realitzen
presteer	realitzar
keurvors	elector
fluit	xiulet
fluit	flauta
komma	coma
jonas	jonas
thibault	thibault
ingryping	constitucional
ingryping	constitucionals
horlosie	rellotge
horlosie	rellotge
insident	incident
insident	crash
rijn	rijn
gilbert	gilbert
vakansiedae	festes
vakansiedae	festius
vakansiedae	vacances
brugge	bruges
petroleum	petroleum
petroleum	petroli
modules	mòduls
kronos	cronos
vaart	voyage
jerry	jerry
trio	trio
apokriewe	bíblic
martín	martín
tuna	tonyina
hepburn	hepburn
hardy	hardy
lua	lua
akkuraatheid	precisió
akkuraatheid	exactitud
daag	arriben
daag	arribin
raid	raid
discovery	descobriment
robotte	bots
robotte	robots
fotografiese	fotogràfics
fotografiese	fotogràfica
fagan	fagan
geletterdheid	alfabetització
verhoudinge	relacions
heidegger	heidegger
bophuthatswana	bophuthatswana
hoffman	hoffman
ingelig	educats
ingelig	educat
ingelig	informat
ingelig	informats
hastings	hastings
check	comprovació
olaf	olaf
statige	senyorials
saga	saga
blyplek	hostalatge
blyplek	allotjament
aanleer	sastre
oesbekistan	uzbekistan
cleopatra	cleòpatra
komposisies	composicions
liam	liam
federal	federal
tang	tang
brien	brien
inwoner	resident
dreig	amenacen
dreig	amenaçar
dreig	amenaçant
groeperings	agrupaments
groeperings	agrupacions
historia	historia
damaskus	damasc
trui	jersei
volgehou	persisteix
navigasie	navegació
lenings	préstecs
spa	spa
maryland	maryland
maree	maree
diploma	diplomat
diploma	diploma
aas	terrassa
aas	as
aas	ace
geskenke	regals
aux	aux
cola	cola
bailey	bailey
gis	llevats
gis	llevat
gis	rent
brusselse	brussels
marino	marino
tesla	tesla
angelo	angelo
ingebring	implantada
ingebring	implantats
kelte	celtes
regionalliga	regionalliga
vasbeslote	determinat
vasbeslote	determinada
verweer	destrueix
angus	angus
pieke	cims
pieke	pics
dhcp	dhcp
inspekteur	topògraf
schumacher	schumacher
jose	jose
casper	casper
protestantisme	protestantisme
mangaan	manganès
giacomo	giacomo
rms	rms
astrid	astrid
cunha	cunha
weerlig	llamp
voorpommere	vorpommern
strafskoppe	sancions
gilles	gilles
kroeg	barra
kroeg	bar
kroeg	pub
coetzer	coetzer
swerwer	viatger
dorothy	dorothy
roemeense	romanès
fisies	físicament
seëls	segells
ich	ich
dylan	dylan
pali	pali
liberty	llibertat
arcadia	arcàdia
eaton	eaton
ekologie	ecologia
taipei	taipei
rente	interès
bewonder	admirar
bewonder	admirat
skaduwee	ombra
skaduwee	shadow
kliniese	clínic
masjinerie	maquinària
elegante	elegant
elegante	elegants
batoe	batu
vertaalde	traduït
subpage	subpage
giza	kheops
ekonoom	economista
appèl	recurs
entiteite	entitats
rot	rata
bayer	bayer
diertjie	criatura
riet	reed
tau	tau
pearson	pearson
anthem	himne
verskaffers	proveïdors
coca	coca
felis	felis
gekanselleer	interromput
nobel	nobel
eweknieë	contraparts
marina	marina
seuntjie	noi
simpson	simpson
sement	morter
keramiek	ceràmica
liberië	libèria
navbox	navbox
geografies	geogràficament
routledge	routledge
lis	lis
verwerping	rebuig
kosovo	kosovo
linnaeus	linnaeus
juwele	jewels
juwele	joies
rym	rym
paddas	granotes
toneelspel	actuant
lüderitz	lüderitz
interaksies	interaccions
dimensie	dimensió
instansies	instàncies
instansies	ocurrències
herontdek	redescobrir
tripoli	trípoli
curaçao	curaçao
versoeke	peticions
waarskuwing	avís
waarskuwing	advertència
waarskuwing	alerta
pyrénées	pyrénées
eredivisie	eredivisie
bertel	bertel
henrik	henrik
camille	camille
relevante	rellevant
reed	reed
alberto	alberto
gelos	estrenat
gelos	estrenats
cbs	cbs
matrose	mariners
rachel	rachel
augusta	augusta
homoseksualiteit	homosexualitat
denkbeeldige	imaginari
bedieners	servidors
aanhaling	citació
eenvormige	uniforme
rennes	rennes
sale	salons
sale	sales
korrespondensie	correspondència
mustafa	mustafa
mustafa	mustafà
foucault	foucault
rpm	rpm
warner	warner
objekte	objectes
baskiese	basc
vegters	lluitadors
insameling	veina
mercury	mercuri
mercury	mercury
edith	edith
vreedsaam	pacífica
voorspellings	prediccions
plesier	plaer
artemis	artemis
houers	cartutxos
zacharias	zacharias
eksperimenteer	experiment
tekstuur	textura
kelder	celler
kelder	celler
soöplankton	zooplàncton
getuies	testimonis
doele	objectius
kliniek	clínica
kliniek	clinic
dionysos	dionís
godheid	deïtat
konsekwent	coherent
konsekwent	coherents
konsekwent	consistents
matteus	matthew
matteus	mateu
borg	patrocinador
borg	padrí
auf	auf
vegas	vegas
patricia	patricia
verhore	audiències
pomare	pomare
redigering	edició
skisma	cisma
gholf	golf
voorbereidings	preparatius
beoog	contemplat
swaan	cigne
swaan	swan
sensitief	sensible
sensitief	sensibles
elvis	elvis
begraafplase	cementiris
skattings	estimacions
interwiki	interwiki
blokkies	quadrats
blokkies	places
folk	folk
dalai	dalai
rande	vores
rande	arestes
fak	fak
subkontinent	subcontinent
problem	problema
varke	porcí
varke	porcs
eros	eros
asteekse	asteca
spesifiseer	especificat
spesifiseer	especificats
handbal	handbol
danny	danny
elsevier	elsevier
belastings	impostos
aangaan	concertació
aangaan	conclusió
jurisdiksie	jurisdicció
kabels	cables
mahayana	mahayana
hermes	hermes
waikato	waikato
skenkings	donatius
skenkings	donacions
skenkings	donats
skenkings	donara
velle	làmines
velle	fulls
velle	llençols
oriëntasie	orientació
afrikaan	africà
afrikaan	african
intel	intel
waterweg	waterway
maleise	malai
porselein	porcellana
champagne	champagne
champagne	xampany
humoristiese	humorística
hoogtepunte	destaca
hoogtepunte	destacats
hoogtepunte	ressaltats
pte	pte
voortsetting	continuació
terrorisme	terrorisme
silikon	silici
meel	farina
rubber	cautxú
graal	grial
voorspelling	predicció
voorspelling	previsió
geduld	paciència
isis	isis
saamgevat	consolidat
longontsteking	pneumònia
ifa	ifa
nationalgoals	nationalgoals
nationalcaps	nationalcaps
versiering	decoració
terminale	terminals
messina	messina
harbour	harbour
wallabies	wallabies
missiele	míssils
kie	kie
bekendes	famosos
verbreed	estén
dringende	urgent
prakties	pràcticament
haarlem	haarlem
ulster	ulster
gesiene	eminent
danser	ballarí
danser	dancer
danser	ballarina
jesse	jesse
termodinamika	termodinàmica
celsius	celsius
ekwivalente	equivalent
spontaan	espontània
salm	salmó
epog	època
augustinus	augustinus
afstam	descendeix
andrea	andrea
epidemie	epidèmia
vryhede	llibertats
glenn	glenn
gemak	consuelo
gemak	comoditat
gemak	confort
rosario	rosario
kazan	kazan
garcía	garcía
slaaf	esclau
slaaf	esclava
labrador	labrador
deurentyd	contínuament
beroerte	traç
beroerte	ictus
goelag	gulag
tomas	tomas
josh	josh
uniform	uniforme
versnelling	acceleració
kennisgewing	notificació
kennisgewing	preavís
elias	elias
danse	danse
ferguson	ferguson
frere	frere
chloor	clor
gefedereerde	federades
circa	circa
ink	tinta
vriendin	xicota
vriendin	nòvia
prosedures	procediments
leven	leven
sonja	sonja
kajuit	cabina
kajuit	cabana
betoog	argument
gibraltar	gibraltar
peugeot	peugeot
domenico	domenico
boyle	boyle
montpellier	montpeller
diereriem	zodiac
poems	poemes
ted	ted
gewaarborg	garantit
gewaarborg	garantida
hoender	pollastre
greep	byte
waardigheid	dignitat
moeg	cansada
moeg	cansats
moeg	cansat
passie	passió
genetika	genètica
riller	horror
riller	thriller
jobs	treballs
mayfair	mayfair
aborsie	avortament
hunter	caçador
hunter	hunter
davies	davies
hartseer	tristesa
hartseer	trista
hartseer	sad
hartseer	trist
salzburg	salzburg
vereenvoudig	simplificat
aanhanger	fan
gambië	alhambra
gambië	gamma
gambië	lambda
drukker	impressora
buig	profundament
bertrand	bertrand
rassisme	racisme
habitats	hàbitats
deutschland	deutschland
trinidad	trinidad
trinidad	trinitat
ios	ios
holmes	holmes
braun	braun
vietnam	vietnam
laser	laser
laser	làser
ikea	ikea
fiets	bicicleta
paleogeen	paleogen
farmaseutiese	farmacèutica
iok	ioc
emedicinesubj	emedicinesubj
primêr	primària
primêr	primari
sent	cèntims
huang	huang
onstabiele	inestabilitat
onstabiele	inestable
hulde	homenatge
gesentreer	centra
gesentreer	center
gesentreer	centre
chroom	chrome
chroom	crom
twickenham	twickenham
hydra	hydra
beskermende	protectora
gelaaide	carregat
gelaaide	carregats
bende	colla
awb	awb
gewillig	disposat
gewillig	disposats
devon	devon
skadelike	nocius
skadelike	nocives
skadelike	nociu
theravada	theravada
verlossing	salvació
anastasia	anastasia
gegenereer	generada
gegenereer	generades
gegenereer	generat
kano	kano
marxisme	marxisme
broom	brom
coleman	coleman
gewenste	desitjada
gewenste	desitjat
gewenste	desitjats
pepyn	pipí
raadpleeg	consultar
raadpleeg	consulteu
infeksies	infeccions
moritz	moritz
weiering	negativa
anus	anus
byron	byron
wang	wang
gelowige	religiós
hades	hades
benito	benito
janssens	janssens
bemiddeling	mediació
onverwagte	inesperat
este	este
faso	faso
ivoor	ivori
nicol	nicol
egskeiding	divorci
houston	houston
tuberkulose	tuberculosi
byname	sobrenoms
marathon	marató
marathon	marathon
mekka	meca
toetmoses	tuthmosis
litauers	lituans
verdraagsaamheid	enteniment
verdraagsaamheid	comprensió
verdraagsaamheid	entesa
verdraagsaamheid	entenent
opgeëis	reclamava
opgeëis	reclamat
journey	trajecte
grieg	grieg
kristalle	vidres
voorkoming	prevenció
pionne	peons
sas	sas
sumatra	sumatra
metadata	metadades
spiere	músculs
mannheim	mannheim
siegfried	siegfried
hlist	hlist
onthoof	decapitar
tieners	teens
tieners	adolescents
opgesluit	empresonat
osaka	osaka
fernández	fernández
leuven	leuven
sertifikaat	certificat
gama	gama
popper	popper
diodes	diodes
oneindige	infinit
oneindige	infinites
oneindige	infinits
oneindige	infinita
merkwaardig	notable
merkwaardig	destacable
merkwaardig	remarcable
merkwaardig	remarcables
lugvaart	aviació
palladium	palladium
bourbon	bourbon
bourbon	borbó
paolo	paolo
bethesda	bethesda
enschede	enschede
aken	aachen
belegging	inversió
afkortings	abreviatures
momentum	impuls
roberto	roberto
nieuw	nieuw
kruise	creus
kruise	travessa
vsb	vsb
imdb	imdb
verras	sorprèn
verras	sorprès
tanganjika	tanganyika
rhodesia	rhodèsia
klante	clients
xxii	xxii
desmond	desmond
tegnesium	tecneci
motorvoertuig	cotxe
macau	macau
verkragting	colza
verkragting	violació
doris	doris
natalia	natàlia
brandende	flamejants
jeanne	jeanne
ottawa	ottawa
brendan	brendan
noir	noir
montana	montana
verskaffer	proveïdor
verouderde	vintage
freeman	freeman
eglin	eglin
rsa	rsa
regime	règim
rovere	rovere
monde	boques
edelman	excèntric
bevrore	frozen
bevrore	congelat
gaulle	gaulle
itunes	itunes
amadeus	amadeo
jodium	iode
tannie	tieta
tannie	tia
division	divisió
joyce	joyce
calvyn	calvin
cartier	cartier
peper	pebrot
peper	pebre
duif	columba
laura	laura
wells	pous
jorge	jorge
edison	edison
vera	vera
toegewys	assignat
resensie	revisió
resensie	revisa
laas	darrer
laas	últim
laas	última
laas	darrera
huygens	huygens
swemmer	nedador
hopelik	esperem
guido	guido
jonge	jonge
ward	ward
gesigte	cares
lie	mentida
hunt	hunt
lantern	fanal
sat	santali
doi	doi
knvb	knvb
tonumber	tonumber
afgedank	acomiadat
afgedank	disparat
mcdonald	mcdonald
coenraad	coenraad
lyttelton	lyttelton
jena	jena
apteker	farmacèutic
silinders	cilindres
abu	abu
wars	guerres
pac	pac
jacoba	jacoba
gsub	gsub
sfinks	sphinx
sfinks	esfinx
marchand	marchand
verloof	compromesa
verloof	promès
verloof	promesos
verloof	promesa
magnesium	magnesi
spears	llances
verskaffing	disposició
verskaffing	provisió
verskaffing	subministrar
verskaffing	abastament
verskaffing	subministrament
somaliland	somalilàndia
gebroke	trencats
gebroke	trencat
schöneberg	schöneberg
draer	portadora
draer	transportista
coa	coa
beloning	recompensa
columbië	columbia
geskeduleerde	programades
geskeduleerde	planificat
geskeduleerde	programada
mitsubishi	mitsubishi
onnodig	innecessària
onnodig	innecessari
onnodig	innecessàries
bryce	bryce
etnies	ètnica
sersant	indo
sersant	sergent
bagdad	bagdad
montreux	montreux
grove	grove
grove	olivar
opgeskort	revocats
opgeskort	revocat
opgeskort	revocada
opgeskort	revocades
rings	anells
rings	anelles
raai	endevina
raai	endevinar
oerdoe	urdú
rouge	rouge
crawford	crawford
dover	dover
luc	luc
eris	eris
iphone	iphone
analoog	anàleg
analoog	analògic
feestelik	festiu
feestelik	festives
doctor	metge
doctor	doctor
rochelle	rochelle
spontane	espontània
opsies	calçots
opsies	opcions
vog	fluid
togo	togo
paraná	paranà
kalium	potassi
moerdyk	moerdijk
kate	kate
craven	craven
harvey	harvey
aude	aude
geheimsinnige	misteriós
geheimsinnige	misteriosa
eritrea	eritrea
shah	xah
shah	xa
première	première
brigade	brigada
sauropsida	sauròpsid
domeine	dominis
argeologie	arqueologia
belgrado	belgrad
km³	km³
loon	salari
loon	sou
ashley	ashley
konsonant	consonant
risk	risc
rustig	chill
tokyo	tòquio
tokyo	tokyo
garnale	gambes
garnale	gamba
issn	issn
getroude	casats
getroude	casat
eksklusief	exclusivament
glorie	glòria
glorie	glory
vermeulen	vermeulen
prime	prime
mir	mir
burchell	burchell
maleisiese	malaisi
trent	trent
thukydides	tucídides
onderwater	subaquàtiques
pollard	pollard
français	français
voorgeskrewe	prescrit
gear	engranatge
ariarathes	ariarates
otago	otago
dagga	marihuana
basse	basse
werkverrigting	actuació
werkverrigting	rendiment
nietzsche	nietzsche
racing	racing
pyl	arrow
pyl	fletxa
iwork	iwork
gekonfedereerde	confederats
emil	emil
uil	mussol
galilei	galilei
beleide	polítiques
reklame	publicitat
pontiffs	pontífexs
stevenson	stevenson
pvda	pvda
hersiening	revisió
hersiening	revisa
hersiening	revisió
malvern	malvern
swael	sofre
swael	empassar
jackie	jackie
lufthansa	lufthansa
mariana	mariana
poseidonios	posidoni
tai	tai
ellen	ellen
kai	kai
astrologie	astrologia
glory	glòria
glory	glory
verdwyning	desapareixent
verdwyning	desaparició
akropolis	acròpoli
ming	ming
atlantis	atlàntida
schmitz	schmitz
hoffmann	hoffmann
paddy	paddy
champions	champions
champions	campions
dar	dar
barmen	barmen
michelle	michelle
khoisan	khoisan
emeritus	emèrit
eksamens	exàmens
oopmaak	oberta
oopmaak	oberts
oopmaak	open
oopmaak	obre
oopmaak	obert
bern	berna
larry	larry
heb	heb
woods	woods
woods	bosc
jakkals	fox
jakkals	guineu
meditasie	meditació
prelude	preludi
breton	bretó
blokkeer	bloquejant
blokkeer	bloqueja
blokkeer	bloc
goodwood	goodwood
relatiwiteit	relativitat
kalsium	calci
arc	arc
française	française
borneo	borneo
steuring	interferència
photographic	fotogràfics
photographic	fotogràfica
geberg	desat
geberg	salvat
gmbh	gmbh
tiger	tiger
tiger	tigre
abbey	abadia
tadeusz	tadeusz
agenda	agenda
schweizer	schweizer
gottlieb	gottlieb
albedo	albedo
ark	ark
somme	somme
wonders	meravelles
indonesiese	indonesi
opsioneel	opcionals
opsioneel	facultatius
opsioneel	opcional
opsioneel	facultatiu
implementeer	implementar
opoffering	sacrifici
stratford	stratford
mountains	muntanyes
opvoedkunde	educació
viool	violí
camera	càmera
ipsum	ipsum
snaaks	funny
balfour	balfour
reza	reza
tsjetsjnië	txetxènia
jiddisj	jiddisch
miere	formigues
wyoming	wyoming
ida	ida
cleveland	cleveland
sagittarius	sagitari
werkswinkel	curset
werkswinkel	taller
programmering	programacions
programmering	programació
alix	alix
barber	barber
perry	perry
perfek	perfecte
perfek	perfecta
silva	silva
skilpaaie	tortugues
brighton	brighton
hip	hip
hip	maluc
alter	alterar
alter	alter
draagbare	portable
visvang	peixos
visvang	peix
visvang	pesca
eenmaal	once
hekse	bruixa
resessie	recessió
navy	armada
dankbaar	agraïda
dankbaar	agraït
dankbaar	agraïts
vermenigvuldig	multiplicar
vermenigvuldig	multiplica
lewering	lliurament
coligny	coligny
leroux	leroux
slowaaks	eslovac
clarence	clarence
instel	estableix
instel	conjunt
sindroom	síndrome
bruid	núvia
morse	morse
plutarchus	plutarc
tekstiel	tèxtil
kwesbare	vulnerables
kwesbare	vulnerable
formules	fórmules
verhewe	millorada
verhewe	millorat
betroubaarheid	fiabilitat
sunnyside	sunnyside
selektiewe	selectius
selektiewe	selectiu
selektiewe	selectiva
wetgewer	legislatura
porsche	porsche
versekering	assegurança
versekering	assegurances
hein	hein
beveilig	assegurar
beveilig	assegureu
lockheed	lockheed
akute	aguda
saamstel	assemblea
circus	circ
kopieer	còpia
tallinn	tallinn
todd	todd
cox	cox
gestop	aturat
jin	jin
jin	yin
spot	spot
geregtelike	judicial
kroatiese	croat
kroatiese	croata
befondsing	finançament
concorde	concorde
plasma	plasma
identifikasie	identificació
leigh	leigh
aanvaarbare	acceptables
aanvaarbare	acceptable
kritiseer	criticar
undef	undef
bestelling	orde
bestelling	ordre
forsyth	forsyth
fjord	fiord
vertalers	traductors
vertalers	translators
agente	agents
aansoeke	aplicacions
rory	rory
gewyde	litúrgics
beesvleis	vedella
beatrice	beatriu
violet	violeta
violet	violet
affekteer	afecten
affekteer	afectar
affekteer	afecta
dansers	ballarines
dansers	ballarins
taunus	taunus
bruikbare	útil
greg	greg
wildsbok	antílop
woestyne	deserts
folklore	folklore
bahia	bahia
sterling	sterling
ackerman	ackerman
toepaslike	apropiat
toepaslike	correspongui
toepaslike	aplicables
toepaslike	aplicable
biodiversiteit	biodiversitat
bevestigde	verificat
himalaja	himàlaia
oldenburg	oldenburg
pompeius	pompeu
psalms	salms
kreef	càncer
bsc	bsc
bangkok	bangkok
thüringen	turíngia
rostock	rostock
accipiter	accipiter
hegel	hegel
kappadosië	capadòcia
wouter	wouter
cno	cno
stabiliseer	estabilitzar
ruggraat	troncal
fide	fide
kettings	cadenes
retoriek	retòrica
jake	jake
beperkinge	restriccions
biodiesel	biodièsel
curtis	curtis
sepie	opera
sepie	òpera
handelsmerke	branding
jeltsin	ieltsin
integrale	integrals
christiana	christiana
intieme	íntima
intieme	íntim
tobago	tobago
nevis	nevis
manual	manual
trinity	trinity
trinity	trinitat
rooster	graella
ontbied	convocats
ontbied	convocat
tussenin	separador
fra	fra
