manfred	manfred
johnston	johnston
christine	christine
brøndby	brøndby
fontaine	fontaine
upozorenje	cảnh
okrenuti	quay
okrenuti	lượt
okrenuti	cua
okrenuti	flip
carsku	imperial
titan	titan
infobox	infobox
uss	uss
lan	lan
savi	savi
kanale	kênh
poznań	poznań
emmanuel	emmanuel
mont	mont
gpcr	gpcr
meksički	mễ
citat	quote
holding	lay
dominaciju	dominance
southampton	southampton
tarantino	tarantino
trojanski	trojan
foucault	turano
foucault	foucault
colo	colo
veterana	hanh
michelle	michelle
saarbrücken	saarbrücken
brest	brest
eksperimenti	nghiệm
uhvati	bắt
skandal	scandal
neprijateljski	địch
vazduh	khí
vazduh	air
massa	massa
urađen	lam
urađen	xong
hagen	hagen
omogući	bật
bale	bale
tanke	mỏng
tanke	gầy
tanke	thin
derbi	derby
baltimore	baltimore
lana	lana
iskoristi	dùng
slaven	slaven
elektronegativnost	electronegativity
larsson	larsson
džez	jazz
dfb	dfb
ubiju	giết
gamma	gamma
ethan	ethan
lynch	lynch
neptun	neptune
hase	hase
orijentacija	hướng
tracy	tracy
pmid	pmid
poznavao	tú
trijumf	triumph
hanks	hanks
larsen	larsen
dinamika	dynamics
dozvole	ngập
dozvole	ngập
dozvole	quyền
limun	chanh
pranje	rửa
moćni	lỉnh
barnes	barnes
dubok	deep
dubok	sâu
funta	bảng
funta	pound
funta	lb
domenico	domenico
stambenih	residences
nastavnik	thầy
palma	palma
con	con
ind	ind
radioaktivnog	radioactive
povraćanje	nôn
blake	blake
malabo	malabo
starenja	aging
emina	emina
grosjean	grosjean
solin	solin
yale	yale
admin	admin
playstation	playstation
sinus	xoang
sinus	sin
pinto	pinto
garfield	garfield
amd	amd
brdima	đồi
brdima	hills
interkontinentalni	intercontinental
šešir	mũ
šešir	xịt
šešir	nón
plivanje	bơi
rex	rex
nichols	nichols
police	kệ
blackburn	blackburn
vilajet	erzurum
wilde	wilde
julio	julio
hewitt	hewitt
mega	mega
emirata	emirates
uvoz	nhập
uvoz	danh
uvoz	imports
zhang	trương
strauss	strauss
pogledi	views
primijetiti	chuông
primijetiti	quận
nećak	cháu
iridij	iridium
kocka	cube
kocka	rubik
frameless	frameless
oporavka	recovery
afrodita	aphrodite
umrlo	chết
oštećen	hỏng
ekvatorijalna	equatorial
pietro	pietro
mccarthy	mccarthy
sunnet	sunnah
pio	nhậu
pio	uống
pio	piô
pio	pio
munja	sét
grobovi	graves
grobovi	đào
ilirskih	illyrian
foster	foster
sauber	sauber
lena	lena
autobus	bus
rodni	rodney
mel	mel
bari	bari
fiat	fiat
brando	brando
peters	peters
itf	itf
leona	leona
sedma	seventh
cro	cro
ina	ina
commonwealth	commonwealth
ligand	ligand
nakita	sỉ
nash	nash
suprotna	ngược
pije	uống
iznenađujuće	ngàng
destinacija	đích
lancima	xích
pronalaženje	finding
cohen	cohen
gate	gate
gate	cổng
razum	sanity
razum	chi
hamid	hamid
platina	platinum
bravo	bravo
forever	forever
forever	mải
plaćanje	trả
kineskoj	chinatown
rune	nguyen
teodora	teodora
teodora	theodora
horvat	horvat
vrba	willow
capablanca	capablanca
ledi	đầm
ledi	tẩy
milutin	milutin
tor	tor
tor	tor
tor	thor
selma	selma
obuke	luyện
obuke	training
independent	lập
traoré	traoré
atkinson	atkinson
kamp	camp
kamp	trại
kamp	kamp
pmc	pmc
kraljevo	kraljevo
krivim	huệ
krivim	tội
oleg	oleg
stoku	bò
knut	phan
dine	dunes
stres	stress
stres	toan
bizmut	bitmut
irena	irene
fool	lừa
dxf	dxf
doha	doha
elite	phủ
rheinpark	rheinpark
nož	đao
nož	dao
mare	mare
kasni	sen
kasni	trễ
kasni	khuya
kasni	muộn
predvodi	dẫn
predvodi	led
meier	meier
sauron	sauron
fosila	fossils
molitva	nguyện
kusturica	kusturica
iñárritu	iñárritu
snu	mơ
snu	dream
balet	ballet
balet	balê
navbox	navbox
meki	mackey
molly	molly
sedamnaest	seventeen
holly	holly
pohvale	khen
nobel	nobel
toplotne	nhiệt
tetive	gân
sumnju	reo
delić	delić
plodnosti	fertility
valter	valter
valter	walter
superliga	superleague
airbus	airbus
katastrofe	họa
pompej	pompey
abel	abel
abel	able
lobanja	skull
lobanja	sọ
lobanja	quang
dag	dag
dag	doug
polumjesec	crescent
guardian	guardian
nadph	nadph
andrews	andrews
ftp	ftp
marion	marion
namibije	namibia
havana	havana
qui	qui
boginje	sởi
tak	tắc
tak	tak
skr	skr
zao	zao
zao	zhao
willy	willy
ivanović	ivanovic
jaroslav	jaroslav
gašenje	shutdown
iskopavanja	excavations
hej	nè
hej	hi
hej	này
hej	hey
togo	togo
nantes	nantes
motion	motion
montaža	montage
gaulle	gaulle
mandela	mandela
ruby	ruby
linearna	tuyến
nokia	nokia
stih	verse
hapšenja	arrests
sokrat	socrates
spratu	tầng
spratu	sàn
posejdon	poseidon
chuck	chuck
selena	selene
selena	selena
keaton	keaton
doktrina	ism
paracetamol	paracetamol
federico	federico
jamajka	jamaica
steka	stack
nad+	nad+
prelazni	dốc
concepción	concepción
discogs	discogs
grla	họng
verona	verona
alfonsa	alfonso
leće	lens
kara	kara
majmun	khỉ
majmun	khỉ
irene	irene
bsd	bsd
asistenta	ass
getparent	getparent
odvojiti	skill
izbjegavati	tránh
pozvani	mời
reid	reid
kleopatra	cleopatra
metropolitan	metropolitan
braunschweig	braunschweig
naređenje	lệnh
grenland	greenland
schiller	schiller
zaragoza	zaragoza
santo	santo
pješaci	pawns
utf	utf
garros	garros
jong	jong
ruiz	ruiz
ankara	ankara
serge	serge
lisice	còng
trogir	trogir
indo	indo
burns	cháy
garrett	garrett
kranj	kranj
narodnosti	ethnicities
narodnosti	nationalities
yang	dương
yang	yang
vile	villas
viking	viking
bangladeš	bangladesh
poljubac	hôn
poljubac	kiss
krajini	krajina
paleolog	palaiologina
ipv	ipv
ekstremnim	extreme
zaposlen	bận
greg	greg
klanac	hẻm
aleli	alleles
simpson	simpsons
simpson	simpson
petković	petkovic
spyware	spyware
prevoz	cưỡi
prevoz	ri
alba	alba
azra	azra
sobota	sobota
đubriva	phân
montpellier	montpellier
dado	dado
chapman	chapman
ekonomista	economists
osmanski	ottoman
finci	finns
gojko	gojko
basso	basso
twitter	twitter
ding	đinh
henning	henning
pbs	pbs
ostvarena	phone
izabere	chọn
izabere	chồn
philips	philips
corpus	corpus
peruu	peru
rudniku	mỏ
rudniku	mine
obrenović	obrenović
rona	rona
banner	banner
penala	penalty
penala	phạt
fragmenata	fragments
paichadze	paichadze
stepenice	dục
radomir	radomir
blu	blu
fuad	fuad
brač	brač
liban	liban
liban	lebanon
brock	brock
rey	rey
crnogorska	montenegrin
stanovnik	resident
rabat	rabat
fruktoza	fructose
peroksid	peroxide
lijepe	đẹp
lambda	lambda
tórshavn	tórshavn
segunda	segunda
suprotnim	ngược
tas	tas
zagrijavanja	ấm
olsen	olsen
radionice	xưởng
toyota	toyota
dover	dover
schleswig	schleswig
hubert	hubert
teza	thesis
asturije	asturias
padine	dốc
kampus	trượng
rastvorljivost	solubility
île	île
parni	steam
parni	lết
postupci	proceedings
postupci	hành
benu	ben
benu	crack
uglovi	góc
uglovi	ngách
polo	polo
nacrt	nháp
cristiano	cristiano
želudac	bụng
schneider	schneider
anto	anto
koze	dê
slovan	slovan
zaštititi	vệ
šaban	saban
psihičke	psychic
jerome	jerome
pepeo	tro
pepeo	ash
pepeo	tro
pepeo	chua
ljubi	hôn
ljubi	hôn
guanin	guanine
lokus	locus
brugge	brugge
kopiju	chép
kopiju	copy
kopiju	trích
uxoris	uxoris
shirley	shirley
alejandro	alejandro
polaže	lays
floyd	floyd
reper	rapper
sem	sem
sem	seem
nacista	nazi
barrett	barrett
glover	glover
buha	flea
eugene	eugene
gal	gal
uroš	uros
univerzalna	universal
univerzalna	chung
moo	moo
wikibase	wikibase
hagrid	hagrid
zaboravi	quên
enterprise	enterprise
sherman	sherman
berry	berry
uski	hẹp
klaudija	claudia
gale	gale
fotosinteza	photosynthesis
perje	lông
taipei	taipei
jackie	jackie
renato	renato
vir	vir
biber	pepper
biber	tiêu
uzastopne	successive
kodovi	codes
kodovi	mã
matilda	matilda
riješi	giải
talenat	tài
undef	undef
laos	lào
semir	semir
dayton	dayton
firefox	firefox
klose	klose
alexandra	alexandra
štrajk	strike
štrajk	đâm
štrajk	slr
tarik	tariq
ukloni	bỏ
ukloni	xóa
domova	nhà
aut	aut
vilice	jaws
vilice	hàm
herculis	herculis
fitzgerald	fitzgerald
policajca	cớm
policajca	cop
avenue	avenue
mobilni	mobile
mobilni	mobil
monica	monica
tau	tau
maksimilijan	maximilian
jensen	jensen
stanovanje	nhà
namirnica	supplies
porte	porte
stanari	tenants
benito	benito
rubidij	rubiđi
sevdalinka	thơ
rajna	rhine
rajna	rhein
daj	đưa
daj	tặng
daj	cho
ado	ado
sant	sant
stihovima	lyrics
jung	jung
hol	hol
peking	kinh
peking	kinh
ponor	abyss
kaspijskog	caspian
moreuz	vịnh
oštrim	sharp
oštrim	nhọn
proto	proto
tetka	dì
tetka	dì
luc	luc
beethoven	beethoven
uhvaćen	caught
raspoloženje	mood
leigh	leigh
f}}	f}}
f}}	v}}
kupi	mua
svetlana	svetlana
maxwell	maxwell
suho	lau
suho	khô
damask	damascus
living	sống
living	living
šema	pattern
šema	mẫu
šema	schema
trifosfat	triphosphat
takse	fee
takse	phí
lccn	lccn
kriv	huệ
kriv	tội
prazna	rỗng
prazna	trống
prazna	trống
prazna	blank
potro	potro
neuroni	neurons
nikotin	nicotine
nikotin	nicotin
lago	lago
ptuj	ptuj
bridgestone	bridgestone
nit	nit
nit	chuỗi
nit	thread
vitezova	kị
ethernet	ethernet
mikro	micro
kapije	gate
kapije	cổng
trust	tin
braga	braga
dvostruku	kép
dvostruku	dual
bronzana	đồng
salon	salon
oblikuje	shaping
willem	willem
hapoel	hapoel
engels	engels
elena	elena
kenija	kenya
agresija	aggression
ashley	ashley
volvo	volvo
conrad	conrad
aida	aida
mason	mason
jaden	jaden
jugo	yugo
shvatili	hiểu
prilagoditi	chỉnh
abdel	abdel
nottingham	nottingham
severin	severin
matić	matic
skupovi	cụm
agatha	agatha
britney	britney
mješovita	võ
alonzo	alonzo
italic	nghiêng
ognjen	ognjen
kompleksna	complex
genetski	di
rubin	rubin
avijacija	aviation
pozorišnih	theatrical
monopol	monopoly
gerard	gerard
ara	ara
theodore	theodore
puskás	puskás
brisel	bruxelles
brisel	brussels
proglašeni	tuyên
unprofor	unprofor
terra	terra
računaju	đếm
laze	laze
wanderers	wanderers
messenger	messenger
colt	colt
guayaquil	guayaquil
#fff	#ff
#fff	#fff
quentin	quentin
bendova	bands
oklopno	armoured
astronomija	astronomy
testcases	testcases
bjeloruski	belarus
nums	nums
claire	claire
pos	pos
odredište	đích
coq	coq
titanic	titanic
hayes	hayes
melo	melo
sjene	bóng
jadac	furcula
nacisti	nazis
sul	sul
leteći	flying
leteći	bay
sibira	sibir
sibira	siberia
herodot	herodotus
dylan	dylan
milo	milo
srp	liềm
srp	sickle
pass	qua
pass	đèo
pass	pass
jesse	jesse
niski	low
niski	thấp
antimon	antimony
pentium	pentium
ubijanje	giết
mainsnak	mainsnak
žaba	nhái
žaba	ếch
žaba	cóc
žaba	frog
sretna	phúc
sretna	vui
bejzbol	chày
penzionisani	hưu
ledenih	icy
jugoslovenska	yugoslav
predavanje	hạng
predavanje	lớp
udinese	udinese
stolica	ghế
stolica	lí
stolica	cậy
encode	encode
sindikata	syndicate
urs	urs
pargs	pargs
goethe	goethe
turnire	tournaments
retval	retval
tripoli	tripoli
palestinu	palestine
kid	nhóc
kid	bé
kid	kid
sever	sever
clouzot	clouzot
najbliža	thiểu
glicin	glycine
arif	arif
obećava	hứa
novinari	khmer
stambeni	nhà
teodor	theodore
teodor	teodor
postupcima	hành
audrey	audrey
kvržica	đốm
fetusa	fetus
tan	tan
tan	tân
patio	hiên
patio	sân
bang	đục
bang	bang
bang	boom
progon	persecution
gera	gera
smole	resin
kruševac	kruševac
maksim	maxim
kategorizaciji	categorise
aurora	aurora
vita	vita
nacistički	nazi
tofiq	tofiq
sum	sum
capet	capet
samoubistva	suicides
harper	harper
skleroza	xơ
odlične	đan
hermione	hermione
osmij	osmi
rudnici	mìn
hnl	hnl
haram	haram
kahva	phê
kahva	coffee
kahva	cafe
mentor	mentor
dudley	dudley
fahda	fahd
banane	chuối
herzog	herzog
arab	arab
spaces	khoảng
ultra	ultra
baja	baja
andersen	andersen
bulls	bò
bulls	bulls
maximus	maximus
priština	pristina
willard	willard
murska	murska
pobuni	loạn
romanov	romanov
aids	aids
aids	sida
georgios	georgios
gruzijski	georgian
marvin	marvin
rubens	rubens
svakoga	ai
ska	ska
antene	antennas
johto	johto
romano	romano
aruba	aruba
ferreira	ferreira
fabio	fabio
gerd	gerd
coruña	coruna
coruña	coruña
bliska	close
bliska	đóng
bliska	gần
bliska	kín
ostanu	stay
missing	thiếu
neo	neo
viola	viola
obračun	showdown
velimir	velimir
indij	indi
michelangelo	michelangelo
sunderland	sunderland
albus	albus
maje	maia
trafford	trafford
vertikalno	dọc
čudno	weird
čudno	rar
čudno	lạ
čudno	lạ
simona	simona
academia	academia
eastwood	eastwood
trakt	tracts
sap	sap
humor	hài
milost	mercy
franca	franca
danica	danica
viktoria	viktoria
khalifa	khalifa
rutherford	rutherford
sharon	sharon
laser	laser
laser	laze
sid	sid
kristina	kristina
ural	ural
mekteb	maktab
jar	lọ
jar	jar
jar	yar
razgovara	nói
allison	allison
misimović	misimović
unose	mục
spielberg	spielberg
ekran	bày
hoover	hoover
amor	amor
asha	asha
pjanić	pjanić
armin	armin
estradiol	estradiol
mes	mess
uskrs	easter
ansambl	ensemble
msn	msn
crouch	crouch
ingrid	ingrid
joey	joey
woods	rừng
ogromni	huge
vedran	vedran
tehelné	tehelné
ševčenko	shevchenko
rui	rui
odveden	taken
odveden	bắt
odveden	chụp
disc	đĩa
telekom	telecom
telekom	telekom
pozivajući	gọi
narednu	kế
narednu	tiếp
narednu	kit
istaknuta	highlight
izolirani	isolated
ritchie	ritchie
ekosistema	ecosystems
biatlon	biathlon
grijeha	sin
amr	amr
tezej	theseus
bavarska	bayern
bavarska	bavaria
shi	shi
shi	thạch
hdi	hdi
sulfida	sulfide
gates	gates
gates	cổng
trenucima	moments
odbraniti	cọc
ida	lda
ida	ida
prioritet	ưu
sabah	sabah
queens	queens
chi	chi
kramer	kramer
tango	tango
api	api
korito	trough
korito	máng
lavovi	lions
jet	jet
gordana	gordana
pokal	pokal
jana	tei
jana	jana
jana	yana
alphonse	alphonse
alternative	alternatives
bašta	vườn
bašta	garden
potražnja	đòi
vikinzi	viking
vikinzi	vikings
rezultatu	tally
napitak	potion
akutni	viêm
trophy	cúp
michelin	michelin
que	que
sahara	sahara
podići	nâng
podići	lift
podići	dỡ
podići	nâng
podići	nuôi
podići	nhôm
grass	cỏ
judaizam	judaism
rhapsody	rhapsody
swansea	swansea
nord	nord
marple	marple
mer	mer
alpi	alps
alpi	anpơ
danak	toll
pozvali	mời
uracil	uracil
bilja	herbs
spriječili	ngăn
innsbruck	innsbruck
koraci	bước
berilij	berili
marlon	marlon
vosak	sáp
vosak	wax
stella	stella
bertrand	bertrand
laurence	laurence
ullevi	ullevi
čvorište	junction
čvorište	hub
karavan	caravan
goldman	goldman
adi	adi
edirne	edirne
nebeski	celestial
mainz	mainz
archaea	archaea
spas	spa
spas	salvation
highland	highland
porsche	porsche
ishrana	diêt
kukuruza	ngô
kukuruza	bắp
kukuruza	lúa
rice	gạo
rice	cơm
presude	câu
dominique	dominique
donjeck	donetsk
vilenjaci	elf
eufrat	euphrates
eleonora	eleonora
persie	persie
poznavali	tú
nominirani	nominees
montreal	montréal
montreal	montreal
kadmij	cadimi
komadi	rách
krim	crimea
krim	crimean
krim	krym
univerzalni	universal
univerzalni	chung
eichmann	eichmann
kiss	hôn
kiss	kiss
duhovi	ghosts
duhovi	ma
pettigrew	pettigrew
eros	eros
kartaga	cartago
kartaga	carthage
nur	nur
holokausta	holocaust
tar	ín
tar	tar
yves	yves
stavke	mục
patnje	khổ
osiguralo	bịt
nana	nana
nana	bà
gmbh	gmbh
šansone	chansons
laži	lies
laži	nằm
snovi	mơ
snovi	dreams
porter	toang
porter	porter
vanden	vanden
ljuske	vảy
ljuske	shell
boleslav	boleslav
romain	romain
petronas	petronas
pywikipedia	pywikipedia
vasco	vasco
genotip	genotype
omega	omega
molarni	molar
aerosmith	aerosmith
bing	bing
hemikalija	hóa
benin	benin
uranij	urani
uranij	uranium
setmetatable	setmetatable
marek	marek
horizontalna	ngang
oblaci	mây
fes	fez
delhi	delhi
lou	lou
judd	judd
johnstone	johnstone
krava	bò
krava	kua
krava	bò
krka	krka
lupin	lupin
doprinijeti	góp
aberdeen	aberdeen
vatikana	vatican
kuhinje	bếp
kuhinje	bếp
destiny	destiny
žita	lúa
žita	hạt
sali	sali
sali	sally
osvete	thù
merk	merk
mad	giận
prisustvovali	dự
iata	iata
grab	grip
grab	grab
neon	neon
pag	pag
kabine	chòi
kabine	cabin
aguirre	aguirre
berze	kho
ruth	ruth
tonga	tonga
pieter	pieter
ryu	ryu
pari	pari
deutscher	deutscher
fahrudin	fahrudin
dieter	dieter
divljeg	wild
divljeg	hoang
jessica	jessica
dijamant	zô
dijamant	diamond
ligue	ligue
elektricitet	điện
broma	brom
damon	damon
holden	holden
obećanje	hứa
podijeli	chia
podijeli	share
podijeli	chia
vergilije	virgil
madagaskar	madagascar
zube	răng
cecil	cecil
embrion	phôi
fluorid	florua
fluorid	fluoride
kap	cap
kap	giọt
kap	bỏ
kap	thả
hingis	hingis
košice	košice
godišnjica	khắc
uske	hẹp
cal	cal
davy	davy
zabava	fun
zabava	ké
zabava	vui
zabava	entertainment
memphis	memphis
thierry	thierry
izbjegne	tránh
magna	magna
klas	klas
uleme	ulema
nadp+	nadp+
elisabeth	elisabeth
šabac	šabac
dakar	dakar
niša	niche
komete	comets
ifk	ifk
krovu	rooftop
krovu	mái
krovu	tèo
krovu	trần
državljani	open
državljani	nationals
teze	thesis
pukotine	đứt
pukotine	nứt
gloria	gloria
delgado	delgado
pisala	viết
laktat	lactat
konstantinopolj	constantinopolis
konstantinopolj	constantinople
amidža	chú
amidža	bác
djevice	trinh
djevice	virgin
djevice	tân
sljepilo	blindness
licem	face
licem	mặt
ahilej	achilles
petit	petit
zimbru	zimbru
municiju	đạn
municiju	ammo
ellen	ellen
ars	ars
nicole	nicole
foot	foot
foot	bộ
koller	koller
yyyy	yyy
gottlieb	gottlieb
razumiju	hiểu
razumiju	hiểu
razumiju	hieu
sing	ca
sing	hát
spavanje	ngủ
spavanje	ngự
spavanje	ngủ
reisul	grand
bliskoj	close
bliskoj	đóng
bliskoj	gần
bliskoj	kín
coca	coca
sainte	sainte
izlučivanje	excretion
nsa	nsa
čamac	tàu
čamac	thuyền
čamac	boat
claudia	claudia
murcia	murcia
vrijedno	giá
astronoma	astronomers
analogni	analog
ortiz	ortiz
viđenja	sightings
pamti	nhớ
pljačke	cướp
ustaše	ustaše
skandinaviji	scandinavia
händel	handel
brakova	marriages
spektralnu	spectral
freud	freud
čad	tchad
čad	chad
karin	karin
pozadinu	nền
pozadinu	background
lambert	lambert
joyce	joyce
draco	draco
birati	chọn
birati	chồn
juana	yuan
juana	nguyên
juana	juana
rasmussen	rasmussen
nacistička	nazi
emilio	emilio
vertikalna	dọc
aurelije	aurelius
apache	apache
pozvala	mời
pozvala	goi
hull	hull
hms	hms
zimbabve	zimbabwe
proleće	spring
proleće	xuân
tatjana	tatjana
močvara	lầy
matteo	matteo
matteo	mateo
ericsson	ericson
ericsson	ericsson
bsc	bsc
motors	motors
dog	chó
dog	dog
ribnica	ribnica
chat	chát
chat	chat
keramika	gốm
keramika	ceramic
keramika	gốm
norbert	norbert
simetrična	symmetrical
torij	thori
sar	sar
stanovniku	capita
jožef	józsef
anime	anime
rajko	rajko
kubrick	kubrick
piper	piper
foreman	foreman
léon	léon
nišana	canopy
mead	mead
arxiv	arxiv
evoluirao	evolved
dns	dns
popov	popov
dominirali	dominated
plymouth	plymouth
osamnaest	eighteen
bistra	sáng
bistra	mẻ
mudrost	wisdom
družina	manh
družina	đảng
družina	đám
družina	lũ
blair	blair
afarensis	afarensis
cola	cola
mkb	mkb
gtp	gtp
katniss	katniss
rouge	rouge
ozbiljan	bách
anfield	anfield
sprat	tầng
sprat	sàn
asteroidi	asteroids
mladenović	mladenovic
namespaces	namespaces
kana	kana
savijanje	uốn
karaiskakis	karaiskakis
bennett	bennett
bennett	bennet
epidemija	bùng
lindsay	lindsay
rover	rover
podzemlja	underworld
titana	titans
kai	kai
hemingway	hemingway
katedri	sở
katedri	khu
leoparda	leopard
cha	cha
vukovi	sói
endem	endemism
borisov	borisov
amaterski	amateur
klinsmann	klinsmann
touré	touré
miro	miro
vargas	vargas
progresivni	progressive
sanskrit	phạn
sanskrit	sanskrit
groznica	sốt
hierro	hierro
kuipers	kuipers
gui	gui
skandala	scandals
sunen	sunan
gigi	gigi
plašt	choàng
ladies	quý
senja	senja
sajam	fair
carlu	carla
feyenoord	feyenoord
palau	palau
ugrožena	endangered
kažnjen	phạt
cellspacing	cellspacing
icao	icao
compact	compact
compact	nén
compact	gọn
inhibicija	inhibition
didier	didier
giacomo	giacomo
fleur	fleur
tanja	tania
tanja	tanja
moralne	đạo
funk	funk
orfej	orpheus
mari	marie
mari	mari
krak	prong
papadopoulos	papadopoulos
cüneyt	cüneyt
kron	kron
guerrero	guerrero
estonski	estonia
tibet	tibet
fletcher	fletcher
inka	inca
mönchengladbach	mönchengladbach
nigel	nigel
che	che
geschichte	geschichte
frederik	friedrich
frederik	frederick
wiley	wiley
hrvat	croat
zhoua	chu
milovan	milovan
jaguar	jaguar
hrišćanski	nguyen
hrišćanski	christian
amina	amina
augsburg	augsburg
kathy	kathy
babin	babi
freebsd	freebsd
četvrtina	quý
drake	drake
dizanje	nâng
dizanje	lifting
castillo	castillo
adil	adil
specijacija	speciation
savršen	hảo
caine	caine
bingo	bingo
bingo	jackpot
radoslava	radoslav
fame	fame
zauzet	bận
lave	lava
marty	marty
duhovnog	linh
rouen	rouen
marcos	marcos
uništene	hỏng
uništene	hư
uništene	xì
odbacuju	huỷ
uae	uae
teheran	tehran
matthias	matthias
čuli	nghe
sébastien	sébastien
amer	amer
integralni	integrated
arginin	arginine
usponu	rise
safin	safin
buba	lỗi
buba	bug
snuker	snooker
traci	traci
uzorku	sample
uzorku	mẫu
uvek	luôn
bsk	bsk
postscript	postscript
sims	sims
tupoljev	tupolev
policajci	cớm
čekajući	đợi
čekajući	chờ
kazimir	casimir
rodrigo	rodrigo
gostiju	khách
prodat	bán
richardson	richardson
ascii	ascii
lise	lise
zaustavljanje	dừng
zaustavljanje	ngừng
piti	piti
lažno	giả
lažno	fake
khan	khan
apg	apg
albrecht	albrecht
majmune	khỉ
tnt	tnt
rizzoli	rizzoli
lean	gầy
lean	nghiêng
estadi	estadi
lynn	lynn
konflikt	xung
sumrak	twilight
publicationdate	publicationdate
preston	preston
gustaf	gustaf
gorki	đắng
celuloza	cellulose
ares	ares
tora	torah
eden	eden
mcdonald	mcdonald
mcdonald	mcdonalds
trondheim	trondheim
meteorita	meteorites
irina	irina
lemuri	lemurs
stubovi	đương
stubovi	cột
dora	dora
mačaka	mèo
mačaka	cats
campos	campos
directx	directx
zaliha	supplies
bono	bono
václav	václav
betis	betis
heidelberg	heidelberg
horde	horde
horde	rợ
izgubivši	losing
izgubivši	thua
primer	primer
cilindar	trụ
bojnom	battlefield
krivično	phạm
zabio	dính
zabio	fast
zabio	kẹt
ugljikohidrati	carbohydrate
klein	klein
buhari	buhari
pretraga	tìm
tirozin	tyrosine
mika	mika
percy	percy
žilina	žilina
biro	bureau
biro	cục
čekaju	đợi
čekaju	chờ
polarne	cực
loka	loka
germanija	germania
freiburg	freiburg
glatka	mịn
glatka	mượt
glatka	ẩm
tonova	toner
severus	severus
iskra	spark
iskra	bugi
iskra	iskra
disku	đĩa
veče	tối
kers	kers
laudrup	laudrup
mraz	frost
mraz	claus
wehrmacht	wehrmacht
ovca	cừu
guido	guido
happy	phúc
happy	vui
gnijezdo	nest
gnijezdo	tổ
jacobsen	jacobsen
buddy	buddy
reynolds	reynolds
ebert	ebert
nationale	nationale
ispuniti	meet
ispuniti	gặp
vala	vala
irc	irc
jagoda	strawberry
jagoda	dâu
jagoda	dâu
mraku	dark
mraku	tối
čist	cai
čist	sạch
rožnjače	cornea
bulbasaur	bulbasaur
formama	đơn
fernandes	fernandes
novigrad	novigrad
pate	khổ
pate	chịu
pate	pate
orbiter	orbiter
citata	quotes
shawn	shawn
ester	ester
ester	este
ester	esther
neville	neville
ramiz	ramiz
prašina	bụi
prašina	chốn
gardner	gardener
gardner	gardner
bal	bal
misterija	mystery
ernesto	ernesto
turbina	turbine
mestalla	mestalla
pogođena	trúng
pogođena	đánh
kosta	kosta
lavov	lviv
tomo	tomo
citati	quotes
citati	citation
regina	regina
guillermo	guillermo
povećanu	tăng
tell	nói
tell	bảo
violinist	violinist
noga	chân
soja	soy
francois	francois
francois	françois
mozambik	mozambique
puškin	pushkin
sandra	sandra
tokove	màng
skrivena	phone
skrivena	ẩn
hertha	hertha
kuala	kuala
tomasson	tomasson
alana	alana
elias	elias
sousa	sousa
rosenborg	rosenborg
elia	elia
metallica	metallica
trošak	tốn
šahtar	shakhtar
göring	göring
trenje	friction
maršal	marshall
gérard	gérard
gérard	gerard
huygens	huygens
suzbijanje	suppression
paladij	palladium
fulham	fulham
čačak	čačak
shore	bờ
shore	shore
ugrožene	cửi
naočale	kính
frances	frances
kirk	kirk
šeme	scheme
šeme	schema
oda	oda
triton	triton
kontinentalni	continental
poštanska	bưu
suša	lau
zagovornik	advocate
bačka	bačka
norfolk	norfolk
oblikovanju	shaping
štampanje	in
štampanje	in
shvati	hiểu
shvati	hieu
proslava	lễ
kant	kant
bolton	bolton
vječni	mải
plainlinks	plainlinks
georgi	georgi
pittsburgh	pittsburgh
kuhinji	bếp
crvi	giun
crvi	worms
rekordnih	album
trenutaka	moments
sjekira	rìu
sjekira	axe
schwarzenegger	schwarzenegger
pse	chó
buk	buk
duncan	duncan
rahman	rahman
dietrich	dietrich
ledeni	icy
nilsson	nilsson
muñoz	muñoz
brett	gấp
brett	brett
vjeverica	sóc
ras	ras
nathan	nathan
bunker	bunker
bunker	boongke
bunker	cũi
kraków	krakow
bohemije	bohemia
timothy	timothy
andrés	andres
andrés	andrés
suri	surrey
suri	suri
geo	geo
friesian	friesian
sahrane	táng
sahrane	tang
sahrane	lễ
bangkok	bangkok
sysop	sysop
lea	lea
lea	leah
tekstila	dệt
ego	ego
enzo	enzo
uho	ear
uho	tai
brembo	brembo
övp	övp
vigo	vigo
vigo	viggo
harding	harding
najmlađe	út
hernando	hernando
skakavac	grasshopper
#cfecec	#cfecec
pitt	pitt
brych	brych
dynamics	dynamics
dustin	dustin
metadata	siêu
ine	ine
utvrdili	quyết
koruška	kärnten
humo	humo
hromosomski	chromosomal
ajeti	revelations
ymca	ymca
hybrid	hybrid
davenport	davenport
šator	lều
paljenje	cháy
kristijan	nguyen
kristijan	christian
komori	vẹn
anda	anda
ljekovita	healing
nimfa	nymph
domingo	domingo
boba	bob
boba	boba
povlačenjem	rút
adobe	adobe
poreze	thuế
moždina	cord
bretanje	bretagne
bretanje	brittany
bajka	fairytale
snop	gói
liber	liber
pauk	nhện
pauk	spider
baci	thảy
baci	chọi
baci	quăng
baci	vứt
baci	ném
low	low
low	thấp
zabranila	cấm
enrico	enrico
golo	golo
nivoi	cấp
ogg	ogg
blokovi	chặn
radost	joy
lajos	lajos
lopez	lopez
podmornice	submarines
stamford	stamford
orgazam	orgasm
kisela	chua
locus	locus
streep	streep
ovise	hinge
sicilija	sicilia
sicilija	sicily
sicilija	sicile
insekte	insects
velasco	velasco
alves	alves
napuštena	thác
kurdi	kurds
saksonija	görlitz
saksonija	saxony
saksonija	sachsen
saksonija	zwickau
abeba	ababa
tigris	tigris
mgm	mgm
kuti	kuti
meryl	meryl
uspjeti	bliss
calvin	calvin
gps	gps
hero	hero
hero	hùng
hero	hoàn
citozin	cytosine
dominacija	domination
grafit	graphite
#cc	#cc
punski	punic
zvezde	stars
franački	frankish
mozaik	khảm
mozaik	mosaic
cns	cns
batistuta	batistuta
maldini	maldini
daisy	daisy
curtis	curtis
kassai	kassai
adria	adria
natalie	natalie
propustio	lỡ
stipe	stipe
liang	lương
liang	liang
fetus	fetus
rijad	riyadh
thrash	thrash
herrera	herrera
davidson	davidson
almeida	almeida
debian	debian
horizontalno	ngang
keller	keller
planckova	planck
limfociti	lymphocyte
poslednji	cuối
topola	topola
triler	thriller
slikao	sơn
vikend	weekend
drva	gỗ
drva	củi
robson	robson
tifa	tifa
ebi	abby
