pino	pino
inèrcia	ความเฉื่อย
inèrcia	เฉื่อย
gbe	gbe
balenes	วาฬ
balenes	ปลาวาฬ
alzines	โอ๊ต
alzines	โอ๊ค
bao	เปา
bao	bao
curació	รักษา
catàstrofe	หายนะ
catàstrofe	เซียน
bytes	ไบต์
omple	กรอก
omple	เติม
vietnamita	เวียดนาม
ofrena	เสนอ
místic	ลึกลับ
comerços	ร้าน
franck	franck
objecció	ค้าน
objecció	คัดค้าน
bowl	ชาม
quilograms	กิโลกรัม
frens	เบรก
frens	เบรค
udine	udine
cosins	ญาติ
calculat	คำนวณ
innsbruck	innsbruck
gama	กามา
genolls	เข่า
magrana	ทับทิม
tambors	กลอง
lligam	พันธบัตร
lligam	สายใย
lligam	บอนด์
lligam	พันธะ
sana	sana
fuji	fuji
fuji	ฟูจิ
gilmour	gilmour
bonic	สวย
trujillo	trujillo
valuosa	คุณค่า
chand	chand
reptes	ท้าทาย
revival	ฟื้นฟู
lynch	ลินซ์
lynch	ลินช์
celebrant	ฉลอง
fisch	fisch
apte	พอดี
apte	ฟิต
apte	fit
vassili	vasily
quest	quest
peru	เป
peru	เปรู
peru	เปเป
reines	ควีน
reines	ราชินี
bitllet	ตั๋ว
bitllet	ใบสั่ง
bitllet	บัตร
sílvia	silvia
passiu	passive
emblemàtic	สัญลักษณ์
emblemàtic	เอกลักษณ์
polèmic	แย้ง
schwerin	schwerin
parèntesi	วงเล็บ
bandits	โจร
competitiu	แข่งขัน
portàtils	แล็ปท็อป
mein	mein
tao	เต๋า
tao	เต่า
tao	เทา
tao	tao
preveure	ทำนาย
iphone	โฟน
iphone	iphone
vendôme	vendôme
toyota	toyota
ebullició	เดือด
aprovades	อนุมัติ
caso	caso
boví	วัว
boví	ปศุสัตว์
substantiu	นาม
iranica	iranica
resina	เกด
tità	titan
curiosa	สงสัย
compartint	แชร์
italo	italo
salinitat	salinity
selim	selim
mico	ลิง
rojos	reds
nike	nike
benz	เบนซ์
benz	benz
epinephelus	epinephelus
profecia	พยากรณ์
reialesa	ราชวงศ์
superordo	superordo
vicenza	vicenza
raw	ดิบ
raw	ดิบๆ
raw	raw
nes	nes
modificades	แก้ไข
descàrregues	ดาวน์โหลด
sonic	โซนิค
argumenta	แย้ง
seleuc	seleucus
anarquia	อนาธิปไตย
vendée	vendée
moble	เฟอร์นิเจอร์
valenciennes	valenciennes
microones	ไมโครเวฟ
being	การ
concha	concha
kde	kde
apreciada	ชื่นชม
apreciada	ซาบซึ้ง
regressió	throwback
regressió	ถดถอย
città	città
empatat	มัด
pierce	เพียซ
sai	ไทร
sai	ทราย
armanyac	armagnac
posaven	ทรงตัว
casno	casno
adriano	adriano
enquestes	โพล
enquestes	โพลล์
gnome	gnome
comiat	อำลา
libri	libri
recreació	นันทนาการ
recreació	สันทนาการ
bic	bic
confiat	มั่นใจ
gli	gli
angels	เทวดา
rapid	รถไฟฟ้า
jacinto	jacinto
ego	อัตตา
mol	mol
paradise	พาราไดซ์
paradise	สวรรค์
paradise	พาราไดส์
decorativa	ตกแต่ง
egypt	อียิปต์
taurons	ฉลาม
nutrició	โภชนาการ
urbanitzacions	ชานเมือง
broughton	broughton
fantasmes	ผี
cassini	cassini
richelieu	richelieu
jam	แยม
jam	แจม
entaulament	entablature
cuvier	cuvier
atribucions	พลัง
ren	หยิน
ren	เรน
gian	gian
remot	รีโมท
pomes	แอ๊ปเปิ้ล
pomes	แอปเปิล
pomes	เปิ้ล
shackleton	shackleton
église	église
sobirana	อภิสิทธิ์
dec	เด็ค
dec	เดค
dec	เดธ
dublin	ดับลิน
ramaders	เกษตรกร
ramaders	กสิกร
ramaders	ชาวไร่
ogg	ogg
recomanat	แนะนำ
ruby	ทับทิม
königsberg	königsberg
sorbona	sorbonne
psiquiàtric	จิตเวช
encyclopædia	encyclopædia
rfc	rfc
esplanada	esplanade
timó	timo
maya	maya
maya	มายา
aec	aec
planxa	เหล็ก
planxa	เตารีด
dee	dee
trebisonda	trabzon
ffd	ffd
aprofundir	กระชับ
maharashtra	maharashtra
münster	münster
persuadir	ชักชวน
menyspreu	ดูถูก
diner	เงิน
forever	forever
reactius	reagents
llits	ที่นอน
llits	เตียง
intercontinental	intercontinental
sue	ซู
sue	sue
série	série
marius	marius
pivot	หมุน
emedicinesubj	emedicinesubj
paràlisi	อัมพาต
confós	งง
confós	สับสน
intestinal	ลำไส้เล็ก
funcionalitats	คุณสมบัติ
jungla	ป่า
deportes	deportes
rochefort	rochefort
mis	mis
gautier	gautier
perdonar	อภัย
rac	rac
colonna	colonna
springfield	สปริงฟิลด์
hartmann	hartmann
insereix	แทรก
fiscalia	โจทก์
surrealisme	surrealism
germanor	ภราดรภาพ
sing	สิงห์
sing	ร้อง
fly	ฟลาย
fly	บิน
superman	superman
galilea	galilee
naturalisme	naturalism
purs	บริสุทธิ์
judo	ยูโด
aldea	หมู่บ้าน
confessar	สารภาพ
boiss	boiss
esbarjo	นันทนาการ
esbarjo	สันทนาการ
secretament	ลับๆ
secretament	แอบ
paràbola	อุทาหรณ์
vençuts	พ่าย
amt	amt
comoditat	สบาย
comoditat	สบายใจ
comic	การ์ตูน
programador	โปรแกรมเมอร์
guns	ปืน
llunes	พระจันทร์
aglomeració	agglomeration
salmo	salmo
bessó	twin
bessó	ฝาแฝด
bessó	แฝด
rca	rca
wiener	ไส้กรอก
tamil	ทมิฬ
cliff	หน้าผา
cistella	ตะกร้า
halo	รัศมี
estrofes	stanzas
haas	ฮาร์ส
llibertari	เสรีนิยม
cuiner	ปรุง
cuiner	ครัว
cuiner	หุง
turbina	กังหัน
variabilitat	variability
andrade	andrade
marian	marian
falda	ตัก
krupp	krupp
madur	ผู้ใหญ่
bessones	ฝาแฝด
bessones	แฝด
nam	นัม
nam	nam
rodejat	ล้อม
sinn	sinn
rels	rels
topogràfic	topographic
montagne	montagne
tàctic	ยุทธวิธี
magnituds	magnitudes
zen	เซน
zen	zen
vergara	vergara
randy	randy
caravanes	คาราวาน
dibuixa	วาด
dibuixa	วาด
sim	ซิม
sim	sim
fallada	ตัดสิน
cobalt	โคบอลต์
tos	ไอ
tos	ไอ
lily	ลิลลี่
comptabilitat	บัญชี
esclava	ทาส
orfes	กำพร้า
peres	peres
groningen	groningen
pack	แพ็คเกจ
pack	แพ็ค
pack	ฝูง
pack	แพค
rinoceront	แรด
espelma	เทียน
espelma	เทียนไข
sinus	ไซน์
encant	เสน่ห์
sorteig	หวย
arab	อาหรับ
champion	แชมป์
rush	รัช
rush	รัส
úter	มดลูก
biaix	อคติ
entusiasta	กระตือรือร้น
crancs	ปู
macintosh	sad
routledge	routledge
escombraries	ขยะ
ioga	โยคะ
pier	ท่าเรือ
stalingrad	stalingrad
destral	ขวาน
accademia	accademia
costera	ชายฝั่ง
ronyó	ไต
holden	โฮลเด้น
bangkok	บางกอก
bangkok	กรุงเทพ
bangkok	กรุงเทพฯ
bangkok	กรุงเทพมหานคร
spin	หมุน
spin	ปั่น
fayard	fayard
aïllant	ฉนวน
asturias	asturias
dale	dale
dale	เดล
dale	ดล
iberia	iberia
disminuït	ปฏิเสธ
preliminars	เล้าโลม
alberti	alberti
ffff	ffff
europaea	europaea
priori	priori
gymnothorax	gymnothorax
audi	audi
fatiga	เหน็ดเหนื่อย
fatiga	อ่อนเพลีย
natur	natur
alçades	ไฮท์
grafit	ไฟต์
cadires	เก้าอี้
stock	สต๊อก
stock	หุ้น
inside	ภายใน
cabral	cabral
mcdonald	mcdonald
entrenat	ฝึก
ninja	นินจา
msg	msg
samba	samba
rota	rota
watts	วัตต์
sos	sos
cry	ร้องไห้
taxi	taxi
taxi	แท็กซี่
freenode	freenode
opi	ฝิ่น
tàxon	taxon
aroma	หอม
àrids	aggregates
deng	เติ้ง
deng	เตง
guam	กวม
josh	จอช
pota	ขา
javascript	javascript
henrik	henrik
viral	ไวรัส
costelles	ซี่โครง
costelles	สับ
mates	คณิตศาสตร์
mates	คณิต
mates	เลขคณิต
mates	เลข
interactive	โต้ตอบ
fotografiar	ภาพถ่าย
pocock	pocock
clíniques	คลินิก
glory	รุ่งโรจน์
schönberg	schönberg
gata	gata
mosques	แมลงวัน
afiliació	สมาชิก
adjunta	แนบ
turbo	เทอร์โบ
isis	isis
acumulat	สะสม
armari	ตู้
pantaló	กางเกง
rémy	rémy
transparents	โปร่งแสง
transparents	โปร่งใส
transparents	โปร่ง
swing	แกว่ง
swing	สวิง
swing	เหวี่ยง
manu	มานู
manu	manu
manuela	manuela
mémoire	mémoire
debatre	อภิปราย
benoît	benoît
adagio	adagio
palestí	ปาเลสไตน์
satisfet	พอใจ
auxili	ช่วย
tensor	tensor
mentalitat	วาบ
hendrik	hendrik
clément	clément
petrus	petrus
delicat	บอบบาง
plain	ธรรมดา
beth	เบ็ธ
beth	เบ็ท
beth	เบ็ต
beth	เบธ
pam	pam
pam	แพม
pam	แพ
giren	พลิก
marcelino	marcelino
roquetes	tipperary
invertit	ลงทุน
fusionat	ผสาน
productiva	ประสิทธิ์
piacenza	piacenza
pugen	ทะยาน
aprovats	อนุมัติ
higgins	higgins
pcr	pcr
valentín	valentin
zum	zum
manilles	กุญแจมือ
manilles	ภริยา
lago	lago
ortogonal	orthogonal
interromput	ขัดจังหวะ
barrejat	เลอะเทอะ
barrejat	วุ่นวาย
barrejat	ยุ่งเหยิง
verificació	ยืนยัน
mencions	mentions
loiret	loiret
mazda	mazda
cdu	cdu
ios	ios
plenitud	บริบูรณ์
shin	ชิน
elongatus	elongatus
cam	แคป
cam	แคม
mohammad	โมฮัมหมัด
ràtio	สัดส่วน
ràtio	อัตราส่วน
rima	คล้อง
rima	คล้องจอง
llogat	เช่า
atòmics	อะตอม
atòmics	ปรมาณู
gimnasta	ยิมนาสติก
forêt	forêt
monasterio	monasterio
mega	เมกะ
mega	mega
cornelis	cornelis
gamba	กุ้ง
paciència	อดทน
gemmes	อัญมณี
aleatori	มั่ว
aleatori	สุ่ม
hélène	hélène
khz	khz
preparades	พร้อม
itunes	itunes
direct	ตรง
direct	โดยตรง
direct	direct
futebol	futebol
quantificació	quantization
ghz	ghz
respirar	หายใจ
hit	ตี
hit	ถล่ม
hit	ชน
hit	จีบ
prostituta	โสเภณี
berlioz	berlioz
noël	noël
valorat	มูลค่า
lopez	lopez
lopez	โลเปซ
tsunami	tsunami
meuse	meuse
criats	พันธุ์
fraternitat	สมาคม
monaco	โมนาโก
stéphane	stéphane
ancona	ancona
dibuixat	วาด
boda	แต่งงาน
boda	แต่ง
guants	ถุงมือ
paranà	paraná
brunei	บรูไน
salvelinus	salvelinus
productiu	ประสิทธิ์
brunet	brunet
cansat	เหนื่อย
cansat	เพลีย
mémoires	mémoires
foia	hoya
capensis	capensis
wittgenstein	wittgenstein
hawks	hawks
coe	coe
diwan	diwan
sacs	กระสอบ
zoom	ขยาย
zoom	ซูม
soft	นิ่ม
soft	อ่อน
soft	นุ่ม
heroica	พระเอก
curlàndia	courland
sabó	สบู่
trombó	ทรอมโบน
ungles	เล็บ
ungles	ตะปู
sistan	sistan
ampolles	ขวด
tic	ict
rae	แร
rae	rae
lance	ทวน
corporativa	องค์กร
loup	loup
gisela	gisela
cha	ชะ
cha	ชา
camper	ค่าย
jubilar	เกษียณ
kerry	kerry
tricolor	tricolor
telègraf	โทรเลข
breve	breve
revelen	เผย
llanterna	ไฟฉาย
garatge	อู่
garatge	โรงรถ
patiment	ทรมาน
arthropoda	arthropoda
holt	โฮลท์
holt	โฮล์ท
holt	โฮลต์
bacallà	คอด
bacallà	cod
evolutiu	วิวัฒนาการ
picant	เผ็ด
flexibles	ยืดหยุ่น
èter	ether
maldives	มัลดีฟ
strange	แปลกๆ
strange	แปลก
intensiva	intensive
tap	แตะ
tap	แท็ป
fanny	fanny
infinitat	infinity
infinitat	อนันต์
antoní	antoninus
vòmits	อาเจียน
ístria	istria
peng	peng
peng	เผิง
peng	ผิง
llavi	ลิป
llavi	lip
eros	eros
tecles	กุญแจ
sept	กันยายน
mereixen	สมควร
rua	แห่
rua	พาเหรด
denúncies	บ่น
cistercenc	cistercian
hearts	หัวใจ
gruixuts	หนา
gruixuts	ข้น
buch	buch
monza	monza
taronges	ส้ม
stand	ยืน
stand	stand
stand	ทน
traductora	ล่าม
colombiana	โคลอมเบีย
colombiana	โคลัมเบีย
daus	เต๋า
daus	ลูกเต๋า
compromesa	หมั้น
remota	รีโมท
heroes	วีรบุรุษ
heroes	heroes
heroes	ฮีโร่
hlist	hlist
màfia	มาเฟีย
arreglat	ตายตัว
arreglat	ซ่อมแซม
muga	muga
soria	soria
sixt	sixtus
ascensor	ลิฟท์
consultiu	consultative
salutacions	สวัสดี
salutacions	ทักทาย
rosada	น้ำค้าง
vermandois	vermandois
filferro	ลวด
pac	pac
corregit	ตายตัว
corregit	ซ่อมแซม
rainer	rainer
imparteix	สอน
jill	จิล
zebra	ม้าลาย
blu	blu
blu	บลู
llançador	เหยือก
fear	กลัว
fear	fear
bufa	พัด
plantarum	plantarum
lupus	ลูปัส
gavina	นางนวล
revolución	revolución
féin	féin
capdavanter	บุกเบิก
japonica	japonica
anunciada	ประกาศ
guan	กวน
belowstyle	belowstyle
gres	หินทราย
panoramio	panoramio
seas	ทะเล
ops	ops
devolució	กลับ
distorsió	บิดเบือน
sintètic	สังเคราะห์
pronom	สรรพนาม
raimundo	raimundo
linecolor	linecolor
trident	สามง่าม
estandardització	standardization
ganivets	มีด
diagnosticar	วินิจฉัย
ers	ers
göteborg	gothenburg
anastasi	anastasius
wordpress	wordpress
psiquiatre	จิตแพทย์
nach	nach
símptoma	อาการ
televisión	televisión
ktm	ktm
parany	บ่วง
chaco	chaco
ortodòxia	orthodoxy
moret	moret
prato	prato
capo	capo
immortal	อมตะ
cheng	เชง
panda	แพนด้า
suspesa	ระงับ
avn	avn
rendibilitat	ยอม
navegadors	บราวเซอร์
cima	cima
coreans	เกาหลี
ned	เนด
ned	เน็ด
espelmes	เทียน
blogspot	blogspot
mick	มิค
mick	มิก
afc	afc
kombat	kombat
hidròlisi	hydrolysis
dino	dino
nadons	ทารก
interwikis	interwikis
pts	pts
domus	domus
forquilla	ส้อม
nun	นูน
cahiers	cahiers
rtve	rtve
aura	aura
marburg	marburg
gesellschaft	gesellschaft
petó	จูบ
petó	kiss
etienne	etienne
graves	กรวด
pesen	ชั่ง
galtes	แก้ม
pass	ผ่าน
escuma	โฟม
determinants	determinants
talles	ขนาด
alella	outdoor
roseta	rosette
naa	naa
compartits	แชร์
ustring	ustring
admirar	ชื่นชม
keynes	keynes
escape	หนี
geo	ภูมิศาสตร์
geo	geo
urgent	ด่วน
sophia	โซเฟีย
programadors	โปรแกรมเมอร์
assumit	สันนิษฐาน
peterson	peterson
kas	kas
bota	บูต
amanida	สลัด
galetes	คุกกี้
urnes	โพล
urnes	โพลล์
ressalta	ไฮไลท์
ressalta	เน้น
ressalta	ไฮไลต์
projekt	projekt
servitud	พันธนาการ
jena	jena
borg	borg
carril	เลน
lim	อิม
lcd	lcd
uma	uma
gabriele	gabriele
vidu	หม้าย
germania	germania
locke	ล็อค
orquestració	orchestration
biographie	biographie
smart	ฉลาด
ànecs	เป็ด
respecta	เคารพ
slc	slc
dall	dall
merino	merino
valentine	วาเลนไทน์
recolzant	สนับสนุน
teobald	theobald
residual	ตกค้าง
racons	มุม
shanghai	เซี่ยงไฮ้
girard	girard
trimestre	ไตรมาส
políedre	polyhedra
vandenberg	vandenberg
pits	ทรวงอก
pits	หน้าอก
pilotes	ลูกบอล
píxel	พิกเซล
prokófiev	prokofiev
especificat	ระบุ
enveja	อิจฉา
enveja	ริษยา
turquestan	turkestan
ajust	ปรับ
botifarra	ไส้กรอก
permisos	สิทธิ์
sintetitzadors	synthesizers
langs	langs
waffen	waffen
reino	reino
casats	แต่งงาน
dinamisme	dynamism
seuil	seuil
immune	ภูมิคุ้มกัน
juárez	juárez
cadells	คับ
assegurat	ประกัน
civada	โอ๊ต
simular	จำลอง
transfermarkt	transfermarkt
silvia	silvia
recobriment	coating
recobriment	เคลือบ
ignorant	งมงาย
ignorància	งมงาย
mongetes	ถั่ว
preceptes	ศีล
agripa	agrippa
yahoo	yahoo
paracaigudes	ชูชีพ
gambes	กุ้ง
consistents	สอดคล้อง
salvament	กู้ภัย
bloom	บลูม
naturae	naturae
immortalitat	อมตะ
faldilla	กระโปรง
eslàlom	slalom
mikel	mikel
tigres	เสือ
arrossegament	ลาก
punctatus	punctatus
dep	dep
rosas	rosas
bonus	โบนัส
frustrat	หงุดหงิด
frustrat	ท้อแท้
recoberta	เคลือบ
stdinchi	stdinchi
corrals	ปากกา
bombolla	ฟอง
sharp	ชาร์ป
sharp	คม
spa	ปาส
spa	ปา
spa	สปา
iode	ไอโอดีน
amarg	ขื่นขม
amarg	ขม
amarg	ขมขื่น
siam	สยาม
puntuacions	คะแนน
trist	เศร้าๆ
trist	เศร้า
stdinchikey	stdinchikey
rightarm	rightarm
senar	แปลก
mall	มอลล์
mall	ห้าง
nicholson	nicholson
kunst	kunst
bondat	น้ำใจ
cambrer	บ๋อย
moses	โมเสส
pui	pui
amenaçant	ข่มขู่
amenaçant	ขู่
étoile	étoile
cska	cska
remots	รีโมท
rutina	กิจวัตร
jade	หยก
jade	เจด
watt	watt
watt	วัตต์
vergonya	ละอาย
vergonya	เสียดาย
àpat	อาหาร
àpat	มื้อ
hipotètic	สมมติ
app	แอป
app	แอพ
grua	เครน
fue	vue
bali	บาหลี
reobrir	รื้อ
jurassic	jurassic
lan	ลาน
porxada	ระเบียง
nasser	nasser
sebastiano	sebastiano
duanes	ศุลกากร
alumnat	นักเรียน
alumnat	นักศึกษา
siete	siete
carrega	โหลด
penjats	ห้อย
penjats	แขวน
penjats	เที่ยว
cinerea	cinerea
micròfon	ไมโครโฟน
tura	tura
ilex	ilex
radiacions	การแผ่รังสี
radiacions	รังสี
salern	salerno
basals	angiosperms
vedella	เนื้อ
trucs	เทคนิค
ping	ping
ping	ผิง
seth	เซ็ท
seth	เซธ
seth	เซท
seth	เซ็ธ
shams	shams
algarve	algarve
cda	cda
tassa	คัพ
tassa	ถ้วย
gloriosa	รุ่งโรจน์
caravana	คาราวาน
lligament	เอ็น
ressenyes	วิจารณ์
ressenyes	รีวิว
reno	โนรี
amistats	เพื่อนๆ
amistats	เพื่อน
jeu	jeu
gerais	gerais
systema	systema
dns	dns
wiesbaden	wiesbaden
polpa	pulp
almoina	ทาน
sartre	sartre
valentinià	valentinian
ninot	ตุ๊กตา
ant	มด
ant	มูส
distintius	ป้าย
distintius	เครื่องหมาย
transistors	transistors
nedar	ว่าย
mangosta	พังพอน
mocador	ผ้าเช็ดหน้า
gomis	gomis
envoltades	ล้อม
bahram	bahram
carregador	ชาร์จ
bert	เบิร์ต
collège	collège
habana	habana
aplicats	ประยุกต์
oncles	ลุง
nfpa	nfpa
benvinguts	ต้อนรับ
benvinguts	ยินดี
saltant	กระโดด
tottenham	tottenham
arp	arp
somriure	ยิ้ม
somriure	smile
ètic	จริยธรรม
corvus	corvus
nfl	nfl
sedimentació	sedimentation
ronyons	ไต
nokia	โนเกีย
monitors	จอภาพ
falguera	fern
monferrato	monferrato
oldenburg	oldenburg
purga	ขจัด
smolensk	smolensk
dora	dora
mosquits	ยุง
dalla	scythe
dalla	dalla
hank	แฮง
hank	แฮงค์
bee	บี
bee	ผึ้ง
ang	อัง
ang	อ่าง
elenc	เฝือก
elenc	โยน
titan	titan
valdemar	valdemar
pesades	หนักๆ
pesades	หนัก
ambre	อำพัน
xicota	แฟน
lüneburg	lüneburg
dominica	โดมินิกา
tec	tec
gàbia	กรง
leonor	leonor
adeptes	ประหยัด
ari	อารีย์
ari	อารี
poli	poly
sofriment	ทรมาน
bcn	bcn
ride	ขี่
repeticions	ตัวแทน
globalment	รวมๆ
rocca	rocca
vallée	vallée
champ	champ
champ	แชมป์
bloquejat	บล็อก
bloquejat	บล็อค
regis	regis
diplomat	ประกาศนียบัตร
retallades	ตัด
micos	ลิง
fumar	บุหรี่
bernoulli	bernoulli
nàhuatl	nahuatl
holiday	holiday
lens	เลนส์
hua	หัว
hohenzollern	hohenzollern
wake	ปลุก
bacteriana	แบคทีเรีย
confia	ใจ
confia	ไว้ใจ
weyden	weyden
dxe	dxe
coixí	หมอน
giuliano	giuliano
knox	น็อค
hawk	เหยี่ยว
esgotament	อ่อนเพลีย
altea	altea
abba	abba
psm	psm
reeder	reeder
litre	ลิตร
litre	ลิตร
arch	อาร์ช
ballant	เต้นรำ
ballant	เต้น
molly	molly
terribles	แย่
terribles	สาหัส
burla	เหน็บแนม
xxv	xxv
tara	ธาร
duomo	duomo
castigat	ลงโทษ
agha	agha
rodrigues	rodrigues
cella	คิ้ว
guardava	เก็บ
equilibrada	สมดุล
palegreen	palegreen
finn	ฟิน
finn	ฟินน์
buddy	บัดดี้
tab	แท็บ
hoc	hoc
moss	moss
gui	gui
psiquiatria	จิตเวชศาสตร์
psiquiatria	เวชศาสตร์
würzburg	würzburg
cairo	ไคโร
saludable	สุขภาพ
assignatures	วิชา
warrior	นักรบ
paulus	paulus
vellut	กำมะหยี่
taipei	ไทเป
federalisme	federalism
amarna	amarna
perón	perón
ambigua	คลุมเครือ
medusa	แมงกะพรุน
latent	แฝง
consulteu	ปรึกษา
consideri	พิจารณา
barker	barker
subregió	subregion
dias	dias
palo	ปาโล
palo	พาโล
tonyina	ทูน่า
argot	สแลง
martirologi	martyrology
birefringència	birefringence
galego	galego
humils	เจียม
humils	ถ่อม
bio	ประวัติ
köln	köln
kan	กานต์
lèpid	lepidus
vine	มา
correggio	correggio
albertí	alberti
braunschweig	braunschweig
perque	เพราะ
jing	จิง
vvd	vvd
pastissos	พาย
prevalença	ชุก
merèixer	สมควร
astrologia	โหราศาสตร์
reflexionar	ไตร่ตรอง
reflexionar	ใคร่ครวญ
cauchy	cauchy
traït	ทรยศ
calendaris	ปฏิทิน
recompenses	รางวัล
lleus	mild
lleus	อ่อน
soissons	soissons
concacaf	concacaf
ideas	แนวคิด
landa	landa
ora	ora
junction	ชุม
superclassis	superclassis
fat	อ้วน
fat	อ้วนๆ
donato	donato
maluc	hip
maluc	ฮิป
maluc	ฮิบ
maluc	สะโพก
persistents	ถาวร
persistents	ตื้อ
formiga	มด
asma	หอบ
sio	sio
kano	kano
alineats	สอดคล้อง
okb	okb
filtració	รั่ว
valentin	valentin
alcázar	alcázar
essai	essai
psv	psv
destresa	skill
destresa	ทักษะ
brooke	บรู๊ค
ànims	cheers
ànims	เชียร์
ànims	ดื่ม
carbohidrats	แป้ง
suborn	สินบน
suborn	สินบน
alam	alam
almanac	almanac
callao	callao
jang	ชัง
jang	จาง
jang	jang
jang	แจง
kemal	kemal
cabestany	กว้าน
scarlatti	scarlatti
messi	messi
dvořák	dvořák
mubarak	mubarak
drew	ดรูว์
drew	ดรูว
bing	บิง
bing	bing
interactiu	โต้ตอบ
bombolles	ฟอง
mussol	ฮูก
ribeiro	ribeiro
interwiki	interwiki
jiang	เจียง
albin	albin
ronaldo	ronaldinho
ait	ait
trencaclosques	ปริศนา
mentida	โกหก
dignes	คู่ควร
krishna	กฤษณะ
farcit	ยัด
vis	สุดวิสัย
laurel	ลอเรล
retalls	ตัด
admirat	ชื่นชม
verdura	ผัก
abbaye	abbaye
llauna	tin
llauna	ทิน
barrets	หมวก
trotski	trotsky
voluntariat	อาสา
plessis	plessis
cours	cours
kerala	kerala
iardes	หลาว
iardes	หลาบ
iardes	หลา
ugo	ugo
lauren	ลอว์เรน
lauren	ลอเรน
instint	สัญชาตญาณ
ching	จิง
ching	ชิง
expo	expo
holly	ฮอล
gripau	คางคก
elegants	หรูหรา
carniola	carniola
osorio	osorio
cocodril	จระเข้
colorit	สีสัน
vhs	vhs
traduint	แปล
rentat	ล้าง
madurs	สุก
nines	ตุ๊กตา
idealisme	อุดมการณ์
twin	twin
twin	ฝาแฝด
twin	แฝด
alliberació	ปล่อย
cúbic	ลูกบาศก์
celles	คิ้ว
penny	เพนนี
penny	พน
forner	baker
coadjutor	coadjutor
casual	สบายๆ
shore	ชายฝั่ง
shore	ฝั่ง
palmes	ฝ่ามือ
palmes	ปาล์ม
insults	ดูถูก
hohenstaufen	hohenstaufen
macau	มาเก๊า
macau	macau
pci	pci
deutschen	deutschen
korea	เกาหลี
ulm	ulm
citroën	citroën
elle	แอล
cee	cee
cee	eec
merlin	เมอร์ลิน
psp	psp
cursor	เคอร์เซอร์
pestanya	แท็บ
nata	ครีม
portadora	พาหะ
fresques	สด
fresques	สดๆ
fresques	สดชื่น
bug	บั๊ก
bug	บัก
gaudint	เพลิน
humanitària	มนุษยธรรม
periple	periplus
giotto	giotto
discutint	เถียง
vetlla	เทียน
vetlla	เทียนไข
manada	แพ็คเกจ
manada	แพ็ค
manada	ฝูง
manada	แพค
bugs	แมลง
separadament	แยก
topar	ตุ่ม
topar	กระแทก
carlisle	คาร์ไลล์
carlisle	คาร์ไลส์
donin	ถ้ำ
donin	เดน
llautó	เหลือง
fiesta	fiesta
lowell	โลเวลล์
càsting	casting
konya	konya
septimi	septimius
voivodat	voivodeship
nirvana	นิพพาน
rand	แรน
rand	แรนด์
pelvis	เชิงกราน
dharma	ธรรมะ
développement	développement
maire	maire
naga	นาคา
exd	exd
harmony	ปรองดอง
fuego	fuego
tin	tin
tin	ทิน
xxiv	xxiv
pesaro	pesaro
cie	cie
dlr	dlr
eslògan	สโลแกน
eslògan	slogan
ajusta	ปรับ
hervé	hervé
recordeu	จดจำ
gsub	gsub
manaments	บัญญัติ
gratacels	ตึกระฟ้า
tràmits	พิธีรีตอง
predit	ทำนาย
haplogrup	haplogroup
mercaderia	สินค้า
rustam	rustam
hokkaido	ฮอกไกโด
cocaïna	โคเคน
batxiller	bachelor
cgi	cgi
competitiva	แข่งขัน
ielena	yelena
elseif	elseif
impressora	เครื่องพิมพ์
newell	newell
etiquetatge	แท็ก
udc	udc
benth	benth
maquetes	สาธิต
maquetes	demos
morat	ม่วง
estrateg	ยุทธศาสตร์
mula	ล่อ
moulin	moulin
ili	ili
riva	riva
redir	redir
sven	sven
psi	psi
sheldon	sheldon
seminola	seminole
trista	เศร้าๆ
trista	เศร้า
requeriment	ขอ
requeriment	คำขอ
requeriment	ร้องขอ
tea	ชา
comprovació	เช็ค
comprovació	ตรวจ
vieja	vieja
menjant	กิน
ute	ute
sid	ซิด
cubans	คิวบา
sirena	ไซเรน
sirena	เงือก
dev	dev
shane	เชน
truc	ทริค
microprocessador	microprocessor
boyd	บอยส์
boyd	บอยด์
jusqu	jusqu
llença	วาง
llença	หย่อน
llença	หยด
llença	ดรอป
disparat	ยิง
inchikey	inchikey
fontenay	fontenay
saëns	saëns
vitoria	vitoria
congelat	frozen
congelat	อายัด
congelat	แข็ง
bloch	bloch
desguàs	ระบาย
abbr	abbr
apuntant	ชี้
reine	reine
senyoreta	คิดถึง
senyoreta	มิส
senyoreta	พลาด
senyoreta	นางงาม
divertit	สนุก
divertit	สนุกสนาน
sidó	sidon
sabata	รองเท้า
runner	runner
andersson	andersson
studi	studi
michelin	michelin
analitzant	วิเคราะห์
imprescindibles	สำคัญ
luo	หลัว
uri	uri
acipenser	acipenser
esperó	กระตุ้น
atm	atm
atm	เอทีเอ็ม
qualificacions	คะแนน
joanna	joanna
intermedius	intermedius
impartit	สอน
valclusa	vaucluse
camell	อูฐ
solter	bachelor
sister	น้อง
unànime	เอกฉันท์
empeny	เบ่ง
empeny	ผลัก
empeny	ดัน
empeny	เข็น
aquosa	aqueous
listclass	listclass
beiträge	beiträge
felipa	philippa
celebritat	ดัง
hotspur	hotspur
galatasaray	galatasaray
pvda	pvda
carr	คาร์
avellaneda	avellaneda
intuïció	สัญชาตญาณ
primacia	primacy
soy	soy
talp	ไฝ
maça	เมส
maça	เมซ
kahn	คาห์น
hilton	hilton
wwf	wwf
benvingut	ต้อนรับ
benvingut	ยินดี
iata	iata
fun	สนุก
fun	สนุกสนาน
neuchâtel	neuchâtel
perfum	น้ำหอม
dávila	dávila
tocats	สัมผัส
senders	หาง
saw	เห็น
barril	อวย
barril	ถัง
rosso	rosso
echo	ก้อง
echo	echo
capsa	box
capsa	กล่อง
capsa	ช่อง
cuit	ปรุง
tirosina	tyrosine
apis	api
rpg	rpg
rosetta	rosetta
cirenaica	cyrenaica
carreró	ซอย
carreró	ตรอก
geoffroy	geoffroy
comique	comique
visca	เร่
rosales	rosales
aptituds	ทักษะ
tetis	tethys
cep	กรวย
spartak	spartak
gale	เกล
nigerià	ไนจีเรีย
duval	duval
galleria	galleria
equilibrat	สมดุล
tar	tar
simbòlics	สัญลักษณ์
thyssen	thyssen
contre	contre
lgbt	lgbt
duck	เป็ด
pèptids	peptides
daguestan	dagestan
vienès	viennois
ccc	ccc
cortesia	มารยาท
perrin	perrin
sage	เซจ
pax	pax
mondadori	mondadori
dra	dra
entrenats	ฝึก
lao	ลาว
mantes	ผ้าห่ม
legends	ตำนาน
eunuc	ขันที
falsificació	ปลอม
assegurança	ประกัน
františek	františek
advertència	เตือน
aspx	aspx
cànem	hemp
deva	deva
reemplaça	แทนที่
reemplaça	แทน
flabiol	พิคโคโล่
mano	mano
moyen	moyen
admiradors	แฟนๆ
foca	ผนึก
hrsg	hrsg
sonny	ซันนี่
riverside	riverside
estàtic	คงที่
estàtic	สถิตย์
più	più
ind	ind
colze	ข้อศอก
colze	ศอก
boc	boc
elegia	elegy
arius	arius
inferioritat	ปมด้อย
exp	exp
tam	tam
tam	แทม
pdp	pdp
privar	กีดกัน
transacció	ธุรกรรม
reaccionen	โต้ตอบ
reaccionen	ปฏิกิริยา
infinitiu	infinitive
sáez	sáez
distribuïdor	จำหน่าย
img	img
anàlegs	analogues
contractats	จ้าง
detallats	ละเอียด
crash	คว่ำ
crash	ตก
segueixi	ติดตาม
segueixi	ตาม
abdel	abdel
acacia	vachellia
gálvez	gálvez
destinatari	ผู้รับ
rimski	rimsky
sula	sula
praha	praha
alcohols	alcohols
ryu	ริว
implementacions	implementations
gerd	gerd
meravellós	วิเศษ
mostassa	มัสตาร์ด
perfums	น้ำหอม
ambientació	บรรยากาศ
enriquit	อุดม
ginger	ขิง
lumière	lumière
banana	กล้วย
pom	ปอม
plutoni	พลูโทเนียม
neó	นีออน
chin	ชิน
chin	คาง
cosinus	โคไซน์
cosinus	ไซน์
oligocè	oligocene
sebastòpol	sevastopol
aixecant	ยก
orgullós	ภูมิใจ
orgullós	proud
leyenda	leyenda
rústic	ชนบท
embut	กรวย
pmid	pmid
tri	ไตร
maculata	maculata
sylvain	sylvain
tarifes	อัตรา
argiles	clays
guernica	guernica
gong	กง
gao	เกา
panxa	ท้อง
panxa	พุง
panxa	สะดือ
reichstag	reichstag
consuelo	สบาย
consuelo	สบายใจ
càmping	ค่าย
brúixola	ทิศ
jours	jours
creditors	หนี้
kew	kew
willd	willd
plorar	ร้องไห้
glorieta	ศาลา
khmer	เขมร
dissenya	ดีไซน์
offenbach	offenbach
colon	ลำไส้
frenada	เบรก
semestre	เทอม
trencats	แตก
trencats	แตกหัก
trencats	พัง
trencats	ชำรุด
trencats	สลาย
trencats	หัก
espigues	หู
politique	politique
compagnie	compagnie
arrendament	เช่า
absoluts	ค่าสัมบูรณ์
absoluts	สัมบูรณ์
whisky	วิสกี้
arrià	baptistry
vaginal	vaginal
lez	lez
kyle	ไค
kyle	ไคล
kyle	ไคล์
iraquians	อิรัก
hugues	hugues
esfondrament	ถล่ม
esfondrament	ยุบ
esfondrament	ย่อ
könig	könig
ceguesa	ตาบอด
adolph	adolph
panys	ล็อก
magalhães	magalhães
woo	อู
woo	วู
absolutes	ค่าสัมบูรณ์
absolutes	สัมบูรณ์
colossal	มหึมา
mègara	megara
acudits	มุข
acudits	มุก
acudits	ตลก
pars	pars
avet	ฟิ
ceo	ceo
fernandez	fernandez
atrau	ดึงดูด
pues	หนาม
diaz	diaz
polaris	polaris
daniela	daniela
agar	agar
maurizio	maurizio
vesícula	อสุจิ
nadh	nadh
invencible	คงกระพัน
charentes	charentes
constantin	constantin
provant	ทดสอบ
picó	กระตุก
expressiu	เริงร่า
vale	เวลล์
fregit	ผัด
fregit	ทอด
uni	uni
massissos	กระจุก
deutschland	deutschland
beneïda	พร
beneïda	เป็นสุข
exposant	แฉ
milloren	ปรับปรุง
éireann	éireann
gaudi	เพลิดเพลิน
sanejament	สุขาภิบาล
recomanada	แนะนำ
polit	ขัด
hai	hai
hai	ไห
imant	magnet
galindo	galindo
rect	rect
islas	islas
regle	ไม้บรรทัด
fideus	ก๋วยเตี๋ยว
fideus	บะหมี่
vulpes	vulpes
apreciats	ชื่นชม
apreciats	ซาบซึ้ง
montmartre	montmartre
milo	milo
milo	ไมโล
kang	คัง
gerry	gerry
unincorporated	unincorporated
varis	เบ็ดเตล็ด
mostela	พังพอน
camises	เสื้อ
fuita	รั่ว
provisió	ชีพ
markus	markus
origines	origines
regionalisme	regionalism
tong	ทง
tutorial	สอน
polivalent	อเนกประสงค์
suetoni	suetonius
philosophie	philosophie
nowrap	nowrap
jara	jara
iraquiana	อิรัก
subunitat	subunit
wings	ปีก
plàtan	กล้วย
camillo	camillo
yann	yann
carisma	เสน่ห์
cosir	เย็บ
shen	เชิน
shen	สิม
civitas	civitas
lautrec	lautrec
canonada	ท่อ
topològic	topological
productius	ประสิทธิ์
turismo	turismo
gelada	ฟรอสท์
vacunació	วัคซีน
prisc	priscus
cremallera	ซิบ
cremallera	ซิป
rostov	rostov
provada	ทดสอบ
ole	ole
uhfffaoysa	uhfffaoysa
jakarta	จาการ์ตา
eslovena	slovene
pinzell	แปรง
doll	ตุ๊กตา
flaix	flash
flaix	แฟลช
engranatges	เกียร์
rovere	rovere
màniga	sleeve
siemens	เมนส์
infinits	อนันต์
oba	oba
nicht	nicht
itf	itf
pernil	แฮม
ppp	ppp
brigitte	brigitte
harmattan	harmattan
ipod	ipod
safari	ซาฟารี
safari	safari
trios	trios
xicot	แฟน
flammarion	flammarion
bata	bata
ratisbona	regensburg
palustris	palustris
revisa	วิจารณ์
revisa	รีวิว
eur	eur
québec	québec
jeune	jeune
pater	pater
zeit	zeit
ucla	ucla
prolongada	ยืนยาว
pistoia	pistoia
forza	forza
adjudicació	รางวัล
paladar	โหว่
suaument	เบาๆ
nic	nic
tentacles	หนวด
guo	กัว
escalda	scheldt
túmul	tumulus
verso	verso
shivaji	shivaji
carpio	carpio
antonin	antonin
liebe	liebe
