actualitzat	atnaujintas
mehmet	mehmet
britània	britannia
ecològic	ekologinė
marcelo	marcelo
coppola	coppola
cesare	cesare
amiens	amiens
ecològica	ekologinė
sexualitat	seksualumo
ressenya	apžvalga
túnels	tunelių
túnels	tuneliuose
fitxes	kaladėlės
fitxes	plytelės
fitxes	traškučių
desamortització	konfiskavimas
holland	holland
holland	olandija
àtic	palėpėje
oblit	oblivion
yorkshire	jorkšyro
thomson	thomson
flotant	kintama
marvel	marvel
psicològic	universiteto
deïtat	dievybė
sil	sil
ine	ine
caldera	katilas
ratpenats	šikšnosparniai
recollits	surinkti
ortodox	ortodoksų
gerhard	gerhard
aviv	avivas
salle	salle
protectora	apsauginis
incert	neaiški
borís	borisas
tonga	tonga
extingit	užgęsta
cascades	kaskadų
cascades	krenta
tranquil	ramu
tranquil	tyliai
trois	trois
talls	gabalai
giray	girėjus
xemeneia	židinys
xemeneia	kaminų
samurai	samurajus
fourier	furjė
mútuament	abipusiai
heinz	heinz
oculta	slėpti
estimava	mylimas
estimava	mylėjo
hostilitat	priešiškumas
clàusula	punktas
urà	uranas
hindi	hindi
benedetto	benedeto
neo	neo
veracruz	verakrusas
esgrima	aptvarų
artesania	rankdarbiai
veronica	veronika
talents	talentus
elfs	elfai
llapis	pieštukas
llapis	pen
sabates	bateliai
sabates	batai
sabates	batų
txaikovski	čaikovskis
violeta	violeta
bernardino	bernardino
potencialment	potencialiai
almagro	almagro
botes	batai
botes	batus
forçada	priverstinis
boom	bum
toulouse	tulūzos
decorar	dekoruoti
soldadura	suvirinimo
trajà	trajanas
ankara	ankaros
refugiat	pabėgėliai
refugiat	pabėgėlių
horror	siaubo
horror	siaubas
primat	primatas
patata	bulvės
patata	bulvių
presentacions	pristatymai
beck	bek
eslovè	slovėnijos
eslovè	slovėnų
nicole	nicole
marxisme	marksizmas
pèrgam	pergamas
barber	barber
stop	sustabdyti
paradoxa	paradoksas
chang	chang
gerald	džeraldas
wehrmacht	vermachto
flexibilitat	lankstumas
flexibilitat	lankstumo
diabetis	diabeto
diabetis	diabetas
diabetis	diabetu
maneig	tvarkymo
fiji	fidžis
fiji	fidžio
cortina	užuolaidų
cortina	kortina
laurence	laurence
sen	sen
cilíndrica	cilindrinių
danesos	danai
binària	dvejetainis
acollit	surengė
michelle	michelle
pujant	išsiunčiama
fantàstic	fantastika
fantàstic	naujiena
fantàstic	fantastiškas
organitzadors	organizatorius
organitzadors	organizatoriai
himàlaia	himalajuose
theodore	teodoras
joia	pupa
say	pasakyti
estimular	stimuliuoti
espia	šnipas
damià	damian
insulina	insulino
insulina	insulinas
primes	priemokos
primes	įmokos
individualment	atskirai
compatibles	suderinama
vulgaris	vulgaris
hansen	hansen
venuda	parduota
venuda	parduodami
venuda	parduotas
venuda	parduodama
fonètica	fonetika
orinoco	orinoko
lladre	vagis
desfilada	paradas
aboca	liejasi
discapacitat	negalia
discapacitat	negalią
desempat	atkrintamųjų
georgia	gruzija
georgia	gruzijos
explorer	explorer
esmena	pakeitimas
segregació	atskyrimo
segregació	atskirtis
segregació	atskyrimas
mentor	apmokymą
femme	femme
miners	kalnakasiai
receptes	receptai
traça	pėdsakai
traça	pėdsakų
traça	sekti
destruint	naikina
susanna	susanna
genocidi	genocidas
aliatges	lydiniai
avortament	abortą
aeronau	orlaivis
aeronau	orlaiviai
aeronau	lėktuvas
comprimit	tabletės
stella	stela
federer	federer
controlats	kontroliuojamų
controlats	kontroliuojami
controlats	kontroliuojama
teheran	teherane
teheran	teherano
teheran	teheranas
algebraica	algebrinė
carmelites	karmelitai
sega	sega
anselm	anselm
dragons	drakonai
emèrit	emeritas
konrad	konrad
tiger	tiger
tiger	tigras
monstres	monstrai
intercanvis	mainų
competidors	konkurentų
competidors	konkurentai
garanties	garantijos
garanties	garantijų
nazisme	nacizmas
lev	levas
cassi	kasijus
dana	dana
gracilis	gracilis
donetsk	donecko
esp	esp
pebre	pipirai
pebre	pipirų
heaven	dangaus
heaven	dangus
tosca	toska
trieste	trieste
agressió	agresijos
agressió	agresija
supervisar	prižiūrėti
arrencada	įkrovos
yucatán	jukatanas
elisa	elisa
ramat	banda
nínxol	nišą
endins	viduje
grenoble	grenoble
amazon	amazon
cole	cole
innocent	nekaltas
innocent	nekalti
sènior	vyr
sènior	vyresnysis
pulla	apulijos
xavi	xavi
hamlet	hamletas
mahler	mahler
postres	desertas
postres	desertai
enriqueta	henrietos
vagues	streikai
regulat	reguliuojamos
regulat	reglamentuojami
bibliotecari	bibliotekininkas
impressions	įspūdžių
especialització	specializacija
especialització	specializacijos
barrio	barrio
atacants	puolėjai
titella	lėlių
helicòpters	sraigtasparnių
helicòpters	sraigtasparniai
virgin	mergelių
festiu	šventė
amy	eimė
assessorament	patarimų
assessorament	patarimai
amorosa	mylėti
duncan	duncan
grandes	grandes
jerez	jerez
dièsel	dyzeliniai
dièsel	dyzelinas
dièsel	dyzelino
balada	baladė
self	save
macmillan	macmillan
niccolò	niccolò
preferències	nustatymai
crit	rėkti
tonalitats	atspalvių
massana	massana
obstacle	kliūtis
casablanca	kasablankos
turíngia	tiuringijos
fricció	trinties
fràgil	trapi
smash	sunaikins
istme	sąsmauka
asfalt	asfalto
engel	engelis
liang	liang
guardià	laikytojas
guardià	globėjas
paròdia	parodija
troncs	rąstus
pollastre	višta
pollastre	vištiena
pollastre	vištos
pollastre	vištienos
renal	inkstai
oboè	obo
agraïment	dėkingumą
schleswig	schleswig
promeses	pažadai
promeses	pažadų
bolets	grybai
mantega	sviesto
mantega	sviestas
fresca	šviežias
fresca	šviežios
fresca	švieži
fresca	šviežia
èpica	epic
salou	salou
ambiciós	ambicingi
ambiciós	ambicingas
ambiciós	užmojo
assam	asamas
mitjanit	vidurnakčio
lli	linai
lli	linų
teòricament	teoriškai
viatger	keliautoja
viatger	keliautojas
emilia	emilija
magnífica	nuostabi
boscoses	miškingoje
breslau	breslau
confessió	išpažinties
benedicció	palaima
gracia	grace
eslovac	slovakijos
dea	dea
cons	pliusų
executa	vykdyti
executa	vykdyti
consumidor	vartotojas
consumidor	vartotojų
ossa	ossa
eyck	eyck
faso	fasas
gandhi	gandis
gomes	gomes
motivació	motyvacija
chemical	cheminis
chemical	cheminė
aconsellar	patarti
mustafa	mustafa
fbi	ftb
opéra	opéra
reggio	reggio
vel	šydas
atura	sustabdyti
tumors	navikų
tumors	navikai
yazid	yazid
suficientment	pakankamai
emoció	emocija
emoció	emocijos
empleat	darbuotojui
empleat	darbuotojas
bruc	erica
bruc	erika
preparatius	ruošiniai
preparatius	preparatai
comestible	valgomieji
vidres	kristalai
puccini	puccini
ich	ich
arquitectòniques	architektūros
manipular	manipuliuoti
leibniz	leibniz
irving	irving
pigments	pigmentai
torino	torino
dèbil	silpnas
dolços	sweet
dolços	saldus
dolços	miela
rousseau	rousseau
espectaculars	kvapą
constructiu	konstruktyvi
lira	lira
escandinàvia	skandinavijos
nua	nuoga
trentino	trentino
dictar	diktuoti
tokugawa	tokugava
assimilació	asimiliacijos
huns	hunai
baba	baba
ghost	vaiduoklis
desgast	dėvėti
venedor	pardavėjo
venedor	pardavėjas
entrenadors	trenerių
bolet	grybai
longitudinal	išilginė
longitudinal	išilginės
quocient	dalmuo
vostè	tu
originalitat	originalumo
chuck	chuck
cintura	juosmens
indicadors	rodikliai
praia	praja
apreciat	vertinamas
sms	sms
lac	lac
osasuna	osasuna
adequadament	tinkamai
augsburg	augsburg
plàstics	plastikas
plàstics	plastikų
institucionals	institucinės
institucionals	instituciniai
institucionals	institucinė
institucionals	institucinis
esbossos	eskizai
mànega	žarna
mànega	žarnos
terre	terre
jakob	jakob
sharon	šeron
toros	bulių
prestigiosa	prestižinio
pizarro	pizarro
hubble	hablo
capitalista	kapitalistinės
salvatore	salvatore
toló	tulono
fontana	fontana
voltaire	voltaire
ladislau	vladislovas
capitans	kapitonai
capitans	kapitonus
cleòpatra	kleopatra
baranes	bėgiai
baranes	turėklai
fenícia	finikija
nigra	nigra
cras	krasas
muda	manekenas
garros	garros
gram	gramo
canari	kanarų
sinagoga	sinagoga
immunitat	imunitetą
immunitat	imuniteto
immunitat	imunitetas
predecessors	pirmtakai
apogon	apogon
secreció	sekrecijos
secreció	sekrecija
drake	drake
eddy	edi
zoològic	zoo
híbrids	hibridų
híbrids	hibridai
robots	robotai
jurisprudència	jurisprudencija
chi	chi
porno	porno
cantat	sung
excepcionals	išskirtinės
excepcionals	išimtiniais
excepcionals	išimtinės
segrest	pagrobimas
palais	palais
raquel	raquel
inspira	įkvepia
gervasi	gervasio
sally	salis
sally	sale
chester	česteris
hastings	hastings
robusta	robusta
saba	saba
brahms	bramsas
devil	velnio
bergen	bergeno
agra	agra
invent	išradimas
multiplicar	daugintis
sinònims	sinonimai
eyes	akimis
eyes	akys
eyes	akis
circulen	cirkuliuoja
villiers	villiers
friburg	freiburg
senecio	žilė
estètic	estetinės
susa	susa
diamond	deimantas
ille	vileno
britannica	britannica
florence	florencijos
psicològica	universiteto
logística	logistika
logística	logistikos
perles	perlai
android	android
inevitable	neišvengiama
orals	žodžiu
tomàquet	pomidorų
tomàquet	pomidorai
granados	granados
anima	anima
anima	animuoti
rodolfo	rodolfo
leicester	leicester
alicia	alicija
jackie	jackie
jesse	džesis
arenas	arenas
consistència	suderinamumas
consistència	pastovumas
consistència	nuoseklumą
consistència	nuoseklumas
fabrica	gamina
remarcable	nepaprastas
telefonia	telefonijos
cromwell	cromwell
ulleres	akiniai
miralls	veidrodžiai
omeia	omeijadų
telescopis	teleskopai
goigs	malonumais
vernon	vernon
deus	deus
carroll	carroll
gambet	gambitas
kuban	kuban
ist	ist
hoy	hoy
perfils	profiliai
pensadors	mąstytojų
manfred	manfredas
troyes	trua
albi	albi
hood	spinta
portadors	vežėjams
cesarea	musmirė
montero	montero
feixistes	fašistai
lleu	lengvu
lleu	lengvas
feminisme	feminizmas
marxes	paradai
lausana	lozanoje
hormona	hormono
hormona	hormonas
hormona	hormonų
hormona	hormonai
perifèria	pakraštys
core	branduolys
hortalisses	daržovės
hortalisses	daržovių
convidada	svečias
revisions	pataisymai
helicòpter	sraigtasparnio
helicòpter	sraigtasparnis
göttingen	göttingen
astronautes	astronautų
tanques	tvoros
tanques	tvoras
infinita	begalinė
abad	abad
castel	castel
ajax	ajax
immersió	nerti
catàlegs	katalogai
eugen	eugen
requisit	reikalavimui
requisit	reikalavimai
requisit	reikalavimas
accessoris	reikmenys
accessoris	priedai
eocè	eocene
empresonament	įkalinimo
chaplin	čaplinas
timor	timoras
cordó	cordon
tauró	ryklys
tauró	rykliai
millet	soros
ethnologue	ethnologue
supervivent	našlių
revolucions	revoliucijos
arcàngel	arkangelas
sanció	sankcija
sanció	bausmę
sanció	bauda
sanció	bausmė
sanció	nuobauda
oca	žąsų
oca	žąsys
acumular	kaupiasi
coincidència	sutapimas
coincidència	atsitiktinumas
fades	fėjos
mesurament	matavimo
mesurament	matavimas
mesurament	matavimai
pneumàtics	padangas
pneumàtics	padangos
gitanos	čigonai
cartutx	užtaisas
machado	machado
cohesió	sanglauda
cohesió	sanglaudos
contaminants	teršalai
marcello	marcello
proposats	siūlomas
žilina	žilina
patrulla	patruliavimo
sandra	sandra
larson	larsonas
bogeria	beprotybė
bogeria	beprotybė
coruña	coruña
austral	austral
byron	baironas
jung	jung
felice	felice
adversari	oponentas
anàleg	panašios
etern	amžina
subsistència	pragyvenimo
lilla	lilla
leigh	leigh
confecció	apranga
confecció	aprangos
confecció	drabužiai
confecció	drabužių
maduració	brendimui
düsseldorf	diuseldorfo
dalmàcia	dalmatija
xxiii	xxiii
digne	orus
uppsala	uppsala
baumann	baumann
descartes	descartes
pulmó	plaučiai
pulmó	plaučių
schaefer	schaefer
barset	barset
tate	teit
ideològica	ideologinių
inducció	indukcijos
misèria	vargo
iván	iván
kit	kit
kit	komplektas
avenir	avenir
oponent	oponentas
tràgic	tragiška
tràgic	tragiškas
isfahan	isfahanas
leeds	leeds
desigualtat	nelygybė
concòrdia	concordia
willy	willy
rocky	rokis
embarcació	laivas
embarcació	indas
contractació	įdarbinimas
chu	chu
aden	adeno
gotha	gotha
varela	varela
burke	burke
sancti	sankti
antigua	antigva
desafiament	iššūkis
kant	kanto
salem	salem
rana	rana
jonas	jonas
fragmentació	susiskaidymo
plymouth	plymouth
mesquites	mečetes
creients	tikinčiuosius
liszt	listo
tumor	auglys
poll	apklausa
milla	konfliktas
milla	mylios
mànec	rankena
mànec	tvarkyti
triangles	trikampiai
aeròdrom	aerodromas
aeròdrom	aerodromo
aeròdrom	aerodrome
rangers	eiguliai
gelosia	pavydas
cànons	honorarų
farmacèutica	farmacijos
fotògrafs	fotografai
postures	kelia
revisat	patikslintas
jpeg	jpeg
rossa	blondinė
rojo	rojo
llàgrimes	rer
llàgrimes	ašaros
tires	juostelių
equivalència	lygiavertiškumas
caminant	vaikšto
kirk	kirk
excursions	ekskursijas
hitita	hetitų
satisfacció	pasitenkinimo
satisfacció	pasitenkinimas
audició	nusifilmuoti
sondes	zondai
espín	spin
natzaret	nazareto
suisse	suisse
tirada	meluoja
fleming	fleming
comercialment	komerciškai
etanol	etanolis
jet	jet
reservada	rezervuota
stein	stein
firefox	firefox
janet	sudomino
freeman	frimanas
aspiracions	siekius
aspiracions	siekiai
medicament	vaistas
đoković	džokovičius
electronic	elektroninių
electronic	elektroniniai
cisma	schizma
predicar	preke
curar	pasveikti
carrasco	carrasco
escapa	sprunka
espores	sporas
manganès	mangano
extracte	ekstraktas
extracte	išrašas
extracte	ištrauka
grapat	grupelė
moràvia	moravijos
doc	doc
estímul	paskatų
molar	molinis
molar	molio
apartheid	apartheido
agenda	darbotvarkę
agenda	darbotvarkė
essex	eseksas
bolxevic	bolševikų
racisme	rasizmas
racisme	rasizmu
recordant	prisimenant
recordant	prisiminti
sabre	sabre
vasari	vasari
dijon	dijon
rivas	rivas
shell	shell
shell	apvalkalas
germandat	brolija
tommaso	tommaso
nimfa	nimfa
foguera	laužas
perfumeria	parfumerijos
perfumeria	kvepalai
cantor	cantor
serge	serge
brunsvic	brunsviko
schumann	schumann
terrasses	terasos
sotsprefectura	subprefektūra
realistes	nerealūs
esbós	eskizas
cabo	cabo
pesada	sunkus
pesada	galinga
execucions	egzekucijų
broma	pokštas
esfèrica	sferinių
kepler	kepler
héctor	héctor
bitínia	bitinija
ontario	ontarijas
pontífex	pontifex
eliminatòries	atkrintamąsias
guardian	globėjas
colonia	kolonia
òscar	oskaras
servent	tarnas
servent	tarnautojas
innocència	nekaltumo
meridià	meridian
piles	baterijų
piles	akumuliatoriai
piles	baterijos
cinemes	cinemas
ibers	iberai
doctors	daktarai
doctors	gydytojai
dracs	drakonai
benfica	benfica
microscopi	mikroskopu
manualment	rankomis
aleatòria	atsitiktinai
aleatòria	atsitiktinė
posidó	poseidonas
ventilació	vėdinimo
resolucions	rezoliucijos
resolucions	rezoliucijų
humboldt	humbolto
girolamo	džirolamas
contenidor	konteineris
multijugador	multiplayer
yan	yan
canaria	canaria
timothy	timothy
asteca	actekų
colesterol	cholesterolio
annales	analų
desitjada	norimą
esperances	viltis
esperances	viltys
delegacions	delegacijų
delegacions	delegacijos
aule	aulus
olaf	olaf
reacciona	reaguoja
prunus	prunus
atol	atolas
karate	karate
robes	apranga
robes	drabužius
robes	drabužiai
trinidad	trinidadas
peris	peris
royale	royale
dulce	dulce
room	kambarys
fletcher	fletcher
nacionalitats	tautybių
cívic	pilietinių
cívic	pilietinis
faraons	faraonai
afi	afi
reclamava	teigė
olympique	olympique
descansa	poilsio
descansa	poilsis
preocupat	susirūpinęs
accidental	atsitiktinio
sorprès	nustebęs
electes	išrinkti
electes	išrinktas
electes	išrinkta
llebre	hara
adalbert	adalbertas
igor	igor
basquetbol	krepšinio
refugis	priedangos
comboi	konvojus
gestionat	pavyko
gestionat	valdoma
gestionat	valdomi
robertson	robertson
salaris	atlyginimai
salaris	atlyginimas
salaris	alga
salaris	algos
salaris	atlyginimus
salaris	atlyginimai
treballadora	darbštus
brad	bredas
euclides	euklido
chao	menam
reparacions	remontas
anotació	anotacija
llenya	malkų
trinity	trinity
elegans	elegans
sext	sekstas
ryukyu	riūkiū
pressupostos	biudžetai
regulador	reguliatorius
passes	žingsniai
jessica	džesika
jessica	jessica
karel	karel
emancipació	emancipacijos
floristeria	floristas
geòleg	geologas
alternant	kintamoji
alternant	saulėtos
fermament	tvirtai
fre	stabdys
fre	stabdžiai
fre	stabdžių
fre	stabdymas
bering	beringo
galileu	galileo
galileu	prisiminus
milet	miletas
schubert	schubert
heredia	heredia
matteo	matteo
maldonado	maldonado
cornualla	kornvalio
gutenberg	gutenbergo
papallones	drugelių
vichy	vichy
horn	ragas
cingles	uolų
cecs	aklas
cecs	aklai
cecs	akla
diumenges	sekmadieniais
patologia	patologijos
marin	marin
huang	huang
isidro	isidro
osman	osman
trinxeres	tranšėjos
chico	čikas
estratègics	strateginiai
judea	judėją
tobago	tobago
araneus	araneus
tyler	taileris
tyler	smėlis
barnes	barnsas
coreografia	choreografija
tríptic	triptikas
apocalipsi	žlugimo
bergman	bergman
ahir	vakar
cantonals	kantonų
ela	ela
antibiòtics	antibiotikų
antibiòtics	antibiotikai
extreu	ekstraktas
extreu	išrašas
extreu	ištrauka
ambició	ambicijų
hoffmann	hoffmann
ase	asilas
metafísica	metafizika
heretgia	erezija
toda	toda
evolucionant	klestinti
evolucionant	klesti
negació	neigimas
malestar	diskomfortas
malestar	negalavimas
cuc	sliekas
impressionat	sužavėtas
guerrillers	partizanams
turkmenistan	turkmėnija
nóvgorod	naugardo
clemente	clemente
gimnàs	saugus
cavitats	ertmes
café	kavinė
assegurances	atsargumas
assegurances	draudimas
assegurances	draudimo
savis	išmintinga
barat	pigiai
barat	pigūs
barat	pigus
barat	pigios
barat	pigu
hernando	hernando
màscares	kaukės
mònica	monika
sagrament	sakramentą
ganges	ganga
mitocondrial	mitochondrijų
marguerite	marguerite
infermeria	slaugos
arquers	lankininkai
calcuta	kalkutos
sabina	sabina
ham	kumpio
ham	kumpis
simpatia	užuojautą
laberint	labirintų
laberint	maze
isidor	isidor
isidor	isidore
bucle	linijos
aprox	maždaug
amr	aam
tina	tina
constitucionals	konstitucinių
acadèmies	akademijų
vernet	vernet
legitimitat	teisėtumą
impureses	priemaišų
impureses	priemaišos
surf	surf
estadístic	statistikos
plafons	plokštės
nin	nin
controladors	vairuotojai
controladors	vairuotojų
trampa	spąstai
trampa	gaudyklė
trampa	gaudyklės
contextos	kontekstuose
refrigeració	aušinimo
refrigeració	šaldymo
tirador	šaulys
burns	dega
topografia	topografija
plomatge	dimorfizmas
cuevas	cuevas
regnum	regnum
cobra	kobra
comestibles	valgomieji
uzbeks	uzbekai
drames	dramas
braun	braun
princess	princesė
princess	princese
princess	princesės
crespo	crespo
coregonus	coregonus
rococó	rokoko
carnestoltes	karnavalas
polímers	polimerai
polímers	polimerų
diagrames	žemėlapiai
diagrames	schemos
asunción	paraguay
amfiteatre	amfiteatras
navajo	navahų
vaux	vaux
cirera	vyšnių
cirera	vyšnios
kobayashi	kobayashi
rich	turtingas
triada	triados
greixos	riebalų
greixos	riebalai
meravelles	stebuklus
jenkins	jenkins
vascular	kraujagyslių
donatello	donatello
herrero	kalvis
kane	kane
bol	dubenį
subhasta	aukcionas
oïda	ausies
dorotea	dorothea
baga	baga
grandesa	didybės
crom	chromo
piero	piero
adquirits	įsigijo
lèmur	lemūras
arborea	brugmansija
ballarí	šokėja
llamp	žaibas
llamp	žaibo
zanzíbar	zanzibaro
marilyn	marilyn
nora	nora
tuc	tuc
desastres	nelaimių
poderoses	galingas
poderoses	galinga
poderoses	galingi
judes	judas
aguilera	aguilera
recopilatori	rengimo
oasi	oaze
ultraviolada	ultravioletinės
infermera	slaugytoja
postals	atvirukus
caro	caro
plagues	kenkėjų
calif	calif
bmw	bmw
mustafà	mustafa
glàndula	liauka
glàndula	kankorėžinė
roque	roque
ulrich	ulrich
deportats	deportuotas
animat	animacinis
constructives	konstruktyvi
espiritualitat	dvasingumas
pastís	pyragas
pastís	tortas
pastís	pyragas
pastís	pie
snow	sniegas
snow	sniego
minerva	minerva
claudia	claudia
elegància	elegancija
arroyo	arroyo
hiroshima	hirosima
romanesos	rumunai
termodinàmica	termodinamika
inútil	bevertis
inútil	beprasmiška
soares	soares
petite	petite
calcita	kalcito
ferreira	ferreira
singer	dainininkė
desplaçaments	poslinkio
magrib	magrebo
kremlin	kremliaus
cullera	šaukštu
detector	detektoriaus
llàtzer	lazarus
mussa	musa
fragata	fregata
classics	klasika
cartutxos	užtaisai
wadi	vadi
mozilla	mozilla
johnston	johnston
estímuls	dirgiklių
murad	muradas
laic	pasaulietinės
seminaris	seminarai
desterrat	ištremtas
formatges	sūriai
enginy	išradingumą
iuri	jurijus
juniors	juniors
aproximat	apytikslis
albrecht	albrecht
rhodèsia	rodezijos
salinas	salinas
calçat	avalynė
plistocè	pleistoceno
howe	howe
radiodifusió	transliavimas
radiodifusió	transliavimo
edificat	statybų
rama	rama
pet	pet
cranc	krabas
shirley	shirley
veritablement	tikrai
pine	pušų
autoritzat	įgaliotasis
presentadora	vedėja
dissolvent	tirpiklis
atractiva	patraukli
carrillo	carrillo
unicode	unikodo
voyager	voyager
hexagonal	šešiakampės
fitzgerald	fitzgerald
laci	laci
pròstata	prostatos
ovari	kiaušidės
auxerre	auxerre
soriano	soriano
declinació	deklinacija
fabio	fabio
nietzsche	nyčė
refredament	aušinimo
bologna	bolonijos
román	román
sherman	šermanas
ruf	rufas
mascota	pet
mascota	talismanas
wesley	wesley
lituans	lietuviai
sabent	žinant
evaporació	garavimo
dauphiné	dauphiné
funcionant	veikiančių
funcionant	važiavimas
confederats	konfederatų
bihar	biharas
venes	venomis
creative	kūrybos
wilde	wilde
ubuntu	ubuntu
geomètric	geometrinis
geomètric	geometrija
geomètric	geometrinės
livre	livre
blair	blair
delicada	subtilus
acordat	sutarta
yamaha	yamaha
fraga	fraga
pulitzer	pulicerio
àtica	atika
semàntica	semantika
pittsburgh	pitsburgo
operat	valdomi
rada	rada
contenidors	konteineriai
murillo	murillo
pesats	sunkus
pesats	galinga
eclipsi	eclipse
reunificació	susijungimo
phantom	phantom
bundesliga	bundesliga
cosmos	cosmos
jacopo	jacopo
françoise	françoise
coherència	suderinamumas
coherència	nuoseklumą
coherència	suderinamumas
coherència	pastovumas
coherència	nuoseklumą
coherència	nuoseklumas
pèndol	švytuoklės
prototips	prototipų
padrí	rėmėjas
proveïdors	tiekėjų
proveïdors	tiekėjai
proveïdors	tiekėjams
textcolor	textcolor
perseu	persėjas
proveïdor	tiekėjas
cues	uodegos
rabí	rabinas
haut	haut
mia	mia
kill	nužudyti
timur	timūras
expressionisme	ekspresionizmas
bien	bien
riure	juoko
riure	juokas
riure	juoktis
bicolor	beždžionvarlė
respectat	gerbiama
malària	maliarija
pecats	nuodėmes
especulació	spekuliacija
especulació	spekuliacijos
trucada	vadina
síndic	patikėtinis
mahdi	mahdi
demostracions	demonstracijas
demostracions	demonstracijos
demostracions	demonstravimas
atribut	atributas
atribut	požymis
pigment	pigmentas
ipv	ipv
balena	banginis
envelliment	senėjimo
amar	amar
scherzo	scherzo
nimes	nîmes
greenwich	grinvičo
autèntics	autentiškas
autèntics	autentiški
philips	philips
juliana	juliana
compacta	kompaktiškas
dorsals	varikliai
loves	dievina
loves	mėgsta
loves	myli
karim	karim
confederacions	konfederacijų
braga	braga
plantació	plantacija
plantació	sodinimo
plantació	sodinti
baber	babūras
mérida	merida
kay	kay
vallecano	vallecano
artefacte	artefaktas
campaments	stovyklos
campaments	stovyklose
gallego	gallego
llemotges	limoges
cremona	cremona
dieu	dieu
compres	apsipirkti
coburg	coburg
aston	aston
saône	sona
fowler	paukštininkas
deportació	deportacijos
ceres	cerera
malatesta	malatesta
delaware	delavero
formosa	formosa
pompeia	pompėja
miocè	miocenas
agostino	agostino
agressiu	agresyvus
oliveira	oliveira
elm	guobų
thriller	trileris
pseudo	pseudo
hinduisme	hinduizmas
passions	aistrų
beaufort	beaufort
generadors	generatoriai
mítica	mitinio
combinats	kombinuotosios
terciari	mokomųjų
resol	išspręsti
truita	omletas
truita	upėtakis
localitzacions	vietose
localitzacions	vietovės
localitzacions	vieta
pinya	ananasų
sentències	sprendimai
azul	azul
cocció	virimo
conti	conti
sims	sims
lynn	lynn
orientalis	orientalis
correlació	koreliacija
correlació	koreliacijos
coratge	drąsos
coratge	drąsa
valuós	vertinga
valuós	vertingas
blindat	šarvuotas
samsung	samsung
gould	gould
diversió	smagu
diversió	smagiai
diversió	linksma
diversió	linksmai
diversió	pramogų
francisca	franciska
bayreuth	bairoitas
inversors	investuotojai
inversors	investuotojų
eigenmann	eigenmann
eve	ieva
pujades	laivybos
pujades	laivyba
pujades	shipping
wade	veidai
wade	veidas
copiat	nukopijuotas
jenny	dženi
cyr	cyr
stan	stan
andante	andante
shannon	shannon
cox	cox
pagant	mokėjimo
rodat	filmavo
marroquí	maroko
alphonse	alfonsas
dodge	dodge
vitamines	vitaminai
goa	goa
gore	gore
contorn	kontūrai
riemann	rymano
hoffman	hofmanas
néts	anūkų
affinis	affinis
marseille	marselio
sègol	rugių
discrepàncies	neatitikimai
discrepàncies	neatitikimų
demà	rytoj
urpes	letenas
ferotge	aršios
dover	dover
raj	raj
mana	mana
mana	manda
geobox	geobox
turing	tiuringo
sussex	sussex
constanci	konstancijus
cols	kopūstai
subvencions	stipendijos
subvencions	dotacijos
extreta	išgauti
granger	ūkininkas
bombarder	bombonešis
enriquir	praturtinti
modular	modulinis
absurd	absurdiška
absurd	absurdas
temperament	temperamentas
eng}}	eng}}
urban	urban
urban	miesto
artemisia	artemisia
ieee	ieee
queens	karalienes
bacon	kumpis
patint	kančia
patint	kančias
patint	kančios
hagen	hagen
med	med
sancions	nuobaudos
sancions	baudos
sancions	bausmės
sancions	sankcijos
diem	diem
ayala	ayala
myspace	myspace
deposició	nusodinimo
brie	brie
brutal	žiauri
brutal	žiaurus
morrison	morrison
bellini	bellini
olives	alyvuogių
olives	alyvuogės
olives	alyvuoges
instructor	instruktorius
ingredient	ingredientas
inèrcia	inercijos
festius	šventės
gbe	gbe
neumann	neumann
australians	australai
atari	atari
promocional	skatinimo
urgència	skuba
urgència	skubos
prostitució	prostitucija
sucres	cukrų
curació	gijimo
haro	haro
obeir	paklusti
catàstrofe	katastrofos
catàstrofe	katastrofa
dissidents	disidentai
terrier	terjeras
vibració	vibracijos
vibració	vibracija
matisos	niuansų
hardcore	griežti
ballarins	šokėjų
corrosió	korozijos
rod	rodai
comerços	parduotuvės
comerços	parduotuvėse
input	įvesties
objecció	protestas
objecció	prieštaravimo
objecció	prieštaravimas
forbes	forbes
bowl	dubenį
noruecs	norvegai
protó	protonų
amon	amon
amon	amonas
fotosíntesi	fotosintezė
frens	stabdžiai
pinto	pinto
purcell	purcell
bray	bray
joshua	joshua
ricci	ricci
òptim	optimali
òptim	optimalus
cosins	pusbroliai
lviv	lvovo
meiji	meidži
transvaal	transvalio
jardineria	sodininkystės
magrana	granatų
tambors	būgnai
steiner	steiner
lligam	obligacijų
fuji	fuji
ould	ould
gilmour	gilmour
bonic	gražiai
bonic	gražus
bonic	gražūs
bonic	gražu
trujillo	trujillo
valuosa	vertinga
valuosa	vertingas
rebecca	rebecca
sébastien	sébastien
chiesa	chiesa
sinaí	sinajaus
gott	gotas
rifle	šautuvas
rifle	šautuvą
puerta	puerta
reptes	sunkumai
reptes	iššūkius
reptes	iššūkiai
giorgi	giorgi
cincinnati	sinsinačio
lynch	lynch
probabilitats	šansai
apte	tinka
nottingham	nottingham
alier	aljė
quest	žygis
reines	karalienes
bitllet	bilietas
bitllet	bilietų
bitllet	bilieto
julieta	džiuljeta
rembrandt	rembrantas
trnava	trnavos
rumor	gandai
schwerin	schwerin
parèntesi	sija
parèntesi	skliaustų
bactriana	baktrija
armando	armando
asti	asti
bandits	banditai
bor	boro
afluència	antplūdžio
competitiu	konkurencingas
competitiu	konkurencinis
arcaic	archajišką
tao	tao
betlem	betliejaus
hidràulic	hidrauliniai
iphone	iphone
jacqueline	jacqueline
raids	reidus
tre	tre
reproductor	žaidėjas
amoni	amonio
ska	ska
toyota	toyota
ebullició	virimo
porcellana	porceliano
padre	padre
valí	wali
represàlia	keršto
boví	galvijai
boví	galvijams
boví	galvijų
substantiu	daiktavardis
interfícies	jungtys
interfícies	sąsajos
ono	ono
maharaja	maharadža
abkhàzia	abchazijos
adjectius	būdvardžių
resina	derva
resina	dervos
cuinar	virimo
gardiner	gardiner
tità	titan
juno	juno
diane	diana
compartint	dalintis
compartint	kaupimo
compartint	dalijimasis
enverinat	užterštas
escobar	escobar
salinitat	druskingumas
fàbregas	fàbregas
selim	selim
autopistes	greitkelių
autopistes	greitkeliai
mico	apa
mico	beždžionė
khútor	viensėdis
kirguizistan	kirgizija
nike	nike
benz	benz
anno	anno
reialesa	autoriniai
reialesa	princeses
vicenza	kvartale
ensemble	ansamblis
canadencs	kanadiečiai
metàfora	metafora
competint	konkuruojančių
sonic	sonic
hidròxid	hidroksidas
seleuc	seleukas
maledicció	prakeiksmas
cooperatives	kooperatyvų
cooperatives	kooperatyvai
anarquia	anarchija
tma	tma
moble	baldai
borussia	borussia
sòrab	sorbų
densament	tankiai
valenciennes	valenciennes
microones	mikrobangų
morton	morton
abdicació	atsižadėjimo
concha	concha
kde	kde
apreciada	vertinamas
opressió	priespaudą
sousa	sousa
città	città
pierce	pyrsas
triàsic	triasas
nedador	gelbėtojas
nedador	plaukikas
sai	sai
armanyac	armanjakas
òptima	optimali
òptima	optimalus
deficiències	trūkumai
deficiències	trūkumai
sociòleg	sociologė
adriano	adriano
lille	lilio
conveniència	patogumo
comiat	atsisveikinimo
guevara	guevara
recreació	poilsis
sensacions	pojūčius
emberiza	emberiza
mandela	mandela
blanche	blanche
angels	angelai
rapid	greitas
jacinto	jacinto
quo	quo
diekirch	diekirch
ego	ego
maquillatge	makiažas
hera	hera
paradise	rojų
paradise	rojus
decorativa	dekoratyviniai
decorativa	dekoratyvinės
mescles	mišiniai
egypt	egipte
egypt	egipto
egypt	egiptas
mitra	mitra
pioneer	pioneer
ironia	ironija
taurons	rykliai
nutrició	mitybos
nutrició	mityba
sandy	smėlio
lama	lama
alcántara	alcantara
cornet	kornetas
fantasmes	vaiduokliai
lluminosa	šviesos
cassini	cassini
combinades	kombinuotosios
impulsos	impulsus
jam	uogiene
christina	kristina
periodicitat	periodiškumas
legalitat	teisėtumas
legalitat	teisėtumo
cuvier	cuvier
griffith	griffith
aldo	aldo
tundra	tundra
yukon	jukonas
vespasià	vespasianas
atribucions	jėgos
ren	elnio
ren	ren
gian	gian
pàrtia	partai
pomes	obuolių
pomes	obuoliai
mendelssohn	mendelssohn
cosmopolita	cosmopolitan
vinil	vinilo
tet	tet
napoli	napoli
catalogació	katalogavimo
flac	flaccus
flac	flac
dublin	dubline
dublin	dublinas
digestió	irimo
dispara	šaudo
reprodueixen	atgaminti
pavellons	paviljonų
bernstein	bernstein
königsberg	karaliaučiaus
substantius	daiktavardžiai
signant	pasirašiusios
encyclopædia	encyclopaedia
rfc	rfc
arcàdia	arkadija
massimo	massimo
cicló	ciklono
elèctrode	elektrodas
timó	timo
maya	maja
geològics	geologinio
planxa	geležies
planxa	geležis
extraterrestre	nežemiška
linné	linné
salms	psalmynas
odin	odinas
descobrint	nustatęs
destructor	naikintojas
compromisos	įsipareigojimai
encesa	uždegimas
encesa	uždegimo
hyde	haidas
bourges	buržas
cràters	krateriai
regeneració	regeneravimo
apassionat	aistringas
reactors	reaktoriai
reactors	reaktorių
sospitós	įtariamieji
sospitós	įtariamasis
ffd	ffd
aprofundir	gilinti
maharashtra	maharaštros
transportat	vežami
transportat	gabenama
destrueix	naikina
lourdes	lourdes
celtics	celtics
münster	münster
crueltat	žiaurumas
persuadir	įtikinti
persuadir	įtikino
camió	sunkvežimis
trompes	ligatūra
webster	webster
pianos	pianinai
menyspreu	panieka
elvis	elvis
dai	dai
isòtop	izotopų
comet	įsipareigoja
vinagre	actas
ostatge	įkaitų
ostatge	įkaitu
forever	amžinai
reactius	reagentai
llits	lovos
ministeris	ministerijų
ministeris	ministerijos
donzella	maiden
intercontinental	tarpžemyninis
sue	siu
coppa	coppa
paràsit	parazitų
camus	kamiu
robat	pavogtas
hernán	hernán
cosmologia	kosmologija
paràlisi	paralyžius
funcionalitats	ypatumai
funcionalitats	savybės
catocala	catocala
senzillesa	paprastumas
jungla	džiunglės
predicador	pamokslininko
palos	palos
deportes	deportes
germán	germano
rochefort	rochefort
gates	vartus
gates	vartai
sassànides	sasanidai
qualificada	kvalifikuota
indemnització	kompensacija
indemnització	kompensacijos
llangardaix	driežas
increïble	nuostabu
increïble	nuostabus
increïble	nuostabi
increïble	neįtikėtina
minsk	minsko
tudor	tudor
rac	rac
colonna	colonna
elliot	eliotas
lotto	lotto
nàutica	laivybos
tràiler	priekabos
tràiler	priekabų
tràiler	priekaba
neville	nevilis
hartmann	hartmann
encomanar	patikėti
léger	léger
inhibició	slopinimo
inhibició	slopinimas
diafragma	diafragmos
infraroig	spindulių
guglielmo	guglielmo
insereix	įterpti
carrosseria	kėbulas
sapiens	sapiens
brasilers	brazilai
surrealisme	siurrealizmas
chiapas	čiapo
germanor	brolija
sing	dainuoti
carey	carey
levante	levant
fly	skristi
monsieur	mesjė
salvia	salvia
superman	supermenas
naturalisme	natūralizmas
baja	baja
velòdrom	velodromas
excentricitat	ekscentricitetas
purs	grynas
purs	aiški
judo	dziudo
