càlid	ấm
bruges	brugge
bruges	bruges
restricció	constraint
importació	nhập
importació	danh
amfibi	amphibious
niger	niger
holocaust	holocaust
rajola	lát
rajola	ngói
gonzaga	gonzaga
miniatura	miniature
botons	nút
cremat	táng
dimonis	quỷ
onades	sóng
neue	neue
teodosi	theodosius
endemisme	endemism
gaetano	gaetano
liberalisme	liberalism
goethe	goethe
mecklenburg	mecklenburg
mecklenburg	ludwigslust
tutor	guardian
tutor	latin
tèrmic	nhiệt
sophie	sophie
harper	harper
nizam	nizam
natiu	native
defensant	cọc
orgull	ngạo
brillantor	trưng
creacions	creations
huguet	huguet
novetat	novelty
buffalo	trâu
buffalo	buffalo
icc	icc
haití	haiti
klein	klein
camille	camille
rap	rap
aaron	aaron
rojas	rojas
sequera	lau
lucia	lucia
mamelucs	mamluk
amore	amore
citació	citation
mickey	mickey
batejar	christened
sarthe	sarthe
radial	radial
christoph	christoph
silèsia	silesia
observadors	observers
australis	australis
prestacions	lợi
romanç	romance
falles	fail
clos	clos
remix	remix
puente	puente
classicisme	classicism
heretat	thừa
vílnius	vilnius
pelegrí	pilgrim
ada	ada
hughes	hughes
astrònoms	astronomers
ecosistemes	ecosystems
suzuki	suzuki
alpí	alpine
màscara	nạ
màscara	mask
titus	titus
vertebrata	vertebrata
salari	lương
karen	karen
pensaments	suy
sancho	sancho
fraccions	fractions
montes	montes
calderón	calderón
bruixa	thuỷ
bruixa	thủy
tempo	gear
zhao	triệu
palacio	palacio
metà	mêtan
metà	metan
metà	methane
xilè	chile
baikonur	baikonur
bretagne	bretagne
préstec	vay
shan	đan
shan	shan
prieto	prieto
uzbekistan	uzbekistan
derivació	derivation
passi	qua
passi	đèo
passi	pass
grava	sỏi
mtv	mtv
esquirol	sóc
philipp	philipp
heròdot	herodotus
camisa	áo
bars	thanh
sard	sard
elies	elijah
diferenciades	reel
preludi	prelude
hussein	hussein
votacions	bầu
beatles	beatles
pete	pete
nationale	nationale
freud	freud
minisèrie	miniseries
whitehead	whitehead
lotus	lotus
elst	elst
dolmen	dolmen
feix	beam
gaza	gaza
inundació	lụt
inundació	gượng
qatar	qatar
orgànic	organic
murat	murat
millorant	healing
nasr	nasr
circumscripcions	constituencies
destacament	detachment
kassel	kassel
concepción	concepción
primats	primates
enviament	gửi
enviament	phái
aposta	cược
betis	betis
emil	emil
break	break
break	phá
juventus	juventus
rèplica	replica
halle	halle
comnè	komnenos
luisa	luisa
abelles	ong
octets	byte
octets	bytes
auf	auf
secta	cult
storia	storia
escriptori	bàn
canaveral	canaveral
interrupció	ngắt
mama	mommy
mama	mẹ
nocturns	nocturnes
abric	khoác
analítica	analytic
grey	xám
atzur	azur
negreta	đậm
negreta	bold
pia	pia
contrapunt	counterpoint
deformació	warp
calvados	calvados
neurones	neurons
fòsfor	phốtpho
invitació	mời
winston	winston
take	lấy
take	bắt
take	chụp
wwe	wwe
cubana	cuba
canària	canaria
claire	claire
anarquisme	anarchism
mohamed	mohamed
seül	hé
seül	seoul
sogorb	segorbe
wien	wien
tito	tito
perla	pearl
perla	trân
millars	mijares
wales	wales
georgià	georgian
corones	crowns
comenta	luận
gauss	gauss
elvira	elvira
fertilitat	fertility
litúrgia	liturgy
claret	claret
barraca	lán
barraca	shack
vençut	bại
galera	galera
entès	hiểu
richardson	richardson
forja	forge
cub	cube
cub	rubik
willem	willem
gauguin	gauguin
antigen	antigen
hermes	hermes
dent	răng
montbui	montgomery
anhalt	anhalt
repte	thạch
repte	thách
dubai	dubai
celtes	celts
augusto	augusto
currículum	cv
currículum	resume
lucien	lucien
vals	waltz
vals	valse
assassins	assassins
milton	milton
reservat	reserved
elias	elias
theodor	theodor
emissores	trạm
brots	mầm
anas	anas
manolo	manolo
westfàlia	westphalia
corydoras	corydoras
màrqueting	marketing
cambodja	campuchia
gota	giọt
gota	bỏ
gota	thả
cardiff	cardiff
ming	minh
ming	ming
creient	believer
monts	monts
hostil	địch
samarcanda	samarkand
leopoldo	leopoldo
cabot	cabot
capadòcia	cappadocia
amenaçar	true
amenaçar	tru
ferradura	horseshoe
vaques	bò
todd	todd
cubà	cuba
rachel	rachel
clermont	clermont
fonte	fonte
amour	amour
seriós	bách
vittorio	vittorio
zenit	zenith
connor	connor
inèdit	unreleased
tòxics	độc
claredat	clarity
cargol	ốc
reflexions	reflections
banya	sừng
banya	kèn
banya	horn
tigris	tigris
salada	mặn
dénia	denia
mediawiki	mediawiki
peons	pawns
justificació	justification
hutchinson	hutchinson
amanda	tô
amanda	amanda
lope	lope
sirià	syria
sirià	syrian
xxx	xxx
christine	christine
kabul	kabul
pat	pat
pat	vỗ
opositors	opponents
orne	orne
préstecs	vay
arslan	arslan
novo	novo
baluard	bastion
fame	fame
bellas	bella
bellas	bellas
biodiversitat	biodiversity
hunt	hunt
hunt	săn
níquel	nickel
níquel	niken
grip	cúm
grip	cúm
enviant	gửi
enviant	phái
assegut	ngồi
pieter	pieter
busquets	busquets
camino	camino
diamants	rô
huber	huber
jubilat	hưu
nusos	hải
grimaldi	grimaldi
cdc	cdc
artigas	artigas
condé	condé
examinar	khám
boig	khùng
boig	điên
cherokee	cherokee
tessalònica	thessaloniki
lieder	lieder
warriors	warriors
planck	planck
ngc	ngc
leguminosae	leguminosae
alexis	alexis
recepta	thức
recepta	recipe
bismarck	bismarck
híbrid	hybrid
fullname	fullname
ponce	ponce
tirant	ném
epítet	epithet
deficiència	deficiency
fulls	lá
fulls	tờ
fulls	mẩu
fulls	sheets
geschichte	geschichte
caríntia	kärnten
piera	piera
misericòrdia	mercy
plutarc	plutarch
parentiu	kinship
provat	xua
sayyid	sayed
bolxevics	bolshevik
euskal	euskal
rouen	rouen
derby	derby
ducal	ducal
ratolins	chuột
heràldica	heraldry
moz	moz
sia	sia
soterrani	hầm
estepa	cistus
dinamo	dynamo
amaga	giấu
amaga	trốn
amaga	ẩn
miler	millar
cúria	curia
hormones	hormone
hormones	hormon
hormones	hormones
beijing	kinh
mossul	mosul
kyoto	kyoto
herodes	herod
aube	aube
garibaldi	garibaldi
musique	musique
leslie	leslie
fixació	fixing
evangelista	evangelista
dinàmic	động
trad	trad
vargas	vargas
bradley	bradley
madre	madre
oller	oller
bennett	bennett
bennett	bennet
funerari	đòn
panell	tấm
haplochromis	haplochromis
aparcament	đỗ
conducte	conduit
todo	todo
méndez	mendez
shu	tú
shu	thục
shu	shu
gogh	gogh
oval	oval
khorasan	khorasan
sulfur	sulfide
cano	cano
licini	licinius
pin	ghim
pin	pin
melilla	melilla
asp	asp
llops	sói
becker	becker
ida	lda
ida	ida
gasolina	xăng
gasolina	xăng
dioclecià	diocletianus
doctrines	doctrines
poma	táo
poma	apple
rubens	rubens
topologia	topology
cúmul	cụm
vosges	vosges
móra	blackberry
blas	blas
mariana	mariana
esther	esther
periódico	báo
presideix	ghế
cracòvia	krakow
friül	friuli
salat	mặn
cabina	cockpit
cabina	chòi
cabina	cabin
arbusts	shrubs
ampolla	chai
palestins	palestinians
angela	angela
clor	clo
clor	chlorine
guyana	guyana
mergus	mergus
marcs	khung
voluntària	nguyện
cantada	soong
cantada	sung
bèstia	beast
bèstia	tã
destino	destino
fong	fungus
fong	nấm
revelat	revealed
revelat	lộ
olla	nồi
olla	pot
limburg	limburg
pacheco	pacheco
rohan	rohan
champions	champions
lionel	lionel
neill	neill
carbonat	cacbonat
goldstein	goldstein
manacor	manacor
kings	kings
kings	vua
peugeot	peugeot
curvatura	cong
faust	faust
lou	lou
inserció	chèn
kiss	hôn
kiss	kiss
espatlles	vai
api	api
capdevila	capdevila
haven	haven
glenn	glenn
motí	loạn
curiós	curious
curiós	mò
justin	justin
split	tách
split	chia
simulació	mô
monica	monica
geoffrey	geoffrey
bethesda	bethesda
gustave	gustave
maura	maura
transsilvània	transylvania
bangladesh	bangladesh
pretensions	ngợi
pretensions	khai
seqüela	sequel
gesta	gesta
gesta	brewing
giménez	giménez
ban	ban
ban	cấm
keyserling	keyserling
guanys	gains
betty	betty
emi	emi
gaston	gaston
conan	conan
escorial	escorial
coco	coco
coco	dừa
euràsia	eurasia
multi	đa
multi	multi
libertad	libertad
núvia	bride
rosen	rosen
tòxic	độc
paso	paso
namur	namur
rai	rai
cantonal	cantonal
riqueses	riches
enfonsament	chìm
sami	sami
rastre	trail
univ	univ
lyon	lyon
paga	trả
cornell	cornell
isla	isla
ovella	cừu
bales	đạn
bambú	bamboo
bambú	tre
rouge	rouge
ellis	ellis
caixmir	kashmir
bartolomeo	bartolomeo
gill	gill
mono	mono
atlàntics	atlantiques
peters	peters
assigna	gán
lucca	lucca
ceba	onion
ceba	hành
nitra	nitra
volcans	volcanoes
pandanus	dứa
pandanus	pandanus
ponte	ponte
abandó	abandonment
gemma	gemma
doubs	doubs
salas	salas
avant	avant
herat	herat
maison	maison
imitar	mimic
multa	ổn
multa	khỏe
aeronàutica	aeronautics
hart	hart
tucker	tucker
efes	ephesus
demografia	demography
deo	deo
premiat	thưởng
woods	rừng
ave	ave
fisher	fisher
martha	martha
homs	homs
brien	brien
biogràfic	biographical
crawford	crawford
vàndals	vandals
akbar	akbar
voyage	voyage
aix	aix
sankt	sankt
gps	gps
nouvelle	nouvelle
pissarra	slate
falses	sai
falses	giả
mehmet	mehmed
mehmet	mehmet
britània	britannia
saladí	saladin
marcelo	marcelo
coppola	coppola
windsor	windsor
cesare	cesare
amiens	amiens
abstracció	abstraction
fitxes	lát
fitxes	chips
holland	holland
face	face
face	mặt
àtic	attic
àtic	gác
yorkshire	yorkshire
thomson	thomson
flotant	lỏng
flotant	float
flotant	nổi
marvel	marvel
liga	liga
sil	sil
ine	ine
graella	lưới
landes	landes
richmond	richmond
seychelles	xê
seychelles	seychelles
ratpenats	dơi
gerhard	gerhard
paradigma	paradigm
aviv	aviv
malla	lưới
malla	mesh
cork	cork
luciano	luciano
borís	boris
tonga	tonga
cascades	cascades
cascades	ngã
cascades	falls
cascades	thác
cascades	rơi
cascades	sút
île	île
trois	trois
talls	cắt
cru	raw
cru	thô
giray	giray
xemeneia	chimney
samurai	samurai
stevens	stevens
missatger	messenger
minas	minas
genoll	gối
reclamacions	ngợi
reclamacions	khai
fourier	fourier
modulació	modulation
heinz	heinz
oculta	giấu
oculta	trốn
oculta	ẩn
estimava	yêu
clàusula	clause
urà	uranus
hindi	hindi
houghton	houghton
benedetto	benedetto
neo	neo
humbert	humbert
veracruz	veracruz
veronica	veronica
elfs	tiên
elfs	elves
llapis	chì
llapis	pen
llapis	bút
sabates	giày
sabates	giầy
sabates	móng
txaikovski	tchaikovsky
violeta	violet
calatrava	calatrava
bernardino	bernardino
almagro	almagro
botes	giày
botes	bốt
botes	ủng
botes	boots
veterà	hanh
boom	hụt
boom	bùm
boom	boom
toulouse	toulouse
ganivet	đao
ganivet	dao
soldadura	hàn
ankara	ankara
pavia	pavia
petra	petra
cbs	cbs
dar	dar
earl	earl
earl	lô
patata	khoai
christi	christi
beck	beck
make	pha
nicole	nicole
espectral	spectral
belize	be
belize	belize
pèrgam	pergamon
barber	barber
dordonya	dordogne
stop	dừng
stop	ngừng
chang	chang
gerald	gerald
judith	judit
judith	judith
wehrmacht	wehrmacht
casella	casella
regan	regan
fiji	fiji
ans	ans
getafe	getafe
liechtenstein	liechtenstein
cortina	màn
cortina	curtain
cortina	chăn
cortina	rèm
cortina	cortina
laurence	laurence
sen	sen
danesos	danes
palmer	palmer
xml	xml
xml	xm
half	nửa
mpeg	mpeg
michelle	michelle
violins	violins
himàlaia	himalaya
himàlaia	himalayas
theodore	theodore
joia	ngọc
joia	jewel
duero	douro
say	nói
say	tràng
espia	điệp
damià	damian
insulina	insulin
vulgaris	vulgaris
hansen	hansen
venuda	bán
fonètica	phonetics
orinoco	orinoco
lladre	trộm
kai	kai
desempat	playoff
georgia	gruzia
georgia	georgia
explorer	explorer
segregació	segregation
mentor	mentor
femme	femme
trencant	phá
trencant	breaking
traça	vết
traça	trace
tanganyika	tanganyika
genocidi	genocide
alpha	alpha
alpha	alfa
avortament	abortion
comprimit	tablet
stella	stella
federer	federer
teheran	tehran
traç	cú
traç	đòn
bahames	bahamas
sega	sega
richards	richards
anselm	anselm
dragons	rồng
emèrit	emeritus
konrad	konrad
bat	bat
bat	dơi
tiger	tiger
tiger	cọp
tiger	hổ
fiord	fjord
monstres	gắn
monstres	freaks
intercanvis	exchanges
lev	lev
cassi	cassius
dana	dana
podi	bục
podi	podium
gracilis	gracilis
donetsk	donetsk
esp	esp
pebre	pepper
pebre	tiêu
primerenc	sớm
tosca	tosca
salazar	salazar
márquez	marquez
trieste	trieste
agressió	aggression
arrencada	boot
yucatán	yucatán
quadern	notebook
quadern	quyển
elisa	elisa
monroe	monroe
nínxol	niche
compagno	compagno
grenoble	grenoble
casanovas	casanovas
cali	cali
amazon	amazon
cole	cole
innocent	tội
sènior	sr
sènior	senior
pulla	apulia
xavi	xavi
hamlet	hamlet
estrada	estrada
mahler	mahler
enriqueta	henrietta
suàbia	swabia
vistos	thấy
barrio	barrio
titella	rối
helicòpters	helicopters
virgin	trinh
virgin	virgin
virgin	tân
festiu	holiday
bacteri	bacterium
amy	amy
assessorament	khuyên
amorosa	yêu
duncan	duncan
grandes	grandes
jerez	sherry
jerez	jerez
dièsel	diesel
predominantment	predominantly
zheng	trịnh
zheng	zheng
moles	moles
moles	mol
balada	ballad
self	self
self	tự
macmillan	macmillan
niccolò	niccolò
crit	quát
crit	hét
tonalitats	shades
cecil	cecil
agitació	uro
casablanca	casablanca
finalitzat	xong
turíngia	eichsfeld
fricció	friction
fràgil	sệt
smash	smash
istme	isthmus
ecuador	ecuador
asfalt	nhựa
engel	engel
liang	lương
liang	liang
reunits	đọt
guardià	guardian
sender	trail
paròdia	parody
viver	viver
oder	oder
alsina	alsina
pollastre	gà
oboè	oboe
norton	norton
todos	todos
schleswig	schleswig
conills	thỏ
activisme	activism
menú	menu
nigel	nigel
promeses	hứa
iwamoto	iwamoto
bolets	nấm
parra	parra
mantega	bơ
fresca	tươi
joyce	joyce
portàtil	laptop
èpica	huyền
salou	salou
assam	assam
henares	henares
irc	irc
emilia	emilia
roewer	roewer
banquet	yến
boscoses	forested
breslau	breslau
confessió	confession
benedicció	blessing
jeffrey	jeffrey
gracia	ân
gracia	grace
gracia	tha
newcastle	newcastle
cadaqués	cadaqués
lusignan	lusignan
dea	dea
cons	cons
executa	chạy
heroïna	heroin
nadir	nadir
ossa	ossa
eyck	eyck
majordom	butler
largo	largo
faso	faso
gandhi	gandhi
gomes	gomes
chemical	hóa
aconsellar	khuyên
percy	percy
trobi	tìm
look	xem
look	nhìn
mustafa	mustafa
fbi	fbi
fbi	cục
andrònic	andronicus
reggio	reggio
mad	giận
vel	mờ
yonne	yonne
atura	dừng
atura	ngừng
yazid	yazid
ace	ách
ace	ace
bruc	erica
exàmens	thi
contribueixen	góp
suez	suez
antàrtic	antarctic
mesnil	mesnil
visualització	xem
visualització	view
puccini	puccini
ich	ich
sarajevo	sarajevo
botswana	botswana
aquila	aquila
leibniz	leibniz
irving	irving
torino	torino
dèbil	yếu
dèbil	nhược
dolços	sweet
dolços	ngọt
lotaríngia	lorraine
rousseau	rousseau
lira	lira
lira	lire
escandinàvia	scandinavia
nua	naked
trentino	trento
cedida	ceded
tokugawa	tokugawa
greg	greg
jamie	jamie
baba	baba
baba	margo
ghost	ghost
ghost	ma
desgast	mặc
desgast	đeo
venedor	nhã
derek	derek
entrenadors	coaches
bolet	nấm
longitudinal	longitudinal
vostè	các
vostè	cac
vostè	bạn
vostè	anh
vostè	cô
chuck	chuck
cintura	eo
cintura	hông
càller	cagliari
indicadors	cờ
nevers	nevers
pag	pag
praia	praia
sms	sms
lac	lac
edge	mép
edge	edge
edge	rìa
edge	cạnh
bordes	bordes
osasuna	osasuna
sonar	âm
augsburg	augsburg
reedició	reissue
plàstics	nhựa
supremacia	supremacy
guaita	lookout
lakers	lakers
pennsylvania	pennsylvania
terre	terre
collar	collar
jakob	jakob
sharon	sharon
vélez	vélez
toros	bò
toros	bulls
eli	eli
falco	falco
pizarro	pizarro
hubble	hubble
literal	verbatim
aro	aro
complert	khen
salvatore	salvatore
toló	toulon
gibbs	gibbs
fontana	fontana
emboscada	ambush
voltaire	voltaire
ladislau	władysław
peshwa	peshwa
generalitzat	generalized
dylan	dylan
bosó	boso
cleòpatra	cleopatra
bratislava	bratislava
baranes	rails
fenícia	phoenicia
nigra	nigra
cras	crassus
crucifixió	crucifixion
choctaw	choctaw
muda	dummy
muda	nộm
fuig	scat
lat	lat
lat	lạt
meurthe	meurthe
garros	garros
gram	gam
gram	gram
gram	grams
canari	serinus
canari	canary
vacunes	ngừa
pomerània	pomerania
apogon	apogon
bearn	béarn
drake	drake
eddy	eddy
zoològic	thú
zoològic	zoo
cercant	ve
robots	robot
robots	robots
raven	quạ
raven	raven
matas	matas
chi	chi
romain	romain
porno	porn
woody	woody
cantat	soong
cantat	sung
cxd	cxd
neuville	neuville
bayer	bayer
palais	palais
tars	tarsus
bàssora	basra
raquel	raquel
gervasi	gervasio
sally	sally
chester	chester
hastings	hastings
led	led
uthman	uthman
robusta	robusta
gap	gap
saba	saba
ghazi	ghazi
aznar	aznar
brahms	brahms
devil	devil
devil	quỷ
bergen	bergen
estendard	banner
agave	thùa
agave	agave
piotr	piotr
dortmund	dortmund
agra	agra
multiplicar	nhân
eyes	mắt
sad	buồn
hilaire	hilaire
cendra	ash
cendra	tro
cendra	chua
villiers	villiers
tenda	lều
friburg	freiburg
shi	shi
shi	thạch
nash	nash
senecio	senecio
estètic	aesthetic
dispersos	loãng
antígon	antigonos
susa	susa
diamond	zô
diamond	diamond
britannica	britannica
florence	florence
virtuals	ảo
logística	logistics
perles	perles
android	android
fluxos	màng
granados	granados
lin	lin
lin	lâm
anima	anima
anima	hoạt
diàspora	diaspora
bains	bains
rodolfo	rodolfo
milano	milano
leicester	leicester
gruixut	thick
gruixut	dầy
gruixut	dày
alicia	alicia
jackie	jackie
viatjant	salesman
jesse	jesse
arenas	arenas
carmel	carmel
extermini	extermination
cromwell	cromwell
ulleres	kính
miralls	gương
miralls	mirrors
vernon	vernon
vernon	dượng
represa	cv
represa	resume
bourg	bourg
deus	deus
carroll	carroll
harald	harald
gambet	gambit
kuban	kuban
ist	ist
chase	đuổi
chase	tẩu
chase	chase
manfred	manfred
troyes	troyes
dinou	nineteen
albi	albi
hood	mui
hood	hood
cesarea	caesarea
montero	montero
lleu	nhẹ
trail	trail
indianapolis	indianapolis
estonià	estonia
laval	laval
feminisme	feminism
marxes	marches
lausana	lausanne
hormona	hormone
hormona	hormon
frances	frances
dvb	dvb
core	lõi
core	hạt
core	nhân
edison	edison
hortalisses	rau
cartoixa	charterhouse
convidada	khách
helicòpter	helicopter
helicòpter	thăng
göttingen	göttingen
odessa	odessa
infinita	infinite
infinita	vá
abad	abad
castel	castel
ajax	ajax
mona	mona
immersió	immersion
immersió	lặn
caient	falling
caient	rơi
rars	hiếm
eugen	eugen
etíop	ethiopia
diferenciats	differentiated
edmond	edmond
eocè	eocene
plutó	pluto
chaplin	chaplin
greene	greene
greene	greens
timor	timor
motlle	mốc
cordó	cordon
anònims	anonymous
lídia	phuong
lídia	lydia
châtillon	châtillon
lars	lars
tauró	shark
tauró	carcharhinus
millet	kê
ethnologue	ethnologue
supervivent	survivor
salta	nhảy
salta	skip
arcàngel	archangel
sanció	penalty
sanció	phạt
tau	tau
oca	ngỗng
oca	goose
coincidència	thủ
coincidència	khớp
metròpoli	metropolis
morro	morro
cars	oto
cars	ôtô
pneumàtics	tires
pneumàtics	lốp
gitanos	gypsies
glen	glen
cartutx	hộp
machado	machado
cohesió	cohesion
barques	thuyền
lot	đợt
lot	batch
lot	mẻ
lot	bó
lot	lot
marcello	marcello
webb	webb
žilina	žilina
sandra	sandra
richter	richter
larson	larson
bogeria	madness
bogeria	insanity
sabana	savannah
sabana	savanna
coruña	coruna
coruña	coruña
francolí	francolinus
austral	austral
byron	byron
magí	magi
jung	jung
felice	felice
anàleg	analogue
anàleg	analog
etern	mải
subsistència	livelihood
leigh	leigh
vieux	vieux
tai	thái
tai	tai
maduració	maturation
düsseldorf	düsseldorf
rpm	rpm
dalmàcia	dalmatia
uppsala	uppsala
lam	lam
lam	lâm
ccd	ccd
baumann	baumann
descartes	descartes
pulmó	phổi
pulmó	lung
than	hơn
tango	tango
rivière	rivière
barset	barset
tate	tate
gottfried	gottfried
cinca	cinca
gardner	gardener
gardner	gardner
inducció	induction
isa	isa
benidorm	benidorm
misèria	khổ
misèria	misery
suro	cork
ley	ley
generalització	generalization
kit	kit
avenir	avenir
isfahan	isfahan
malwa	malwa
leeds	leeds
concòrdia	concordia
ophrys	ophrys
gerardo	gerardo
willy	willy
rocky	rocky
lex	lex
chu	chu
aden	aden
gotha	gotha
imperis	empires
trobadors	troubadours
varela	varela
burke	burke
sancti	sancti
reivindicació	nhận
antigua	antigua
desafiament	thạch
desafiament	thách
kant	kant
salem	salem
còdols	sỏi
còdols	pebbles
rana	rana
jonas	jonas
fragmentació	fragmentation
plymouth	plymouth
liszt	liszt
tumor	bướu
bdfutbol	bdfutbol
milla	dặm
nathan	nathan
triangles	tam
mekong	mekong
rangers	rangers
rangers	kích
ver	ver
gelosia	jealousy
cànons	royalties
fotògrafs	photographers
postures	posing
hal	hal
vulnerable	cửi
jpeg	jpeg
rossa	blonde
brot	brot
aranda	aranda
rojo	rojo
llàgrimes	lăn
simultània	simultaneous
doris	doris
poitou	poitou
kirk	kirk
gradient	gradient
hitita	hittite
montreal	montréal
montreal	montreal
audició	audition
sondes	dò
espín	spin
espín	quay
natzaret	nazareth
suisse	suisse
tirada	xạo
fleming	fleming
etanol	ethanol
bosses	túi
jet	jet
tracy	tracy
reservada	reserved
stein	stein
firefox	firefox
janet	janet
cronològic	chronological
freeman	freeman
aspiracions	tr
medicament	thuốc
đoković	djokovic
dotació	endowment
sanremo	sanremo
carrasco	carrasco
manganès	mangan
mayenne	mayenne
moràvia	moravia
doc	doc
estímul	stimulus
regia	regia
molar	molar
apartheid	apartheid
essex	essex
bolxevic	bolshevik
popa	popa
racisme	racism
sabre	sabre
vasari	vasari
dijon	dijon
rivas	rivas
flautes	sáo
shell	vảy
shell	shell
germandat	brotherhood
nimfa	nymph
carnegie	carnegie
orfe	orphan
orfe	côi
perfumeria	perfume
cantor	cantor
serge	serge
caporiacco	caporiacco
impulsada	driven
brunsvic	brunswick
indie	indie
bernhard	bernhard
grafica	grafica
schumann	schumann
terrasses	terraces
pròximes	sắp
pelayo	pelayo
realistes	tế
esbós	sketch
cabo	cabo
pesada	nặng
tabriz	tabriz
impliquen	ro
execucions	executions
broma	joke
broma	đùa
broma	đểu
didier	didier
oscars	oscars
oscars	oscar
fosses	nách
kepler	kepler
habitant	capita
bitínia	bithynia
ontario	ontario
consolidat	consolidated
eliminatòries	playoffs
oblidat	quên
guardian	guardian
judit	judit
judit	judith
gruyter	gruyter
colonia	colonia
òscar	oscar
meridià	meridian
piles	bình
piles	pin
piles	piles
cinemes	rạp
qué	qué
mauro	mauro
eudes	eudes
malvat	ác
malvat	wicked
dracs	rồng
benfica	benfica
berta	bertha
microscopi	microscope
microscopi	phức
casp	casp
carlí	carlist
aleatòria	cuốc
aleatòria	nét
posidó	poseidon
humboldt	humboldt
gotes	guốc
gotes	giọt
girolamo	girolamo
contenidor	container
llegint	truyện
llegint	đọc
singularitat	singularity
santedat	holiness
yan	yến
yan	yan
yan	nhan
canaria	canaria
ies	ies
timothy	timothy
dux	doge
asteca	aztec
lèmurs	lemurs
colesterol	cholesterol
vivo	vivo
vilaine	vilaine
annales	annales
açores	azores
aule	aulus
enterprise	enterprise
ors	ors
septimània	septimania
olaf	olaf
discutit	dóc
prunus	prunus
kart	kart
karate	karate
trinidad	trinidad
peris	peris
against	dũng
against	chống
trias	trias
ballets	ballets
royale	royale
dulce	dulce
lahore	lahore
room	phòng
fletcher	fletcher
nacionalitats	nationalities
encarnació	kiếp
cívic	civic
faraons	pharaon
faraons	pharaoh
ria	ria
olympique	olympique
edessa	edessa
descansa	nghỉ
remake	remake
preocupat	lo
synodontis	synodontis
llebre	lepus
llebre	hare
horus	horus
adalbert	adalbert
hayes	hayes
igor	igor
robertson	robertson
salaris	lương
brad	brad
esmalt	men
euclides	euclid
teleosti	teleostei
chao	chao
liti	lithium
liti	liti
premiada	thưởng
creuat	dấu
llenya	củi
trinity	trinity
elegans	elegans
sext	sextus
ryukyu	ryukyu
meshid	meshid
jeremy	jeremy
passes	bước
jessica	jessica
karel	karel
emancipació	emancipation
cabaret	cabaret
romanya	romagna
rashid	rachid
rashid	rashid
metadades	siêu
fre	phanh
bering	bering
galileu	galileo
milet	miletus
schubert	schubert
heredia	heredia
vertebral	vertebral
matteo	matteo
matteo	mateo
maldonado	maldonado
ramis	ramis
cornualla	cornwall
gutenberg	gutenberg
papallones	bướm
vichy	vichy
aubin	aubin
filera	hàng
rèquiem	requiem
bhutan	bhutan
amoníac	ammonia
amoníac	ammoniac
horn	sừng
horn	kèn
horn	horn
cecs	mù
marin	marin
huang	hoàng
huang	huang
esmirna	smyrna
isidro	isidro
yin	âm
yin	yin
osman	osman
chico	chico
judea	judea
prof	prof
tobago	tobago
araneus	araneus
tyler	tyler
barnes	barnes
coreografia	choreography
tríptic	triptych
estella	estella
apocalipsi	apocalypse
bergman	bergman
cantonals	cantonal
ela	ela
erau	hérault
hoffmann	hoffmann
hoffmann	hoffman
tangent	tangent
ase	donkey
ase	lừa
pistons	piston
toda	toda
cuc	giun
cuc	worm
python	python
python	trăn
pànic	panic
turkmenistan	turkmenistan
balkh	balkh
nóvgorod	novgorod
fabi	fabius
oswald	oswald
café	café
nixon	nixon
tributaris	tributaries
savis	wise
raion	raion
barat	cheap
barat	rẻ
hernando	hernando
balança	libra
explícita	dâm
mònica	monica
ganges	hằng
mitocondrial	mitochondrial
marguerite	marguerite
prolífic	prolific
euphorbia	euphorbia
puny	bó
latina	latinh
latina	latina
infermeria	nursing
champagne	champagne
anglesola	riyadh
especies	especies
calcuta	calcutta
sabina	sabina
ham	ham
olympia	olympia
laberint	mê
denver	denver
veles	nến
isidor	isidor
isidor	isidore
edith	edith
bucle	lặp
bucle	loop
brescia	brescia
aprox	khoảng
aprox	approx
basal	basal
audiències	hearings
amr	amr
tina	tina
norfolk	norfolk
henderson	henderson
vernet	vernet
surf	surf
surf	lướt
thierry	thierry
magúncia	mainz
niño	niño
plafons	bảng
situ	situ
nin	nin
icv	icv
excepcionalment	exceptionally
casta	caste
trampa	bẫy
trampa	tráp
parque	parque
correctes	đúng
contextos	contexts
estàtica	tích
estàtica	tĩnh
tirador	slingshot
burns	cháy
bajo	bajo
plomatge	plumage
cuevas	cuevas
cuenca	cuenca
artois	artois
regnum	regnum
cobra	cobra
uzbeks	uzbeks
muro	muro
burundi	burundi
braun	braun
esposes	vợ
crespo	crespo
coregonus	coregonus
viktor	viktor
contesa	feud
rococó	rococo
carnestoltes	carnival
antonia	antonia
asunción	asunción
palm	palm
palm	sên
palm	cọ
cadet	cadet
lond	lond
harcourt	harcourt
navajo	navajo
vaux	vaux
cirera	cherry
kobayashi	kobayashi
rich	vương
rich	giàu
rich	rich
regio	regio
triada	triad
greixos	fats
gers	gers
gili	gili
jenkins	jenkins
donatello	donatello
herrero	rèn
kane	kane
calle	calle
bol	bát
oïda	ear
oïda	tai
dorotea	dorothea
