dolç	lieflike
dolç	soet
larry	larry
patent	patent
twitter	twitter
wayne	wayne
cerimònies	ceremonies
fictici	fiktiewe
escates	skale
vocabulari	woordeskat
pila	hopie
pila	stapel
dick	dick
prior	prior
edimburg	edinburgh
narbona	narbonne
motocicletes	motorfietse
arsenal	arsenal
delictes	misdade
delictes	misdrywe
ortiz	ortiz
avenç	deurbraak
avenç	baanbreker
cia	cia
cia	cla
pink	pienk
iglesias	iglesias
hannover	hanover
hannover	hannover
submarí	duikboot
llibertats	vryhede
servidors	bedieners
excepcions	uitsonderings
jamaica	jamaika
letó	lettiese
generat	gegenereerde
generat	gegenereer
observador	observer
tiberi	tiberius
fotogràfica	photographic
fotogràfica	fotografiese
quintana	quintana
interaccions	interaksies
pesant	swaar
atlanta	atlanta
substitueix	oordra
substitueix	spasie
recomana	aanbeveel
recomana	beveel
houston	houston
singapur	singapoer
deure	plig
assíria	assirië
aprenent	apprentice
rubí	ruby
northern	noordelike
northern	northern
sul	sul
fritz	fritz
edgar	edgar
pietat	mercy
phil	phil
andreas	andreas
somme	somme
joies	juwele
antecedents	agtergrond
ryan	ryan
versalles	versailles
pica	pike
búlgar	bulgaars
deutsche	deutsche
albacete	albacete
repúbliques	republieke
susan	susan
convidats	gaste
bàrbara	barbara
infern	hell
infern	inferno
lost	verlore
lost	verloor
mini	mini
operar	operate
operar	opereer
filòsofs	filosowe
rosario	rosario
salvat	gestoor
salvat	geberg
permanents	permanente
permanents	permanent
modest	beskeie
segments	segmente
mansur	mansur
nikolai	nikolay
marcos	marcos
gestionar	bestuur
amplitud	amplitude
inter	inter
especialitzats	specialized
geologia	geologie
avaluar	evalueer
banca	bench
llars	huishoudings
gall	haan
aristocràcia	aristokrasie
piscina	swembad
atles	atlas
imdb	imdb
clars	skoonmaak
clars	skoon
suplent	afwissel
suplent	alternatiewe
participacions	gedeel
marató	marathon
marató	maraton
ànimes	souls
cec	blind
secretària	sekretaris
secretària	sekretaresse
feliç	gelukkig
exiliats	uitgewekenes
distribuïts	verspreide
dalí	dalí
marino	marino
madame	madame
emigració	emigrasie
multimèdia	multimedia
creades	geskep
fosfat	fosfaat
ipa	ipa
ferrara	ferrara
mag	towenaar
act	wet
autobusos	busse
ovelles	skaap
confirma	bevestig
mariner	matroos
adjacent	aangrensende
matilde	matilde
gloria	gloria
logotip	logo
logotip	kenteken
infinit	oneindige
infinit	infinity
jason	jason
guerrer	warrior
guerrer	vegter
römer	römer
pineda	pineda
hist	hist
perfecta	perfek
charlotte	charlotte
actualització	opdateer
actualització	opgedateer
cromosoma	chromosoom
coca	coke
coca	coca
inundacions	vloede
sanz	sanz
salts	duik
salts	diving
gregorio	gregorio
zur	zur
helen	helen
sergent	sersant
ambulància	ambulans
peña	peña
kosovo	kosovo
emès	uitgereik
gots	gote
vaca	koei
sebastián	sebastian
ciment	cement
cadira	chair
cadira	voorsitter
cadira	stoel
transbordador	ferry
làser	laser
claudio	claudio
apòstol	apostle
apòstol	apostel
progressiva	progressiewe
libro	libro
evita	evita
adhesió	lidmaatskap
fum	smoke
niu	nes
equivalents	equivalents
consolat	konsulaat
masters	masters
wallace	wallace
amos	amos
amos	masters
peó	pion
comissionat	kommissaris
infraphylum	infraphylum
dotzena	twelfth
mon	mon
adquirida	gewen
erosió	erosie
verona	verona
civilitzacions	beskawings
hugh	hugh
lara	lara
simpson	simpson
implementació	implementering
guido	guido
robinson	robinson
cabells	hare
bemoll	plat
arturo	arturo
divuit	agtien
bobby	bobby
consonant	konsonant
estrasburg	strasbourg
raúl	raúl
horda	horde
adolfo	adolfo
gneu	gnaeus
budisme	boeddhisme
cretaci	kryt
volant	vlieënde
volant	flying
sostingut	skerp
bakr	bakr
oceans	oseane
consorci	consortium
otan	navo
honda	honda
empat	gelykop
empat	das
aguda	akute
compatible	aanpasbaar
compatible	versoenbaar
pastors	herdershonde
telecomunicacions	telekommunikasie
morris	morris
side	kant
consentiment	toestemming
pàdua	padua
charente	charente
paradís	paradise
caserna	kaserne
presentant	aangebied
múltiple	veelvuldige
múltiple	veelvoud
laos	laos
kara	kara
llegendari	legendariese
llegendari	legendary
adaptada	adapted
cristall	kristal
cristall	crystal
duo	duet
duo	duo
musa	musa
musa	muse
transparent	deursigtig
transparent	transparent
transparent	deursigtige
olimpíada	olimpiade
auguste	auguste
potassi	kalium
espiral	spiral
feminista	feminist
einstein	einstein
bitllets	kaartjies
companya	companion
escolta	luister
warren	warren
forçat	geforseer
forçat	gedwing
quentin	quentin
garantia	waarborg
garantia	waarborg
eficient	doeltreffende
eficient	doeltreffend
destacable	merkwaardig
destacable	remarkable
electrodomèstics	toebehore
electrodomèstics	toestelle
consecutives	agtereenvolgende
palerm	palermo
mòduls	modules
nenes	meisies
nenes	mishandel
xbox	xbox
gaudeix	enjoy
llenç	doek
operatius	operasionele
compliment	nakoming
vladimir	wladimir
mònaco	monaco
estalvis	besparings
vie	vie
erik	erik
firma	handtekening
diversa	uiteenlopende
diversa	diverse
conversa	gesprek
somnis	drome
müller	müller
palmas	palmas
castilla	castilla
yusuf	yusuf
bari	barium
bari	bari
estratègies	strategieë
heidelberg	heidelberg
concedida	toegestaan
homo	homo
margarita	margarita
esprint	sprint
conducció	bestuur
conducció	driving
xocolata	sjokolade
rèptils	reptiele
edita	wysig
quintet	kwintet
bossa	sak
stark	stark
processador	verwerker
nan	nan
württemberg	württemberg
capitalisme	kapitalisme
delegats	afgevaardigdes
ambientals	environmental
springs	springs
hispano	hispano
yuan	yuan
barbus	barbus
begudes	drankies
begudes	drankies
challenge	challenge
challenge	uitdaging
cilindres	silinders
amants	liefhebbers
hàbit	gewoonte
afer	affair
derrotes	nederlae
argila	clay
tunis	tunis
gremi	guild
prades	prades
dallas	dallas
criminals	misdadigers
immediat	onmiddellike
patinatge	skating
dennis	dennis
reims	reims
etimologia	etimologie
rotterdam	rotterdam
panteó	pantheon
bàltic	baltiese
ronald	ronald
fórmules	formules
antàrtida	antarktika
intèrprets	kunstenaars
pioners	pioniers
fossa	fossa
eddie	eddie
sentits	sintuie
calent	hot
calent	warm
bateries	batterye
montgomery	montgomery
trencat	gebreekte
trencat	stukkend
trencat	gebroke
trencat	gebreek
aleix	alexios
coronada	gekroonde
comunisme	kommunisme
irene	irene
satisfer	bevredig
positius	positiewe
positius	positief
strauss	strauss
cerro	cerro
jacint	hyacinth
rècords	rekords
rècords	records
ecologia	ekologie
baltimore	baltimore
nantes	nantes
plomes	vere
sistemàtica	stelselmatig
tit	titus
brabant	brabant
combinacions	kombinasies
colin	colin
llemosí	limousin
estructurals	strukturele
lliura	weegskaal
lliura	libra
lliura	pond
lliura	pound
rita	rita
diocesà	diocesan
finalitats	doeleindes
finalitats	poog
romanen	remain
transformada	transformeer
wellington	wellington
frescos	vars
admetre	erken
bush	bush
defensiu	verdedigende
recompensa	beloning
romàntica	romantiese
romàntica	romanties
exactes	presiese
exactes	presies
fontaine	fontaine
balduí	baldwin
salsa	sous
nielsen	nielsen
mostrava	gewys
granit	granite
negro	negers
vinci	vinci
franca	franca
invertebrats	invertebrates
iris	iris
harrison	harrison
nicholas	nikolaas
nicholas	nicolaas
sastre	aanleer
retard	vertraging
pascal	pascal
salzburg	salzburg
brooklyn	brooklyn
superioritat	superioriteit
pipí	pepyn
repeteix	herhaal
repeteix	lus
eusebi	eusebius
valeri	valery
valeri	waleri
acceleració	versnelling
antíoc	antiochus
continents	kontinente
cohen	cohen
embarcacions	boats
embarcacions	bote
enciclopedia	enciclopedia
ravenna	ravenna
degà	dean
glasgow	glasgow
vancouver	vancouver
clube	clube
mixt	gemeng
mixt	gemengde
abel	abel
mod	mod
formals	formele
formals	formal
caracas	caracas
pelegrinatge	pilgrimage
convocatòria	oproep
convocatòria	bel
convocatòria	roep
convocatòria	skakel
bombai	bombay
bombai	mumbai
anglo	anglo
direccions	aanwysings
direccions	voorskrifte
cher	cher
escàndol	scandal
escàndol	skandaal
proveir	voorsien
proveir	verskaf
léon	léon
làmines	lakens
làmines	velle
concursos	kompetisies
ling	ling
blaus	blues
américa	américa
polinomi	polinoom
espases	swords
reg	besproeiing
regal	geskenk
seleccionat	gekose
seleccionat	gekies
seleccionat	gemerk
num	num
croat	kroatiese
diploma	diploma
metz	metz
ntupdate	ntupdate
wikidata	wikidata
matt	matt
tomé	tomé
abi	abi
sortides	uitgaan
supervisió	toesig
progressiu	progressiewe
bots	bots
bots	botte
bots	robotte
poderosos	powerful
poderosos	kragtige
deep	diep
botó	knoppie
plens	vol
plens	volle
ulster	ulster
calvo	bald
armand	armand
hampshire	hampshire
màntua	mantua
veterans	veterane
julián	julian
julián	julián
agut	treble
guàrdies	guards
guàrdies	wagte
bridge	brug
vuitena	eighth
dijous	donderdag
baby	baba
reyes	reyes
mercader	handelaar
nomenats	aangestelde
gala	gala
cabana	hut
cabana	kajuit
cabana	cabin
johns	johns
extensions	uitbreidings
darmstadt	darmstadt
integrats	geïntegreerde
pesos	gewigte
inquisició	inkwisisie
ref	ref
celler	kelder
celler	wynplaas
celler	kelder
constança	constance
ploma	pen
ploma	feather
angular	detailed
oman	oman
innovacions	innovasies
continuat	volgehoue
continuat	deurlopende
continuat	voortdurende
delle	delle
nits	nagte
donades	gegee
orador	orator
joão	joão
mani	mani
express	express
gov	gov
carnaval	carnival
carnaval	karnaval
yang	yang
desfer	herroep
cartells	plakkate
ametlla	amandel
resurrecció	resurrection
obaga	umbrië
domèstic	domestic
domèstic	huishoudelike
teclats	sleutelborde
mill	meul
mill	mill
mill	meule
llavor	saad
armstrong	armstrong
sky	lug
esborrany	konsep
esborrany	eraser
tesis	thesis
tor	tor
ordena	rangskik
ordena	sorteer
grams	gram
schneider	schneider
montfort	montfort
responsabilitats	verantwoordelikhede
plantacions	plantations
subdivisió	tak
meyer	meyer
facilita	fasiliteer
exercit	uitgeoefen
tracció	traction
incidents	insidente
segells	stamps
segells	seëls
valent	dapper
convençut	oortuig
nòmades	nomads
escalada	klim
studios	studios
farmàcies	apteke
eugène	eugène
banks	banke
pensant	denke
entorns	omgewings
mauritània	mauritanië
convocat	ontbied
discografia	diskografie
òptic	optiese
embaràs	swangerskap
alegria	vreugde
mineria	mining
mineria	myn
mineria	mynbou
mineria	mynwese
siena	siena
ain	ain
horts	orchards
cristóbal	cristóbal
guerrero	guerrero
cadascú	elk
judicis	probeerslae
alcaldes	burgemeesters
grove	grove
apollo	apollo
plànol	vliegtuig
patates	potatoes
caos	chaos
hunter	hunter
hunter	jagter
jefferson	jefferson
obligacions	verpligtinge
cecília	cecilia
polo	polo
yes	ja
trento	trient
français	français
floyd	floyd
seients	sitplekke
viquipedista	wikipedian
llimona	suurlemoen
tolerància	tolerance
phoenix	phoenix
diables	devils
born	gebore
amenaçat	gedreig
amenaçat	bedreig
definicions	definisies
funeral	funeral
funeral	begrafnis
felicitat	geluk
rares	skaars
jura	alb
bonn	bonn
plegat	vou
tallat	cut
pronunciació	uitspraak
estrets	straits
conill	haas
conill	rabbit
navegador	blaaier
tia	bokkie
tia	tannie
banco	banco
textura	tekstuur
ismail	ismail
émile	émile
trobant	bevinding
júlia	magda
júlia	julia
yves	yves
violació	verkragting
administratius	administratiewe
administratius	verrig
heavy	swaar
fantasma	spook
after	na
after	nadat
after	ná
protagonisme	prominensie
judaisme	judaïsme
cuir	leer
vegas	vegas
peticions	versoeke
exacte	presiese
exacte	presies
maximilià	maksimiliaan
senadors	senators
àlies	alias
àlies	skuilname
mites	mites
influents	invloedryke
cometa	komeet
iss	iss
detroit	detroit
santi	santi
perdó	forgiveness
cruïlla	junction
serguei	sergei
harvey	harvey
julian	julian
théâtre	théâtre
icona	ikoon
electró	elektron
disputada	betwis
combinada	gekombineer
combinada	combined
arkansas	arkansas
racional	rasionale
obligatori	verpligtend
autobús	bus
congost	gorge
fàrmacs	medisyne
fàrmacs	drugs
fàrmacs	dwelms
dimoni	duiwel
dimoni	demoon
dimoni	demon
brava	brava
criticar	kritiseer
philadelphia	philadelphia
creadors	skeppers
fòssil	fossiel
lucre	profit
lucre	winsgewende
académie	académie
sintaxi	sintaks
soto	soto
autèntica	eg
autèntica	aandag
terços	derdes
leningrad	leningrad
ombres	skaduwees
administrar	administreer
entusiasme	entoesiasme
físicament	fisies
terrible	verskriklike
terrible	terrible
atletes	atlete
emocions	emosies
pobladors	settlers
pib	bbp
hubert	hubert
veterinari	veearts
finalitza	eindig
finalitza	einde
finalitza	voltooi
gabon	gaboen
orella	oor
chan	chan
mason	mason
benín	benin
championship	championship
amagat	versteek
amagat	weggesteek
amagat	verberg
suaus	sagte
suaus	sag
rex	rex
vita	vita
teràpia	therapy
nòrdic	norse
nòrdic	nordic
stade	stade
yale	yale
boris	boris
bahadur	bahadur
bey	bey
boles	balle
hotels	hotelle
hotels	hotels
príncipe	príncipe
calàbria	calabria
société	société
ensenyaments	lesse
jordània	jordan
jordània	jordaan
introduïda	ingestel
organitzen	rangskik
organitzen	organiseer
bravo	bravo
creien	believed
prohibida	verbande
prohibida	verban
ballarina	ballerina
ballarina	dancer
ballarina	danser
dedicació	toewyding
automàtic	outomatiese
automàtic	outomaties
loire	loire
suggerit	voorgestelde
suggerit	aanbevole
suggerit	voorgestel
genoma	genome
evidentment	duidelik
evidentment	obviously
condemnar	veroordeel
hàbits	gewoontes
carcassona	carcassonne
volts	volts
neil	neil
tradueix	vertaal
magnífic	manjifiek
obstacles	hindernisse
platí	platinum
resideix	woonagtig
sonates	sonatas
trípoli	tripoli
lliçons	lesse
datació	dating
corral	corral
vincenzo	vincenzo
pells	skins
viatja	reise
domèstics	domestic
domèstics	huishoudelike
xeic	sheikh
terminals	terminale
dames	checkers
constituent	samestellende
australiana	aussie
hard	hard
hard	harde
hard	moeilik
mayer	mayer
danny	danny
gimnàstica	gimnastiek
granges	plase
rumors	gerugte
node	node
refereixen	verwys
elegant	elegant
elegant	elegante
aïllats	geïsoleerde
inversions	beleggings
madonna	madonna
heli	helium
caçador	hunter
caçador	jagter
educat	ingelig
perillós	gevaarlike
perillós	gevaarlik
llicències	lisensies
millorat	verhewe
millorat	verbeterde
pròxima	volgende
leon	leon
distintiu	kenteken
debats	besprekings
debats	debatte
ferrari	ferrari
cripta	kripte
keith	kees
keith	keith
repetició	herhaal
salvació	verlossing
oracle	orakel
confiar	trust
confiar	vertrou
restant	oorblywende
restant	oor
tinta	ink
hassan	hassan
plànols	plat
dot	punt
dot	dot
continuada	volgehoue
continuada	deurlopende
continuada	voortdurende
culpable	skuldig
numeració	nommering
aisne	aisne
mares	moeders
bilingüe	bilingual
greix	vet
greix	fat
jin	jin
escàs	scarce
saqueig	sack
anunciat	aangekondig
lloguer	huur
compensació	vergoeding
simbolitza	simboliseer
jeanne	jeanne
incertae	incertae
detectiu	speurder
mitgeres	dividing
trompeta	trompet
corint	korinthe
organitzador	organiseerder
comunicat	gerapporteer
rates	rotte
rates	rats
ruth	ruth
loir	loir
five	vyf
funcionalitat	funksionaliteit
roi	roi
enter	heelgetal
chopin	chopin
sean	sean
entreteniment	vermaak
eritrea	eritrea
genealogia	genealogie
ran	gehardloop
mateo	mateo
inscrits	geregistreer
llicenciatura	bachelor
mitridates	mithridates
umar	omar
treballador	worker
treballador	werker
treballador	arbeider
plaer	plesier
gene	gene
navegant	sailing
amnistia	amnestie
antilles	antille
hui	hui
monopoli	monopolie
monopoli	monopoly
jay	jay
zinc	sink
guies	gidse
perfecció	perfeksie
antònia	antonia
acosta	acosta
lituà	litause
bei	bei
indians	indians
indians	indiane
electric	elektriese
clade	klade
stefan	stefan
elefant	olifant
fuentes	fuentes
absent	absent
hostal	inn
hostal	herberg
powell	powell
zimbabwe	zimbabwe
fris	frieze
mitchell	mitchell
palla	strooi
intel	intel
mobiliari	meubels
mobiliari	meubelstuk
constructor	bouer
convenient	gerieflike
convenient	gerieflik
dean	dean
terry	terry
agricultors	boere
pub	pub
pub	kroeg
aprova	goedkeur
aprova	keur
mausoleu	mausoleum
berna	bern
myanmar	mianmar
discriminació	diskriminasie
despatx	kantoor
haydn	haydn
aude	aude
roche	roche
atur	werkloosheid
bous	bulle
bous	bulls
six	sesde
six	ses
esportista	atleet
esportista	jock
sediments	sediment
màgic	magiese
màgic	magical
neboda	niggie
docència	teaching
pràctic	praktiese
prioritat	prioriteit
proc	proc
romeu	romeo
junior	junior
consecutius	agtereenvolgende
randall	randall
demòcrates	demokrate
complicat	complicated
complicat	ingewikkeld
octavi	octavius
mayo	mayo
laboratoris	laboratoriums
laboratoris	laboratoriums
distribueix	versprei
libre	libre
connectat	verbind
donats	geskenk
donats	skenkings
jordà	jordan
jordà	jordaan
definides	gedefinieer
definides	omskryf
definides	gedefinieër
suïcidi	selfmoord
alger	algiers
boxa	boks
lleials	lojaal
lleials	loyal
lleials	lojale
sòria	soria
magnus	magnus
austin	austin
tramvia	tram
rajoles	sover
biològic	biologiese
anuncis	advertensies
belle	belle
rondes	rondtes
rondes	rond
kate	kate
edmund	edmund
coordinador	koördineerder
clarke	clarke
roosevelt	roosevelt
coeficient	koëffisiënt
clarinet	klarinet
lectures	readings
màlik	malik
tommy	tommy
convertida	omgeskakel
edwards	edwards
kenneth	kenneth
linda	linda
arle	arles
aureli	aurelius
llegit	lees
llegit	gelees
secà	droë
secà	dry
secà	droog
neutralitat	neutrality
chelsea	chelsea
che	che
peculiar	peculiar
sobreviscut	survived
alçària	hoogte
brooks	brooks
bremen	bremen
eco	ego
eco	echo
marea	gety
tempestes	storms
vulgar	vulgêr
antenes	antennas
cameron	cameron
seattle	seattle
nuremberg	neurenberg
justificar	regverdig
plebs	plebs
visconti	visconti
reed	riet
reed	reed
verbs	werkwoorde
tambor	drum
tambor	drom
diamant	diamond
diamant	diamant
banyes	horings
estrabó	strabo
mensual	maandelikse
mensual	maandeliks
collita	oes
preferència	voorkeur
cid	cid
domínguez	domínguez
exercicis	oefeninge
blois	blois
pantalles	skerms
armadura	armor
implementar	implement
implementar	implementeer
guardó	toekenning
sac	sac
sac	sack
trajecte	journey
inclús	selfs
walt	walt
malauradament	ongelukkig
rata	rat
rata	rot
cleveland	cleveland
parcials	biased
parcials	gedeeltelik
parcials	gedeeltelike
rogers	rogers
monja	nun
rumb	natuurlik
emocional	emosioneel
clergues	predikante
clergues	predikant
fai	fai
nomenclàtor	gazetteer
motocicleta	motorfiets
ferida	wonde
integritat	integriteit
novè	ninth
supermercat	supermark
rossi	rossi
stefano	stefano
annex	byvoegsel
policies	polisiemanne
estius	summers
esperits	geeste
esperits	spirits
empresaris	entrepreneurs
dna	dna
dna	dns
honorari	honorary
porcs	varke
jennifer	jennifer
tarn	tarn
euler	euler
monstre	monster
enrico	enrico
perry	perry
polzades	duime
polzades	duim
ríos	ríos
lotari	lothair
aziz	aziz
bonifaci	bonifatius
acompanyats	vergesel
edu	edu
desambiguació	dubbelsinnig
fletxes	pyle
inestabilitat	onstabiele
moisès	moses
matrius	matrikse
andrews	andrews
estadis	stadions
luca	luca
sallent	pireneë
representades	verteenwoordig
filharmònica	philharmoniker
distribuïda	verspreide
gérard	gérard
memoire	memoire
tirà	tiran
curiositat	nuuskierigheid
funcionals	funksioneel
funcionals	funksionele
epir	epirus
evacuació	ontruiming
preparats	herlaai
preparats	gereed
compacte	kompakte
compacte	kompak
definits	gedefinieer
definits	omskryf
definits	gedefinieër
terminologia	terminology
holmes	holmes
saviesa	wysheid
lleons	lions
instant	kits
hitchcock	hitchcock
dakar	dakar
cristòfor	christopher
cristòfor	christoffel
buida	leeg
buida	leë
buida	egipte
cineasta	filmmaker
brill	brill
corals	corals
simfonies	simfonieë
indicat	aangedui
barrancs	canyons
hongaresos	hongare
voluntari	volunteer
voluntari	vrywilliger
àliga	eagle
àliga	arend
wyoming	wyoming
pinyin	pinyin
balanç	saldo
balanç	balans
allan	allan
rubio	rubio
multiplicació	maal
pistola	pistool
pistola	gun
ares	ares
murphy	murphy
gustau	gustav
indicant	aanduiding
setmanal	daagliks
setmanal	weekliks
setmanal	weeklikse
forster	forster
ral	mene
poitiers	poitiers
ariel	ariel
conclusions	gevolgtrekkings
inaugural	inaugural
guadalupe	guadalupe
guadalupe	guadeloupe
cera	wax
abdul	abdul
catalan	katalaanse
singles	singles
renault	renault
esquelet	geraamte
esquelet	skelet
sidney	sidney
ted	ted
palatinat	palts
dinosaure	dinosaur
dinosaure	dinosourus
estela	stele
klaus	klaus
aïllades	geïsoleerde
anant	going
anant	gaan
gnu	gnu
adreces	adresse
xat	klets
xat	gesels
etiquetes	merkers
etiquetes	etiket
regals	geskenke
necròpolis	dodeakker
droga	dwelm
droga	drug
còdex	codex
finit	eindige
verbal	verbale
verbal	verbaal
càpsula	kapsule
pacífica	vreedsame
pacífica	rustige
pacífica	vreedsaam
sands	sands
virtuts	deugde
acompanyant	companion
filippo	filippo
simbòlic	simboliese
simbòlic	simbolies
emmanuel	emmanuel
recipient	houer
blake	blake
cables	kabels
enquesta	meningspeiling
enquesta	opname
hindú	hindu
legalment	legally
sínode	synod
pirata	pirate
pirata	seerower
operadors	operateurs
operadors	draers
birmingham	birmingham
cometre	redigeer
gustavo	gustavo
uss	uss
mao	mao
manipulació	manipulasie
equipat	toegerus
mann	mann
activació	aktivering
batman	batman
abbas	abbas
absolutament	absoluut
carol	carol
mhz	mhz
cosme	cosme
historiografia	historiography
luc	luc
llosa	slab
llosa	llosa
regadiu	besproeiing
inventat	uitgevind
guineu	jakkals
guineu	fox
wta	wta
adolescents	tieners
colón	colón
pertinença	lidmaatskap
entrenar	spar
ernesto	ernesto
bautista	bautista
mínims	minimum
mínims	minimale
tecla	sleutel
tecla	key
disponibilitat	beskikbaarheid
exclusiu	eksklusiewe
owen	owen
panells	panele
cendres	ashes
honoris	honoris
divorci	egskeidings
divorci	egskeiding
fars	fars
instàncies	gevalle
instàncies	instansies
votat	gestem
ànec	eend
ànec	duck
bertrand	bertrand
michele	michele
contribueix	contributes
ibèria	iberië
zàmbia	zambië
zàmbia	zambia
transferit	oorgedra
reflectir	herhaal
reflectir	reflekteer
reorganitzar	herorganiseer
cresta	crest
auckland	auckland
clinton	clinton
toc	por
togo	togo
geomètrica	geometriese
potencials	potensiaal
sufix	agtervoegsel
editorials	uitgewers
respiració	asemhaling
esa	esa
tortugues	skilpaaie
villers	villers
gest	gebaar
vàlida	geldig
vàlida	geldige
vàlida	soektog
kazan	kazan
bartolomé	bartolomé
bartolomé	bartholomew
her	haar
ictiologia	igtiologie
magnesi	magnesium
bruixes	witches
cascada	waterval
baríton	bariton
munició	ammunisie
tokyo	tokyo
tokyo	tokio
delgado	delgado
vermont	vermont
signa	teken
signa	onderteken
ein	ein
terrorisme	terrorisme
christophe	christophe
escasses	scarce
reformada	gereformeerde
reformada	hervormde
flickr	flickr
false	vals
canònica	kanonieke
glacera	gletser
seriosament	erg
craig	craig
fonament	fondament
dominique	dominique
txad	chad
flames	vlamme
flames	flames
cava	grou
cava	cava
dem	dem
gay	homoseksuele
gay	gay
corb	crow
corb	raaf
corb	raven
ratlles	strepe
aeronaus	vliegtuie
aeronaus	vliegtuig
boeing	boeing
periòdics	koerante
tèxtils	tekstiele
computació	uitwerk
brossa	gemorspos
alberta	alberta
aranyes	spiders
bala	koeël
bala	bullet
exposats	blootgestel
exposats	kaak
puresa	reinheid
papallona	skoenlapper
perspectives	perspektiewe
controls	kontrole
controls	kontroles
laguna	laguna
aula	klaskamer
aula	aula
confirmació	bevestiging
baixada	descent
dom	dom
àlex	alex
tasmània	tasmanië
berbers	berbers
frédéric	frédéric
adoració	aanbidding
centrale	centrale
geni	genie
geni	genius
doi	doi
serps	snakes
libèria	liberië
basili	basil
coreà	korean
coreà	koreaanse
contribuït	bygedra
retòrica	retoriek
llibreries	boekwinkels
neptú	neptune
imitació	imitation
foscor	donkerte
flexible	soepel
flexible	buigbare
dosi	dose
degli	degli
enregistrat	opgeneem
coordinadora	koördineerder
protocols	protokolle
samoa	samoa
troballa	bevinding
gradual	gradual
tigre	tier
tigre	tiger
tuberculosi	tuberkulose
factura	faktuur
marquesa	markiesin
sullivan	sullivan
andrei	andrei
luís	luis
norte	norte
axelrod	axelrod
mecànics	mechanical
mecànics	meganiese
paràgraf	paragraaf
simón	simon
simón	simón
mètrica	metriek
escassos	scarce
elector	keurvors
cartografia	kartografie
tocava	gespeel
iec	iec
baltasar	baltasar
pearl	pearl
roubaix	roubaix
olga	olga
ramsès	ramses
lògic	logies
lògic	logiese
convencions	gebruike
peloponès	peloponnese
budista	boeddhistiese
documenta	documenta
autobiografia	outobiografie
lliurat	afgelewer
lola	lola
sensors	sensors
roll	rol
joel	joel
certamen	wedstryd
certamen	kompetisie
vasco	vasco
mahoma	mohammed
víkings	vikings
perduts	verlore
perduts	verloor
košice	košice
celeste	celeste
simone	simone
verí	poison
duet	duet
emília	emilia
regina	regina
auditori	ouditorium
bis	bis
exportacions	uitvoer
reflecteixen	herhaal
reflecteixen	reflekteer
decimal	desimale
decimal	desimaal
palazzo	palazzo
consumidors	verbruikers
arrodonida	gerond
liber	liber
surinam	suriname
impressionant	fantasties
impressionant	ongelooflike
impressionant	wonderlik
falcó	falcon
canterbury	canterbury
impulsat	gedryf
gaulle	gaulle
nebulosa	newel
lancaster	lancaster
robar	steel
robar	steel
robar	diefstal
papir	papirus
presentador	aanbieder
vàlid	geldig
vàlid	geldige
vàlid	soektog
manila	manila
eventualment	eventually
estranya	vreemd
agrupacions	groeperings
laborals	arbeid
laborals	labour
recomanació	aanbeveling
mercury	mercury
mercury	kwik
escriptures	scriptures
sulfat	sulfate
sacrificis	opofferings
spencer	spencer
miracles	miracles
gilles	gilles
reaccionar	reageer
visions	visioene
visions	visions
brigades	brigades
joachim	joachim
butxaca	pocket
butxaca	broeksak
arpa	harp
ètnica	etniese
ètnica	etnies
thor	thor
diaca	deacon
berry	bessie
berry	berry
arias	arias
feixisme	fascisme
sot	sot
humanitats	geesteswetenskappe
maxwell	maxwell
desconeguts	vreemdelinge
bonaventura	bonaventura
villeneuve	villeneuve
explicacions	verduidelikings
serena	serena
pinta	verf
domicili	tuis
domicili	huistoe
domicili	tuisblad
domicili	huis
altures	hoogtes
altures	heights
argos	argos
borges	borges
nad	nad
alcorà	koran
girls	meisies
girls	mishandel
excessiva	buitensporig
desplegament	ontplooiing
bayern	bayern
desitjos	wense
desitjos	begeer
extremitats	ledemate
imprescindible	noodsaaklike
imprescindible	essential
jubilació	aftrede
abús	misbruik
verde	verde
decoracions	versierings
flama	vlam
darrerament	deesdae
bogotà	bogotá
parèntesis	hakkies
parèntesis	hakies
promès	verloof
promès	betrokke
tower	tower
tower	toring
portland	portland
exponent	eksponent
sospita	suspicion
afegits	bygevoeg
eugènia	eugenia
rennes	rennes
matrimonis	huwelike
eaux	eaux
gregory	gregory
gregory	gregorius
qin	qin
penetració	penetrasie
favorit	gunsteling
sint	sint
westminster	westminster
lorca	lorca
sex	seks
sex	geslag
sex	sex
aeris	aerial
bioquímica	biochemie
unix	unix
sostenible	volhoubare
hidalgo	hidalgo
anníbal	hannibal
cimera	summit
ambaixadors	ambassadeurs
après	learned
après	geleer
mediació	bemiddeling
certificat	sertifikaat
elefants	elephants
annie	annie
cola	glue
cola	cola
estrès	stres
estrès	stress
edo	edo
aguirre	aguirre
gènesi	genesis
cérvol	takbokke
cérvol	takbok
pensió	pensioen
zoo	dieretuin
zoo	zoo
nur	nur
greco	greco
cirurgià	chirurg
supermercats	supermarkte
avec	avec
duel	duel
noche	noche
gana	honger
asiàtics	asiese
asiàtics	asiatiese
erich	erich
calze	goblet
lagos	lagos
caroline	caroline
reconeixen	herken
cruel	cruel
cruel	wreed
asil	asylum
marín	marin
eugenio	eugenio
vinculació	skakel
especificacions	spesifikasies
hiverns	winters
moria	moria
odi	haat
sensor	sensor
pereira	pereira
beisbol	bofbal
refracció	ligbreking
hèlsinki	helsinki
sànscrit	sanskrit
idaho	idaho
messina	messina
paxton	paxton
rellotges	horlosies
sòcol	sok
sòcol	socket
cum	cum
mòdena	modena
günther	günther
dinar	middagete
convents	kloosters
malcolm	malcolm
ellen	ellen
sopa	sop
bressol	wieg
bressol	cradle
cilícia	cilicia
fuente	fuente
relativitat	relatiwiteit
velasco	velasco
primetime	primetime
foster	foster
siècle	siècle
bianchi	bianchi
rebuts	kwitansies
mansió	mansion
dominic	dominic
abdomen	abdomen
bolívar	bolivar
caseta	booth
chapman	chapman
orlando	orlando
curtis	curtis
kuwait	kuwait
intervals	reekse
intervals	intervalle
pregària	gebed
violent	geweldadig
violent	geweldadige
violent	violent
violent	gewelddadig
dunlop	dunlop
rebutja	verwerp
boulogne	boulogne
estimacions	skattings
estimacions	beramings
maps	kaarte
escassetat	tekort
elba	elba
rubén	rubén
telèfons	fone
orina	urine
aficionat	amateur
llunyà	verre
ceuta	ceuta
reformat	opgeknap
reformat	gereformeerde
reformat	hervormde
rick	rick
reprodueix	toneelstuk
reprodueix	speel
oci	ontspanning
jose	jose
patricia	patricia
uniformes	uniforms
polinèsia	polinesië
còlera	cholera
encàrrecs	orders
encàrrecs	bestellings
mohs	mohs
alexandra	alexandra
simbolisme	symbolism
explícitament	uitdruklik
explícitament	pertinent
int	int
bureau	bureau
pagaments	betalings
romano	romano
cellers	wynkelders
midi	midi
comercialització	bemarking
negociació	onderhandeling
luz	luz
pecat	sonde
granotes	paddas
imprès	printed
espatlla	skouer
filosòfic	philosophical
rss	rss
flash	flits
flash	flash
hay	hay
hay	hooi
ozó	osoon
giulio	giulio
sensibles	sensitief
valverde	valverde
recomanacions	aanbevelings
osaka	osaka
emirats	emirates
estómac	maag
búlgars	bulgare
invisible	onsigbaar
invisible	onsigbare
robatori	diefstal
robatori	rooftog
formigues	miere
hell	hell
vice	vice
oda	oda
oda	ode
sima	sima
vincle	bind
lucy	lucy
distribuïdes	verspreide
vintena	twentieth
ars	ars
paviment	pavement
goes	goes
coa	coa
votants	stemmers
votants	kiesers
hombre	hombre
confessions	confessions
inflació	inflasie
phillips	phillips
hip	hip
fonda	fonda
vàlvula	valve
alineació	besetting
alineació	belyning
sioux	sioux
indicador	aanwyser
indicador	aanduier
zhu	zhu
normalització	standardisering
segimon	sigismund
nina	nina
nina	doll
assignació	toewysing
alpina	alpina
naturelle	naturelle
dmitri	dmitri
dmitri	dmitri
mamífer	soogdier
esportistes	atlete
provocada	veroorsaak
sacra	sacra
dòlar	dollar
visibilitat	sigbaarheid
visibilitat	toeganklikheid
humil	nederig
avis	grootouers
avis	avis
