kilòmetres	miles
kilòmetres	kilometers
artístics	artistic
secrets	secrets
doctoral	doctoral
sots	potholes
marges	margins
steven	steven
pesta	plague
coincidint	coinciding
playstation	playstation
excés	excess
four	four
guanyadors	winners
fifa	fifa
literàries	literary
drogues	drugs
triangular	triangular
wright	wright
tanc	tank
deute	debt
percepció	perception
moll	dock
moll	pier
silenci	silence
fuster	carpenter
fletxa	arrow
gibraltar	gibraltar
intens	intense
soiuz	soyuz
dubtes	doubts
telèfon	phone
telèfon	telephone
unificació	unification
bad	bad
miranda	miranda
datat	dated
esperanto	esperanto
gravació	recording
erc	erc
anime	anime
diagnòstic	diagnosis
infantesa	childhood
decorat	decorated
tim	tim
restants	remaining
nas	nose
úniques	unique
gijón	gijón
armats	armed
canceller	chancellor
observat	observed
expert	expert
perduda	lost
emperadors	emperors
canta	sings
andy	andy
regnar	reigned
boys	boys
ventura	ventura
distingeix	distinguishes
borja	borja
mancomunitat	commonwealth
fortificacions	fortifications
diòxid	dioxide
diana	diana
heretar	inherit
burgesia	bourgeoisie
dresden	dresden
tetra	tetra
manxa	bellows
augusta	augusta
barana	railing
socialisme	socialism
corporació	corporation
cervesa	beer
churchill	churchill
fugida	escape
eslovènia	slovenia
alto	alto
breument	briefly
gaspar	gaspar
finalista	finalist
tragèdia	tragedy
serp	snake
casino	casino
paula	paula
riga	riga
morera	morera
albània	albania
fortificació	fortification
fals	false
fals	fake
chapelle	chapelle
semi	semi
constantment	constantly
casanova	casanova
fracció	fraction
filmfare	filmfare
miami	miami
modificat	modified
investigador	researcher
ocasionalment	occasionally
rescat	rescue
crims	crimes
restriccions	restrictions
restriccions	constraints
tours	tours
guadalajara	guadalajara
teclat	keyboard
alfredo	alfredo
ses	ses
mus	mus
sensibilitat	sensitivity
kentucky	kentucky
abundància	abundance
sergio	sergio
inspirar	inspire
atacat	attacked
considerant	considering
tràfic	traffic
tràfic	trafficking
clínica	clinic
cervantes	cervantes
ian	ian
bus	bus
fabricants	manufacturers
walker	walker
sar	sar
calç	lime
julia	julia
clergat	clergy
office	office
fisiologia	physiology
llacuna	lagoon
crani	skull
inspector	inspector
senzills	singles
consultar	consult
xoc	shock
influït	influenced
proclamació	proclamation
teodor	theodore
fèlix	felix
parr	parr
menezes	menezes
vertebrats	vertebrates
càstig	punishment
forçar	forcing
linux	linux
precedent	precedent
discorre	runs
elit	elite
magatzem	warehouse
targeta	card
cultius	crops
superficial	shallow
acceptada	accepted
ira	ira
romanticisme	romanticism
coincideix	matches
subjectes	subject
conspiració	conspiracy
profeta	prophet
fibres	fibers
arn	rna
zaragoza	zaragoza
rioja	rioja
fluid	fluid
legend	legend
cessió	assignment
componen	compose
emma	emma
ultramar	overseas
ferrocarrils	railways
privats	private
ingrés	income
envia	send
neutral	neutral
adopció	adoption
pasta	pasta
carreres	careers
biscaia	biscay
comunica	communicates
corall	coral
explorador	scout
explorador	explorer
nominal	nominal
promogut	promoted
mural	mural
louvre	louvre
converses	conversations
successors	successors
mola	mola
plató	plato
representats	represented
tensions	tensions
plataformes	platforms
identifica	identifies
quàntica	quantum
earth	earth
àlgebra	algebra
carter	carter
enterrament	burial
rodrigo	rodrigo
michigan	michigan
kazakhstan	kazakhstan
esquerres	leftist
designa	designates
vèrtex	vertex
girar	rotate
miss	miss
diagonal	diagonal
degradació	degradation
afectats	affected
desenvolupant	developing
tendeix	tends
cantata	cantata
emergència	emergency
núria	nuria
núria	núria
aplicada	applied
sarah	sarah
canya	cane
misteri	mystery
notablement	greatly
bertran	bertran
campbell	campbell
wolf	wolf
aïllament	isolation
faune	faun
reforços	reinforcements
estudiat	studied
xah	shah
pur	pure
marcador	scoreboard
clot	clot
bissau	bissau
herois	heroes
partícula	particle
miracle	miracle
guix	plaster
nerviós	nervous
segment	segment
violoncel	cello
premier	premier
febre	fever
caracteritzen	characterize
abasta	covers
treva	truce
tortuga	turtle
irregulars	irregular
pan	pan
comissions	commissions
comissions	committees
rebutjat	declined
rebutjat	rejected
virginia	virginia
fils	threads
benito	benito
gaèlic	gaelic
confirmat	confirmed
centrat	centred
balls	dances
danses	dances
kosmos	kosmos
txecoslovàquia	czechoslovakia
prefecte	prefect
troballes	findings
mississipí	mississippi
conjunta	joint
rodó	rolled
farina	flour
larves	larvae
nicaragua	nicaragua
limitar	limiting
atracció	attraction
detecció	detection
salomó	solomon
subministrament	supply
presentada	submitted
vladímir	vladimir
borneo	borneo
nus	knot
inclinació	tilt
inclinació	inclination
consagració	consecration
formigó	concrete
verdaguer	verdaguer
fem	fem
cirurgia	surgery
semblança	resemblance
semblança	likeness
enderrocar	overthrow
espectador	spectator
lenin	lenin
fibra	fiber
aficionats	amateurs
bordeus	bordeaux
ètica	ethics
geogràfic	geographic
mou	move
àrtic	arctic
agafa	grab
mirall	mirror
güell	güell
essencials	essential
vacances	vacation
vacances	holidays
precedents	precedent
estratègica	strategic
interval	range
interval	interval
brandenburg	brandenburg
vitamina	vitamin
amenaces	threats
ideals	ideals
ideals	ideal
preocupació	concern
rendició	surrender
alcalá	alcalá
nomenclatura	nomenclature
humida	wet
lambert	lambert
reich	reich
arxiduc	archduke
cannes	cannes
recepció	reception
punk	punk
vestigis	vestiges
aristòtil	aristotle
glucosa	glucose
parlava	spoke
llombardia	lombardy
òxid	oxide
esculls	reefs
entertainment	entertainment
transports	transport
ocean	ocean
tons	tones
aterratge	landing
provocat	provoked
inclusió	inclusion
auto	auto
cabra	goat
pressions	pressures
percussió	percussion
polonesos	poles
badajoz	badajoz
oise	oise
gosse	gosse
celta	celtic
preparat	ready
empleats	employees
supressió	deletion
supressió	removal
entén	understands
birmània	myanmar
declara	declares
benestar	wellness
benestar	welfare
serbi	serbian
eficàcia	efficacy
eficàcia	effectiveness
oració	prayer
administrativament	administratively
raf	raf
vores	edges
vores	border
perímetre	perimeter
plini	pliny
acadèmica	academic
fruites	fruits
mirant	watching
domenico	domenico
álvaro	álvaro
giorgio	giorgio
tria	choose
tèrmica	thermal
lachner	lachner
aiguamolls	wetlands
narració	storytelling
narració	narrative
babilònia	babylon
matemàtics	mathematicians
progressista	progressive
adjunt	attachment
adjunt	deputy
distingit	distinguished
subministraments	supplies
públicament	publicly
nick	nick
terol	teruel
patit	suffered
pescadors	fishermen
submarins	submarines
associades	associated
romero	romero
pelatge	fur
paixà	pasha
angelo	angelo
liverpool	liverpool
ritual	ritual
bernardo	bernardo
varien	vary
inventor	inventor
demetri	demetrius
esborrat	deleted
nominada	nominated
centrecampista	midfielder
màgia	magic
autorització	authorisation
autorització	authorization
gold	gold
políticament	politically
cape	cape
xàtiva	xàtiva
prohibit	forbidden
prohibit	prohibited
motociclisme	motorcycling
pateix	suffers
alternatives	alternatives
excepcional	exceptional
seleccions	selections
cims	peaks
comes	commas
agustín	agustín
bielorússia	belarus
freqüències	frequencies
coronació	coronation
maquinària	machinery
roine	rhône
causat	caused
rahman	rahman
stuart	stuart
gràfiques	charts
gary	gary
jimmy	jimmy
compositae	compositae
donacions	donations
nana	nana
sebastian	sebastian
emblema	emblem
diable	devil
papua	papua
public	public
min	min
pessetes	pesetas
herbes	herbs
habitat	inhabited
íntegrament	entirely
batxillerat	baccalaureate
conveni	convention
cicles	cycles
llana	wool
madison	madison
presidencial	presidential
luxe	luxury
interessat	interested
gandia	gandia
potter	potter
oxidació	oxidation
filtre	filter
wild	wild
nominat	nominated
presidencials	presidential
introdueix	enter
alvèrnia	auvergne
assumpció	assumption
intervencions	interventions
cooperativa	cooperative
insecta	insecta
crèdit	credit
étienne	étienne
lluitant	struggling
lluitant	fighting
française	française
maons	bricks
assoleix	reaches
urani	uranium
derivades	derivatives
barry	barry
vinyes	vineyards
àguila	eagle
nassau	nassau
llums	lights
disposat	willing
massacre	massacre
lliurament	delivery
stewart	stewart
llotja	auction
efectivament	indeed
place	place
vázquez	vasquez
vázquez	vázquez
funda	holster
sever	severus
existien	existed
automàtica	auto
automàtica	automatic
moçambic	mozambique
descobriments	discoveries
jurídic	legal
ampliat	extended
ampliat	expanded
absorció	absorption
embassament	reservoir
augmentant	increasing
instància	instance
artur	artur
château	château
núvol	cloud
pèls	hairs
sacrifici	sacrifice
hèrcules	hercules
atleta	athlete
sanitat	health
capturats	captured
lloret	lloret
leone	leone
official	official
marcus	marcus
beca	scholarship
alimenta	feeds
avantpassats	ancestors
bonaparte	bonaparte
dimissió	resignation
cames	legs
jon	jon
hereus	heirs
enregistraments	recordings
euro	euro
armenis	armenians
muntar	mounting
vins	wines
mirada	glance
prince	prince
holstein	holstein
catolicisme	catholicism
afecten	affect
iniciatives	initiatives
fila	row
connexions	connections
dignitat	dignity
flores	flores
cartell	poster
fetge	liver
marx	marx
ciu	ciu
jerarquia	hierarchy
leonard	leonard
collins	collins
oratori	oratory
pòrtic	portico
urbanisme	urbanism
escrivint	writing
danubi	danube
aplicat	applied
amadeu	amadeu
paquets	packages
caixes	boxes
lentament	slowly
thys	thys
suplement	supplement
accessible	accessible
salons	halls
filadèlfia	philadelphia
especialistes	specialists
hardy	hardy
hudson	hudson
combinar	combine
amir	amir
infraestructura	infrastructure
olor	scent
olor	odor
olor	smell
watson	watson
substrat	substrate
prix	prix
banys	bathrooms
banys	baths
holandès	dutch
estrenat	released
ibèric	iberian
harris	harris
mortal	deadly
mortal	mortal
servit	served
insígnia	insignia
elionor	eleanor
anàlisis	insights
gal	gal
chen	chen
trans	trans
anunci	announcement
exposat	exposed
compressió	compression
dilluns	monday
editada	edited
examen	exam
rudolf	rudolf
mèdici	medici
nicolás	nicolás
viscut	lived
cama	leg
paquet	package
sergi	sergi
transforma	transform
transforma	transforms
morfologia	morphology
bru	bru
èmfasi	emphasis
tierra	tierra
dispersió	dispersion
autopista	highway
rebuda	received
bonet	bonet
huracà	hurricane
margaret	margaret
desastre	disaster
protector	protector
estructural	structural
defensiva	defensive
entrat	entered
conscient	conscious
capitals	capitals
sensible	sensitive
criminal	criminal
warner	warner
humits	moist
bank	bank
essència	essence
franges	slots
vectors	vectors
bit	bit
gustav	gustav
decorats	decorated
fans	fans
domina	dominates
julien	julien
josef	josef
bas	bas
esclau	slave
tebes	thebes
hms	hms
ajudat	helped
setena	seventh
maduresa	maturity
schmidt	schmidt
condemna	condemnation
condemna	condemns
reuneix	gathers
adjacents	adjacent
construeix	construct
anatòlia	anatolia
bany	bathroom
estimació	estimate
estimació	estimation
barba	beard
exportació	export
exportació	exporting
suports	props
notre	notre
atribuït	attributed
anatomia	anatomy
codificació	coding
codificació	encoding
francesca	francesca
jurament	oath
venjança	vengeance
venjança	revenge
informacions	informations
mercenaris	mercenaries
alep	aleppo
medicaments	medicines
habitacions	rooms
tija	stem
exclusiva	exclusive
integrant	integrating
contractat	hired
subclassis	subclassis
sumatra	sumatra
scala	scala
passatge	passage
veïnat	neighbourhood
recuperat	recovered
registrat	registered
relatiu	relative
next	next
proporcional	proportional
gastronomia	gastronomy
pisa	pisa
dependent	dependent
presbiteri	presbytery
esperant	waiting
concentrar	concentrate
gonzalo	gonzalo
característics	characteristic
incendis	fires
pretor	praetor
sony	sony
kurt	kurt
raval	raval
ibm	ibm
suggerir	suggest
sou	salary
focs	fireworks
dividits	divided
preservació	preservation
thompson	thompson
oportunitats	opportunities
cook	cook
eugeni	eugene
assistents	attendees
assistents	assistants
targetes	cards
latitud	latitude
motocròs	motocross
concentracions	concentrations
caçadors	hunters
catherine	catherine
uganda	uganda
reglament	regulation
residir	reside
beguda	beverage
beguda	drink
bicicleta	bicycle
duració	duration
consolidació	consolidation
neolític	neolithic
determinació	determination
elevades	elevated
pep	pep
combinat	combined
silvestre	silvestre
facció	faction
sultanat	sultanate
école	école
folre	lining
carlota	charlotte
estels	stars
khanat	khanate
negatius	negatives
esclavitud	slavery
paleolític	paleolithic
àtom	atom
segòvia	segovia
pastoral	pastoral
ortega	ortega
ramírez	ramirez
dinosaures	dinosaurs
immediata	immediate
envolten	surround
esquadra	squad
levi	levi
dead	dead
homònim	eponymous
guipúscoa	gipuzkoa
brut	brutus
lang	lang
clans	clans
porció	portion
tubs	tubes
amat	amat
penes	sorrows
celebracions	celebrations
accidents	accidents
entrant	starter
lloyd	lloyd
fix	fixed
domènech	domènech
privilegi	privilege
apòstols	apostles
càlculs	calculations
acompanyament	pad
acompanyament	accompaniment
montenegro	montenegro
descàrrega	download
realista	realistic
ras	ras
angel	angel
handbol	handball
mercedes	mercedes
bizanci	byzantium
hondures	honduras
malawi	malawi
primari	primary
mobilitat	mobility
crustacis	crustaceans
racó	corner
canet	canet
troia	troy
ascendir	ascend
erupció	eruption
gats	cats
homer	homer
clares	clares
perpendicular	perpendicular
costaneres	coastal
poderosa	powerful
futurs	futures
nissaga	bloodline
sàhara	sahara
promotor	promoter
tabac	tobacco
metropolitan	metropolitan
pics	bullets
pics	peaks
pronunciat	pronounced
fiable	reliable
montpeller	montpellier
assassí	killer
precipitacions	rainfall
eficiència	efficiency
sencera	whole
entesa	understanding
coberts	cutlery
stanford	stanford
info	info
virgili	virgili
virgili	virgil
classic	classic
cràter	crater
esquadró	squadron
suprema	supreme
antologia	anthology
franquícia	franchise
declaracions	statements
declaracions	assertions
mecànic	mechanic
mecànic	mechanical
explorar	explore
hereva	heiress
wei	wei
diferencial	differential
martell	martell
esplendor	splendor
baker	baker
turistes	tourists
calcària	limestone
revela	reveals
leiden	leiden
limitacions	limitations
annals	annals
consola	console
partició	partition
postura	posture
tribunals	courts
cortés	cortés
sagristia	sacristy
descomposició	decomposition
significativament	significantly
conreus	crops
respostes	responses
respostes	answers
respostes	replies
conservadors	conservatives
candidatures	nominations
biol	biol
mariners	sailors
suportar	endure
horari	schedule
annexió	annexation
kurdistan	kurdistan
devoció	devotion
kent	kent
remei	remedy
portals	portals
melodies	melodies
mixta	mixed
mosaic	tiled
mosaic	mosaic
proa	bow
auxiliars	auxiliary
desenes	tens
atacant	attacking
agnès	agnes
evans	evans
utrecht	utrecht
infeccions	infections
explotar	explode
lliurement	freely
olivier	olivier
genèric	generic
gendarmeria	gendarmerie
vocació	vocation
successives	successive
complement	plugin
cornellà	cornellà
estesa	laying
slam	slam
graham	graham
prosperitat	prosperity
tràcia	thrace
savi	wise
andes	andes
cantàbria	cantabria
gutiérrez	gutiérrez
gutiérrez	gutierrez
belgrad	belgrade
ingredients	ingredients
advocats	lawyers
acadèmics	academics
sorgit	emerged
mills	mills
elegits	elected
fuga	fugue
fuga	escape
rom	rom
rom	rum
miralles	miralles
louise	louise
hospitals	hospitals
obligació	obligation
esteban	esteban
trastorn	disorder
sara	sara
villanueva	villanueva
panzer	panzer
sarsuela	zarzuela
imam	imam
oslo	oslo
prevenció	prevention
mussolini	mussolini
bombarders	bombers
comparar	compare
vespre	evening
morales	morales
jeff	jeff
descans	break
descans	rest
actuant	acting
bryan	bryan
tallada	carved
radar	radar
sopar	dinner
sopar	supper
contingent	contingent
residencial	residential
johan	johan
caracteritzat	characterized
lisa	lisa
plasma	plasma
ratolí	mouse
folk	folk
basilea	basel
corbes	curves
correcció	correction
correcció	correctness
àvia	grandmother
cooper	cooper
internacionalment	internationally
guillermo	guillermo
mostrat	shown
mostrat	displayed
néta	granddaughter
folklore	folklore
gant	ghent
seine	seine
raïm	grapes
solo	solo
hot	hot
administracions	administrations
conqueridor	conqueror
enciclopèdic	encyclopedic
trossos	chunks
herman	herman
werner	werner
rituals	rituals
discursos	speeches
bust	bust
amfibis	amphibians
sts	sts
perseguir	pursue
detinguts	detainees
desenvolupats	developed
mikhaïl	mikhail
caledònia	caledonia
detenció	arrest
detenció	detention
entrevistes	interviews
audiovisual	audiovisual
subespècie	subspecies
sofre	sulfur
aïllada	isolated
manhattan	manhattan
hopkins	hopkins
haia	hague
melbourne	melbourne
sociologia	sociology
estratègic	strategic
teva	yours
jerry	jerry
namíbia	namibia
renfe	renfe
ramos	ramos
teòrica	theoretical
timbre	bell
acumulació	accumulation
magatzems	warehouses
mali	mali
banyoles	banyoles
weimar	weimar
pous	wells
taverna	tavern
husayn	husayn
montblanc	montblanc
true	true
connecticut	connecticut
impost	tax
aurora	aurora
deux	deux
terrat	rooftop
darwin	darwin
institucional	institutional
lugo	lugo
coets	rockets
romàntic	romantic
precipitació	precipitation
executiva	executive
eure	eure
matthew	matthew
acb	acb
preservar	preserve
preservar	preserving
intermedi	intermediate
beatriu	beatrice
polígon	polygon
corregir	correct
traspàs	transfer
traspàs	handover
compartit	shared
desapareguda	missing
butlletí	newsletter
butlletí	bulletin
hercegovina	herzegovina
groenlàndia	greenland
inca	inca
maquinari	hardware
oceania	oceania
studio	studio
nadiu	native
shadow	shadow
obtinguts	obtained
indo	indo
faccions	factions
aixeca	lifts
zoologia	zoology
efectius	troops
toro	toro
campanes	bells
extraordinària	extraordinary
basar	bazaar
vuitè	eighth
ron	ron
migració	migration
antropologia	anthropology
princeton	princeton
baptiste	baptiste
carro	cart
estatuts	statutes
contínuament	continually
assignat	assigned
solana	solana
solana	sunshine
precisa	accurate
turner	turner
palaus	palaces
erigir	erect
consistori	consistory
mesopotàmia	mesopotamia
pradesh	pradesh
tiges	stems
vestuari	wardrobe
vestuari	costumes
copeia	copeia
renúncia	resignation
caigut	fallen
disset	seventeen
controlada	controlled
circumferència	circle
circumferència	circumference
epidèmia	epidemic
prehistòria	prehistory
transversal	transverse
divulgació	disclosure
salvatges	savages
naturalista	naturalist
moderat	moderate
moderat	moderated
moros	moors
abolició	abolition
guillaume	guillaume
meca	mecca
tve	tve
visitant	visitor
visitant	visiting
dolç	sweet
derivar	derive
torrents	torrents
blanes	blanes
géry	géry
larry	larry
patent	patent
twitter	twitter
wayne	wayne
cerimònies	ceremonies
fictici	fictional
escates	scales
vocabulari	vocabulary
pila	pile
pila	stack
dick	dick
montseny	montseny
prior	prior
edimburg	edinburgh
narbona	narbonne
motocicletes	motorcycles
arsenal	arsenal
transformacions	transformations
desapareix	disappears
acusació	accusation
delictes	crimes
afirmació	affirmation
ortiz	ortiz
avenç	breakthrough
cia	cia
cia	cla
pink	pink
diocesi	diocesi
dave	dave
ventre	womb
hannover	hanover
submarí	submarine
llibertats	freedoms
servidors	servers
excepcions	exceptions
zwick	zwick
jamaica	jamaica
letó	latvian
evolucionar	evolve
generat	generated
sals	salts
ken	ken
observador	observer
tiberi	tiberius
fotogràfica	photographic
controlat	controlled
almeria	almería
almeria	almeria
quintana	quintana
valoració	valuation
dany	dany
interaccions	interactions
pesant	heavy
atlanta	atlanta
substitueix	replace
recomana	recommend
recomana	recommends
houston	houston
singapur	singapore
deure	duty
assíria	assyria
aprenent	apprentice
rubí	ruby
northern	northern
sul	sul
fritz	fritz
cantatas	cantatas
marxista	marxist
edgar	edgar
fallida	bankruptcy
pietat	mercy
phil	phil
andreas	andreas
somme	somme
joies	jewels
antecedents	background
ryan	ryan
versalles	versailles
murals	murals
pica	pike
qualificació	rating
búlgar	bulgarian
borrell	borrell
deutsche	deutsche
albacete	albacete
repúbliques	republics
susan	susan
convidats	guests
bàrbara	barbara
infern	hell
infern	inferno
revolucionaris	revolutionaries
lost	lost
mini	mini
operar	operate
consonants	consonants
filòsofs	philosophers
rosario	rosario
buits	gaps
salvat	saved
carbonell	carbonell
permanents	permanent
modest	modest
segments	segments
mansur	mansur
nikolai	nikolai
nikolai	nikolay
marcos	marcos
gestionar	manage
amplitud	amplitude
inter	inter
especialitzats	specialized
geologia	geology
avaluar	evaluate
maragall	maragall
banca	banca
banca	bench
llars	households
gall	rooster
desnivell	slope
aristocràcia	aristocracy
piscina	pool
atles	atlas
imdb	imdb
allegro	allegro
clars	clear
acusats	defendants
artesans	craftsmen
suplent	alternate
gehrels	gehrels
participacions	shares
vescomtat	viscounty
marató	marathon
ànimes	souls
cec	blind
secretària	secretary
feliç	happy
exiliats	exiles
distribuïts	distributed
dalí	dalí
localitzar	locate
marino	marino
madame	madame
emigració	emigration
multimèdia	multimedia
creades	created
fosfat	phosphate
ipa	ipa
enclavament	enclave
ferrara	ferrara
mag	magician
mag	mag
act	act
autobusos	buses
ovelles	sheep
confirma	confirm
mariner	sailor
adjacent	adjacent
matilde	matilde
matilde	matilda
gloria	gloria
logotip	logo
infinit	infinite
infinit	infinity
jason	jason
guerrer	warrior
purament	purely
römer	römer
revestiment	coating
pineda	pineda
comandants	commanders
perfecta	perfect
charlotte	charlotte
actualització	update
rectes	straight
cromosoma	chromosome
diccionaris	dictionaries
predominant	predominant
coca	coke
coca	coca
inundacions	flooding
sanz	sanz
salts	diving
salts	jumps
groeneveld	groeneveld
gregorio	gregorio
zur	zur
milícia	militia
helen	helen
sergent	sergeant
narrador	narrator
ambulància	ambulance
peña	peña
excavació	excavation
barons	barons
legions	legions
kosovo	kosovo
emès	issued
gots	goths
vaca	cow
econòmicament	economically
sebastián	sebastian
ciment	cement
cadira	chair
transbordador	ferry
làser	laser
claudio	claudio
apòstol	apostle
coloració	colouring
progressiva	progressive
quaderns	notebooks
evita	evita
adhesió	membership
fum	smoke
niu	nest
niu	niu
equivalents	equivalents
consolat	consulate
neoclàssic	neoclassical
masters	masters
wallace	wallace
amos	amos
amos	masters
pretendent	suitor
peó	pawn
comissionat	commissioner
infraphylum	infraphylum
dotzena	twelfth
significatius	significant
mon	mon
vendrell	vendrell
erosió	erosion
verona	verona
sabor	flavor
sabor	flavour
civilitzacions	civilizations
hugh	hugh
lara	lara
butaca	armchair
simpson	simpson
implementació	implementation
guido	guido
robinson	robinson
cabells	hair
bemoll	flat
arturo	arturo
divuit	eighteen
acabats	finishes
bobby	bobby
consonant	consonant
revelació	revelation
estrasburg	strasbourg
hort	orchard
inventar	invent
raúl	raúl
horda	horde
ibáñez	ibáñez
complutense	complutense
ajuntaments	municipalities
adolfo	adolfo
gneu	gnaeus
occitània	occitania
budisme	buddhism
cretaci	cretaceous
volant	flying
sostingut	sharp
sostingut	sustained
bakr	bakr
oceans	oceans
consorci	consortium
otan	nato
denominacions	designations
denominacions	denominations
strunz	strunz
honda	honda
pastures	pasture
pastures	pastures
empat	tie
desena	tenth
aguda	acute
compatible	compatible
pastors	shepherds
telecomunicacions	telecommunications
precursor	precursor
morris	morris
side	side
consentiment	consent
pàdua	padua
charente	charente
paradís	paradise
caserna	barracks
presentant	presenting
múltiple	multiple
laos	laos
kara	kara
respectius	respective
llegendari	legendary
fires	fairs
adaptada	adapted
cristall	crystal
duo	duo
musa	musa
musa	muse
transparent	transparent
olimpíada	olympiad
martiri	martyrdom
acusacions	accusations
auguste	auguste
potassi	potassium
espiral	spiral
feminista	feminist
einstein	einstein
bitllets	tickets
companya	companion
escolta	listen
warren	warren
forçat	forced
quars	quartz
quentin	quentin
garantia	warranty
garantia	guarantee
eficient	efficient
trilogia	trilogy
tonalitat	hue
destacable	remarkable
electrodomèstics	appliances
consecutives	consecutive
gironès	platja
forjat	forged
forjat	forging
palerm	palermo
mòduls	modules
sorprenent	surprising
arrebossat	batter
formentera	formentera
combatents	combatants
pedrera	quarry
remodelació	remodeling
nenes	girls
xbox	xbox
gaudeix	enjoy
correus	emails
llenç	canvas
operatius	operational
atòmica	atomic
exiliat	exiled
compliment	compliance
vladimir	vladimir
adolescent	teenager
mònaco	monaco
estalvis	savings
vie	vie
erik	erik
firma	signature
diversa	diverse
balcans	balkans
conversa	conversation
somnis	dreams
müller	müller
palmas	palmas
castilla	castilla
yusuf	yusuf
bari	barium
bari	bari
besalú	besalú
estratègies	strategies
heidelberg	heidelberg
concedida	granted
adaptacions	adaptations
homo	homo
margarita	margarita
minories	minorities
esprint	sprint
visigots	visigoths
conducció	driving
xocolata	chocolate
disposicions	provisions
rèptils	reptiles
acompanya	accompanies
edita	edit
decoratius	decorative
torreta	turret
noció	notion
vacant	vacancy
vacant	vacant
quintet	quintet
descripcions	descriptions
disminueix	decreases
bossa	bag
stark	stark
processador	processor
nan	nan
württemberg	württemberg
capitalisme	capitalism
delegats	delegates
ambientals	environmental
springs	springs
hispano	hispano
yuan	yuan
prešov	prešov
barbus	barbus
begudes	beverages
begudes	drinks
regionalista	regionalist
thakur	thakur
challenge	challenge
cilindres	cylinders
amants	lovers
hàbit	habit
afer	affair
derrotes	defeats
argila	clay
tunis	tunis
grossa	grossa
gremi	guild
prades	prades
oblidar	forgetting
dallas	dallas
criminals	criminals
immediat	immediate
viatgers	travelers
patinatge	skating
dennis	dennis
reims	reims
etimologia	etymology
rotterdam	rotterdam
panteó	pantheon
bàltic	baltic
ronald	ronald
fórmules	formulas
fórmules	formulae
antàrtida	antarctica
intèrprets	interpreters
intèrprets	performers
pioners	pioneers
fossa	fossa
eddie	eddie
platnick	platnick
sentits	senses
calent	hot
bateries	batteries
montgomery	montgomery
trencat	broken
aleix	alexios
coronada	crowned
comunisme	communism
irene	irene
vilar	vilar
satisfer	satisfy
mnac	mnac
positius	positive
núñez	nunez
strauss	strauss
cerro	cerro
fabricat	manufactured
rècords	records
ecologia	ecology
baltimore	baltimore
nantes	nantes
plomes	feathers
bisbal	bisbal
sistemàtica	systematic
tit	titus
brabant	brabant
combinacions	combinations
colin	colin
llemosí	limousin
estructurals	structural
lliura	libra
lliura	pound
rita	rita
cries	offspring
diocesà	diocesan
finalitats	purposes
finalitats	aims
romanen	remain
transformada	transform
simètrica	symmetric
simètrica	symmetrical
wellington	wellington
frescos	fresh
admetre	admit
significatives	significant
bush	bush
defensiu	defensive
recompensa	reward
romàntica	romantic
cavitat	cavity
exactes	exact
pardo	pardo
