que	that
per	for
les	les
els	the
amb	with
com	like
més	more
bar	bar
seu	headquarters
van	van
era	era
seva	seva
text	text
també	also
entre	between
fou	was
anys	years
any	year
població	population
però	but
aquest	this
altres	other
altres	others
estat	state
després	after
són	are
fins	until
des	des
aquesta	this
eren	were
estats	states
persones	people
from	from
part	part
cap	none
sobre	envelope
gran	great
durant	during
durant	durant
tot	everything
enllaços	links
dos	two
externs	external
família	family
ciutat	city
quan	when
habitatges	houses
qual	which
molt	very
tenia	tapeworm
nord	north
habitants	inhabitants
barcelona	barcelona
dones	women
res	nothing
segons	seconds
primer	first
segle	century
nom	name
tres	three
sud	south
lloc	place
nova	new
nova	nova
homes	men
primera	first
dues	two
guerra	war
següent	next
sense	without
això	this
general	general
municipi	municipality
catalunya	catalonia
vivien	vivien
forma	shape
forma	form
mateix	same
fet	done
han	han
encara	still
mort	death
dades	data
només	only
només	just
regió	region
temps	time
empreses	companies
troba	find
grup	group
contra	against
admin	admin
properes	upcoming
famílies	families
frança	france
poblacions	populations
fills	children
rei	king
francès	french
mentre	while
nombre	number
tots	all
edició	editing
edició	publishing
isbn	isbn
renda	rent
quatre	four
partit	party
alguns	some
aquests	these
fill	son
nou	new
març	march
setembre	september
principal	main
menys	less
color	color
color	colour
món	world
octubre	october
empresa	company
abans	before
edat	age
web	web
jpg	jpg
dins	inside
església	church
maig	may
terme	terme
casa	house
història	story
història	history
país	country
segona	second
joan	john
joan	joan
final	end
govern	government
est	east
est	est
vida	life
poder	power
totes	all
situat	situated
gener	january
tipus	type
habitatge	housing
juny	june
diferents	different
parelles	couples
parelles	pairs
diversos	several
català	catalan
fitxa	sheet
insee	insee
títol	title
haver	haver
oest	west
desembre	december
què	what
san	san
nacional	national
nacional	nacional
abril	april
major	major
agost	august
vivint	living
poble	village
centre	center
centre	centre
perquè	because
aquestes	these
riu	river
disc	disc
mostra	sample
mostra	show
novembre	november
obres	works
millor	best
espanya	spain
sistema	system
santa	santa
juliol	july
diverses	several
total	total
universitat	university
dia	day
mitjà	medium
data	date
world	world
departament	department
construcció	construction
vol	flight
premi	prize
premi	award
exemple	example
febrer	february
escola	school
cinc	five
espècie	species
principals	main
madrid	madrid
font	source
zona	zone
grans	large
banda	band
banda	banda
central	central
província	province
oficial	officer
superfície	surface
maria	maria
molts	many
cens	census
equip	team
amèrica	america
amèrica	americas
ara	ara
ara	now
qui	who
dir	dir
punt	punt
punt	point
cest	cest
iii	iii
algunes	some
regne	kingdom
john	john
actualment	currently
cas	case
unitats	units
causa	cause
activitats	activities
president	president
article	article
exèrcit	army
música	music
aigua	water
increment	increase
llavors	then
llavors	seeds
conegut	known
conegut	acquaintance
terra	earth
gray	gray
saint	saint
barra	barra
barra	bar
sèrie	series
art	art
club	club
càrrec	charge
etapa	stage
rgb	rgb
república	republic
parís	paris
ordre	command
ordre	order
donar	give
cosa	thing
ell	him
llista	list
cet	cet
important	important
segon	second
europa	europe
cal	cal
servei	service
gridcolor	gridcolor
serveis	services
morir	die
alemanya	germany
piràmide	pyramid
lightgrey	lightgrey
darkgrey	darkgrey
sfondo	sfondo
antic	old
antic	antic
plaça	square
plaça	plaza
comtat	county
pare	father
pare	parent
informació	information
mar	sea
actual	current
serie	serie
castell	castle
castell	castell
york	york
països	countries
moment	moment
anglès	english
tal	tal
illa	island
període	period
territori	territory
londres	london
internacional	international
premis	awards
premis	prizes
josep	josep
josep	joseph
center	center
museu	museum
establiments	establishments
edats	ages
districte	district
pàgina	page
dies	days
havien	had
camp	field
camp	camp
llengua	tongue
llengua	language
base	base
llarg	long
capital	capital
alt	high
alt	alt
diagrama	diagram
diagrama	chart
edifici	building
línia	line
política	policy
política	politics
metres	meters
metres	metres
finalment	finally
francisco	francisco
costat	side
planta	plant
gènere	genre
gènere	gender
mateixa	same
vegades	times
majoria	majority
natural	natural
unió	union
tard	late
aconseguir	get
veure	see
director	director
força	strength
força	force
codi	code
distribució	distribution
origen	origin
persona	person
cos	body
primers	first
espècies	species
william	william
cases	houses
batalla	battle
sol	sun
suport	support
classificació	classification
itàlia	italy
fiscals	prosecutors
comarca	shire
pere	peter
top	top
califòrnia	california
cop	cop
fitxer	file
peix	fish
militar	military
costa	costa
popular	popular
anomenat	named
temporada	season
treball	job
treball	work
vila	vila
mare	mother
estudis	studies
eleccions	elections
articles	articles
discussió	discussion
polític	politician
conjunt	set
posteriorment	subsequently
llibre	book
roma	rome
estil	style
moviment	movement
imperi	empire
divisió	division
membre	member
sempre	always
porta	door
porta	porta
teatre	theater
teatre	theatre
membres	members
ells	them
resta	subtraction
moltes	many
acord	agreement
jocs	games
rebre	receive
rebre	receiving
illes	islands
illes	isles
avui	today
http	http
alta	high
alta	alta
posició	position
format	format
espanyol	spanish
sovint	often
comte	count
jersey	jersey
canvi	change
opció	option
germà	brother
comunes	common
material	material
superior	superior
pas	step
nivell	level
valència	valencia
crear	create
consell	council
consell	hint
creu	cross
ben	ben
futbol	football
antiga	former
volta	volta
interior	interior
josé	josé
finals	finals
finals	endings
paper	paper
entorn	environment
únic	unique
institut	institute
àfrica	africa
cultura	culture
baix	low
mitjançant	through
espai	space
equips	teams
pau	peace
pau	pau
qualsevol	any
civil	civil
civil	civilian
torre	tower
comerç	trade
carrer	street
etc	etc
direcció	direction
nens	kids
nens	children
elements	items
elements	elements
mapa	map
especialment	especially
procés	process
versió	version
dret	right
occidental	occidental
municipal	municipal
vall	valley
local	local
guanyar	win
ibn	ibn
desenvolupament	development
vertical	vertical
set	seven
set	thirsty
grups	groups
campionat	championship
pla	plan
vencedor	victors
classificades	classified
original	original
déu	god
projecte	project
vers	verse
situació	situation
carrera	career
carrera	carrera
alemany	german
oriental	oriental
filla	daughter
societat	society
sis	six
forces	forces
bisbe	bishop
real	real
èxit	success
social	social
relació	relationship
carles	charles
dona	woman
punts	dots
punts	points
densitat	density
clubs	clubs
imatge	image
producció	production
pedra	stone
tracta	treat
cultural	cultural
home	man
administració	administration
resultats	results
malgrat	despite
resum	overview
resum	summary
california	california
gràcies	thanks
econòmiques	economic
automòbils	cars
escut	shield
autor	author
cantó	canton
productes	products
estructura	structure
lliga	league
ciutats	cities
gairebé	almost
categoria	category
partits	matches
estudi	study
estudi	studio
muntanya	mountain
apareix	appears
estudiant	studying
estudiant	student
sobretot	especially
longitud	length
longitud	longitude
academy	academy
reparació	repair
serra	serra
propietaris	owners
comunitat	community
lluís	lluís
lluís	louis
fons	fons
fons	background
fons	bottom
milions	million
milions	millions
revista	magazine
familiars	relatives
jove	young
bottom	bottom
palau	palau
detall	detail
elaboració	preparation
sur	sur
sexe	sex
camí	path
emperador	emperor
estadístiques	statistics
campió	champion
control	control
copa	copa
principalment	mainly
llei	law
interès	interest
participar	participate
gràfic	chart
anual	annual
fan	fan
defensa	defense
defensa	defence
llocs	places
mai	mai
mai	never
ministre	minister
alçada	height
gràfica	graph
funció	function
dècada	decade
activitat	activity
presenta	presents
anterior	prev
anterior	previous
tour	tour
ella	she
ella	her
mèxic	mexico
públic	audience
públic	public
programa	program
programa	programme
façana	facade
can	can
jaume	james
jaume	jaume
següents	following
francesc	francesc
cinema	cinema
petita	small
tropes	troops
construir	build
eschmeyer	eschmeyer
fundació	foundation
podria	could
esquerra	left
patrimoni	heritage
referència	reference
inici	start
zones	areas
realitzar	perform
hall	hall
àrea	area
imagesize	imagesize
medalla	medal
timeaxis	timeaxis
aproximadament	roughly
aproximadament	approximately
plotarea	plotarea
scalemajor	scalemajor
dateformat	dateformat
massa	mass
alignbars	alignbars
pos	pos
veu	voice
pobresa	poverty
brasil	brazil
scaleminor	scaleminor
formació	training
backgroundcolors	backgroundcolors
organització	organization
resultat	result
anglaterra	england
possible	possible
duc	duke
mesos	months
terres	lands
terres	terres
evolucionat	evolved
professor	professor
valencià	valencian
musical	musical
ingressos	income
joc	game
mas	mas
robert	robert
llengües	languages
comune	comune
transport	transportation
transport	transport
jean	jean
creació	creation
grec	greek
caps	heads
príncep	prince
particulars	individuals
model	model
tercer	third
jugador	player
municipis	municipalities
llindar	threshold
sons	sounds
pàrquing	parking
victòria	victoria
restauració	restoration
antoni	antoni
principis	principles
fent	doing
fent	making
rússia	russia
llogaters	tenants
tractat	treaty
david	david
escriptor	writer
jordi	jordi
naixement	birth
viquipèdia	wikipedia
estiu	summer
nelson	nelson
press	press
índia	india
orde	order
parts	parts
parts	parties
manuel	manuel
residències	residences
probablement	probably
italià	italian
antonio	antonio
capita	capita
catalans	catalans
mestre	master
xina	china
plantes	plants
fabricació	manufacture
fabricació	manufacturing
fabricació	fabrication
las	las
permet	allow
explotacions	farms
romà	roman
número	number
ruta	route
ruta	ruta
entrada	entry
caràcter	character
aturades	paros
companyia	company
binomial	binomial
eds	eds
deu	ten
reis	kings
port	port
restes	remains
portar	carry
conca	conca
conca	basin
conca	cuenca
parc	park
festival	festival
arts	arts
ramon	ramon
gratuït	free
mitjans	media
mitjans	means
drets	rights
llibres	books
inclou	includes
governador	governor
compositor	composer
tercera	third
capella	capella
capella	chapel
bona	good
personatges	characters
teoria	theory
comunicació	communication
llum	light
blanc	white
aragó	aragon
massachusetts	massachusetts
meitat	half
kitt	kitt
lliure	free
mans	mans
aleshores	then
pobles	peoples
presència	presence
televisió	television
últim	last
tema	topic
tema	theme
spacewatch	spacewatch
humans	humans
humans	human
estació	station
associació	association
pintor	painter
menor	minor
japó	japan
problemes	problems
objectiu	goal
marc	marc
marc	frame
xviii	xviii
xviii	eighteenth
national	national
acció	action
ocupació	occupation
mascles	males
casos	cases
fonts	sources
noves	new
pont	bridge
imatges	images
principi	principle
dreta	right
velocitat	velocity
velocitat	speed
valor	value
qualitat	quality
generalitat	generalitat
generalitat	generality
professional	professional
referències	references
temple	temple
miquel	miquel
vista	view
museum	museum
aquí	here
energia	energy
arc	arc
classe	class
dinastia	dynasty
wheeler	wheeler
front	front
macdonald	macdonald
prova	test
prova	try
barri	neighborhood
segles	centuries
recent	recent
monestir	monastery
animals	animals
via	via
wiley	wiley
parlament	parliament
educació	education
característiques	features
actor	actor
influència	influence
castella	castile
viure	live
accés	access
conté	contains
gent	people
especial	special
xarxa	network
prentice	prentice
nucli	core
nucli	nucleus
nucli	kernel
decidir	decide
mesura	measurement
mesura	measure
sala	room
literatura	literature
moyle	moyle
cech	cech
clima	climate
comença	start
selecció	selection
congrés	congress
papa	pope
sentit	sense
von	von
personal	staff
fotografia	photograph
fotografia	photography
castellà	spanish
dirigida	directed
khan	khan
domini	domain
domini	dominion
corona	corona
aviat	soon
fort	strong
canal	canal
canal	channel
honor	honor
quantitat	amount
quantitat	quantity
nascut	born
girona	girona
secció	section
enric	enric
enric	henry
life	life
acadèmia	academy
cançó	song
capacitat	capacity
mallorca	majorca
mallorca	mallorca
normalment	usually
normalment	normally
generalment	generally
catedral	cathedral
der	der
cor	heart
ocupar	occupy
noms	names
sistemes	systems
disseny	design
pintura	painting
svg	svg
coll	neck
senyor	sir
senyor	lord
hectàrees	hectares
biblioteca	library
territoris	territories
esdevenir	becoming
rus	russian
genera	generate
genera	generates
formes	forms
formes	shapes
campanya	campaign
alcalde	mayor
mes	month
recerca	research
successor	successor
carretera	road
pallars	pallars
blackwell	blackwell
relacions	relationships
relacions	relations
fusta	wood
llatí	latin
malden	malden
potser	maybe
britànic	british
negre	black
publicat	published
publicat	posted
xvi	xvi
collette	collette
importància	importance
paul	paul
aigües	waters
independència	independence
facey	facey
lleó	lion
respecte	respect
palomar	palomar
propi	own
industrials	industrial
industrials	industrialists
etapes	stages
personatge	character
aire	air
considerat	considered
editorial	publisher
editorial	editorial
petites	small
fos	melted
unitat	unit
american	american
atac	attack
extrem	extreme
plana	flat
diari	newspaper
diari	journal
diari	diary
figura	figure
peces	tracks
peces	pieces
tècnica	technique
diferència	difference
lluita	wrestling
lluita	fight
orquestra	orchestra
òpera	opera
àrab	arabic
volum	volume
reina	queen
argentina	argentina
argentina	argentine
peixos	fish
àlbum	album
comercial	commercial
exposició	exhibition
exposició	exposure
arriba	arrives
bandera	flag
proves	tests
proves	testing
equipaments	equipment
equipaments	equipments
apartaments	apartments
berlín	berlin
nau	ship
austràlia	australia
última	last
james	james
cançons	songs
piano	piano
maría	mary
posterior	rear
temes	themes
temes	topics
fets	facts
funcions	functions
economia	economy
matrimoni	marriage
independent	independent
treballs	jobs
idea	idea
tradició	tradition
federació	federation
charles	charles
escolars	schoolchildren
actriu	actress
formant	forming
inc	inc
mercat	marketplace
mercat	market
evitar	avoid
grau	grade
grau	grau
grau	degree
compte	account
sector	sector
creat	created
nit	night
llac	lake
favor	favour
motiu	reason
ajuda	help
condicions	terms
masia	masia
generals	generals
dur	hard
comú	common
efecte	effect
americà	american
paraula	word
donat	donat
entitat	entity
muntanyes	mountains
tradicional	traditional
sanitaris	toilets
poeta	poet
net	net
guillem	william
problema	problem
propietat	property
canvis	changes
composició	composition
frontera	border
històric	historical
egipte	egypt
pocs	few
conèixer	meet
escrit	written
edicions	edits
parla	speaks
xvii	xvii
diferent	different
trobat	found
escala	scale
george	george
permetre	allow
bretanya	brittany
vuit	eight
passat	past
nombrosos	numerous
revolució	revolution
coberta	deck
competició	competition
indústria	industry
arquitectura	architecture
luis	luis
peu	foot
agrícola	agricultural
locals	local
gen	gene
utilitzat	used
realitat	reality
aquells	those
armes	weapons
armes	guns
quarta	fourth
martí	marti
martí	martí
martí	martin
mica	mica
similar	similar
seguretat	security
seguretat	safety
www	www
militars	military
pertany	belongs
present	present
pes	weight
edificis	buildings
camps	fields
autors	authors
festa	party
soldats	soldiers
comissió	commission
soviètica	soviet
portugal	portugal
xiii	xiii
dirigir	directing
canadà	canada
arxiu	archive
arxiu	file
arribada	arrival
màxim	maximum
línies	lines
àustria	austria
germans	brothers
objectes	objects
marca	mark
moderna	modern
artistes	artists
entitats	entities
fase	phase
amor	love
altitud	altitude
ciències	science
pis	floor
darrer	last
defunció	death
hores	hours
cursa	race
doble	double
àsia	asia
anderson	anderson
península	peninsula
distància	distance
econòmica	economic
tarragona	tarragona
oscar	oscar
traducció	translation
termes	termes
termes	terms
consta	consists
joves	young
normal	normal
felip	philip
hostatgeria	hospice
botiga	shop
botiga	store
richard	richard
tropical	tropical
puig	puig
vots	votes
llarga	long
destaca	highlights
nombroses	numerous
regions	regions
taula	table
jesús	jesus
industrial	industrial
física	physics
element	element
pàgines	pages
ferro	iron
artista	artist
mida	size
enciclopèdia	encyclopedia
secretari	secretary
socials	social
objecte	object
directament	directly
esposa	wife
rep	receives
albert	albert
materials	materials
retirar	withdraw
roca	rock
notes	notes
comercials	commercial
marina	marina
salvador	salvador
usuari	user
cort	cort
cort	court
plata	silver
comandant	commander
hivern	winter
paraules	words
temperatura	temperature
romans	romans
contingut	content
lleida	lleida
suïssa	switzerland
evolució	evolution
representació	rendering
representació	render
representació	representation
comandament	command
vora	edge
vora	border
xii	xii
vallès	vallès
cantant	singer
cantant	singing
existència	existence
llibertat	freedom
llibertat	liberty
plantilla	template
malaltia	disease
elemental	elementary
rius	rivers
produeix	produces
michael	michael
particular	particular
tron	throne
existeix	exists
torneig	tournament
ambdós	both
salut	health
prou	enough
crítica	criticism
oficina	office
assassinat	murder
oficials	officers
marine	marine
xiv	xiv
efectes	effects
hora	hour
química	chemistry
estadi	stadium
estadi	estadio
barranc	ravine
barranc	gully
hospital	hospital
investigació	research
escacs	chess
protecció	protection
publicació	publication
publicació	post
construït	built
carta	letter
foc	fire
socialista	socialist
grècia	greece
viatge	trip
carlos	carlos
resistència	resistance
garcía	garcia
garcía	garcía
considerar	consider
motor	engine
expedició	expedition
àmbit	field
àmbit	area
àmbit	scope
colors	colours
colors	colors
sap	sap
constitució	constitution
recuperar	retrieve
allà	there
federal	federal
torres	torres
mur	wall
mur	mur
escoles	schools
animal	animal
ràdio	radio
pierre	pierre
mètode	method
memòria	memory
cara	face
lletres	lyrics
quart	fourth
actes	acts
jugadors	players
cambres	chambers
quilòmetres	kilometres
quilòmetres	miles
inventari	inventory
martin	martin
blanca	blanca
missió	mission
concepte	concept
polítiques	policies
rock	rock
pràctica	practice
anna	anna
setmana	week
smith	smith
participació	participation
segueix	follow
vii	vii
mena	mena
futur	future
individual	individual
britànica	british
ciència	science
filosofia	philosophy
capità	captain
bosc	woods
bosc	forest
fórmula	formula
fundada	founded
verd	green
escena	scene
pressió	pressure
urgell	urgell
inicialment	initially
viena	vienna
joseph	joseph
bgcolor	bgcolor
concentració	concentration
classes	classes
sortida	output
sortida	exit
thomas	thomas
colònia	cologne
colònia	colony
por	fear
ciclista	cyclist
fulles	leaves
arquitecte	architect
règim	regime
medieval	medieval
portal	portal
recursos	resources
creixement	growth
establiment	establishment
conflicte	conflict
pedro	pedro
assemblea	assembly
tribus	tribes
polítics	politicians
poesia	poetry
ferran	ferdinand
peter	peter
alfons	alfonso
vint	twenty
ràpidament	quickly
mil	thousand
mil	mil
conseqüència	consequence
regnat	reign
catòlica	catholic
àrees	areas
pares	parents
pares	dads
naturals	natural
amic	friend
mont	mount
mont	mont
irlanda	ireland
contacte	contact
louis	louis
seguit	followed
minuts	minutes
cert	true
bronze	bronze
actiu	active
dalt	upstairs
revolta	riot
medicina	medicine
abu	abu
taller	workshop
curs	course
apareixen	appear
modern	modern
polònia	poland
combat	combat
líder	leader
fundador	founder
afegir	add
bèlgica	belgium
corrent	current
sola	alone
princesa	princess
títols	titles
vermell	red
film	film
existeixen	exist
humà	human
vaixells	boats
vaixells	ships
coneguts	acquaintances
límit	limit
galeria	gallery
flors	flowers
https	https
acte	act
mal	mal
producte	product
coses	things
coses	stuff
coneixement	knowledge
totalment	fully
totalment	totally
seguint	following
tribu	tribe
raó	reason
estrella	star
germana	sister
comuna	commune
llevant	levante
moviments	moves
moviments	movements
nov	nov
boscos	forests
alemanys	germans
comitè	committee
províncies	provinces
finestres	windows
ronda	ronda
ronda	round
morts	dead
pista	track
usuaris	users
don	don
monument	monument
futbolista	footballer
reconeixement	appreciation
reconeixement	recognition
tractament	treatment
palma	palma
estrenada	premiered
figures	figures
miguel	miguel
santiago	santiago
smithsonian	smithsonian
feina	job
suècia	sweden
washington	washington
rosa	pink
rosa	rose
rosa	rosa
monuments	monuments
valors	values
park	park
religió	religion
continuació	continuation
enllaç	link
tasca	task
nacions	nations
fundat	founded
obert	open
documents	documents
policia	police
oposició	opposition
tècniques	techniques
digital	digital
anònim	anonymous
predecessor	predecessor
org	org
milà	milan
residència	residence
arquebisbe	archbishop
setge	siege
quadre	table
conquesta	conquest
torrent	torrent
completament	completely
autònoma	autonomous
stadium	stadium
peça	track
llenguatge	language
tecnologia	technology
lópez	lopez
porto	porto
propietats	properties
entrenador	coach
projectes	projects
lliures	free
lliures	pounds
dit	finger
proposta	proposal
clau	key
agricultura	farming
agricultura	agriculture
relacionats	related
espasa	sword
pèrdua	loss
colspan	colspan
extensió	extension
varietat	variety
alexandre	alexandre
alexandre	alexander
sang	blood
guinea	guinea
ponent	westeros
venècia	venice
internet	internet
nacionals	nationals
sevilla	seville
oct	oct
basc	basque
circuit	circuit
valls	valls
simon	simon
anàlisi	analysis
abr	apr
aspecte	aspect
resposta	answer
feta	made
feta	feta
hàbitat	habitat
oficialment	officially
moscou	moscow
periodista	journalist
festes	holidays
terreny	terrain
terreny	ground
operació	operation
fortalesa	fortress
pirineus	pyrenees
internacionals	international
blau	blue
roig	red
millorar	improve
senyal	signal
difícil	difficult
diputats	deputies
versions	versions
històrica	historical
dirigit	directed
metge	physician
metge	doctor
cadena	string
cadena	chain
aliança	alliance
models	models
vaixell	boat
historiador	historian
lletra	lyrics
junta	board
junta	junta
rafael	raphael
presó	prison
operacions	operations
royal	royal
vist	seen
localitat	locality
celebrar	celebrate
aplicació	application
obertura	aperture
obertura	opening
esdeveniments	events
cedit	loaned
categories	categories
amics	friends
premsa	press
turó	hill
parella	couple
israel	israel
ocasions	occasions
black	black
concert	concert
reforma	reform
simple	simple
portes	doors
idees	ideas
und	und
dimensions	dimensions
anteriorment	previously
ferraris	ferraris
parròquia	parish
excepte	except
comunista	communist
exemples	examples
reserva	reservation
reserva	reserve
explica	explains
oli	oil
vídeo	video
provocar	provoke
dedicada	dedicated
autoritat	authority
compost	compound
inicial	initial
forta	strong
econòmic	economic
destacats	highlights
darrera	last
ocupa	occupies
expressió	expression
accions	actions
imperial	imperial
càrrega	load
càrrega	loading
descripció	description
henry	henry
para	para
muhammad	muhammad
feb	feb
abd	abd
dedicat	dedicated
lleis	laws
atenció	attention
cavall	horse
rectangular	rectangular
justícia	justice
volia	wanted
luxemburg	luxembourg
fàbrica	factory
fernando	fernando
diners	money
béns	goods
gas	gas
presa	dam
presa	prey
populars	popular
nivells	levels
completa	complete
flota	fleet
branca	branch
red	red
paris	paris
culturals	cultural
daniel	daniel
simplement	simply
indica	indicates
programes	programmes
programes	programs
centres	centers
centres	centres
espanyols	spaniards
planeta	planet
atacs	attacks
principat	principality
llobregat	llobregat
habitual	usual
municipals	municipal
migdia	noon
fernández	fernandez
fernández	fernández
essent	being
treballadors	workers
solar	solar
carrers	streets
instruments	instruments
nombres	numbers
sabadell	sabadell
complex	complex
símbol	symbol
pintures	paints
pintures	paintings
constant	constant
matar	killing
viii	viii
#aaa	#aaa
gestió	management
àcid	acid
cossos	bodies
temporades	seasons
crisi	crisis
riba	riba
jul	jul
manca	lack
sants	saints
sants	sants
ali	ali
ensenyament	teaching
montserrat	montserrat
ministeri	ministry
giro	giro
participants	participants
baixes	low
motius	reasons
motius	motives
regional	regional
ascensió	ascension
necessitat	need
possibilitat	possibility
complet	complete
cardenal	cardinal
martínez	martinez
martínez	martínez
pérez	pérez
universal	universal
context	context
isabel	isabel
arcs	bows
die	die
convent	convent
jueus	jews
bernat	bernard
bernat	bernat
con	cone
cristians	christians
derrota	defeat
giovanni	giovanni
noruega	norway
famós	famous
cambridge	cambridge
estudiants	students
donant	giving
donant	donor
doctor	doctor
espais	spaces
riera	stream
interpretació	interpretation
caiguda	fall
continua	continues
aspectes	aspects
empordà	empordà
basat	based
incloure	include
intent	attempt
din	din
document	document
clara	clara
utc	utc
clàssica	classical
mínim	minimum
estàndard	standard
obertures	openings
hom	hom
institucions	institutions
representant	representative
altura	height
organitzar	organize
escultura	sculpture
marquès	marquess
roger	roger
editor	editor
agència	agency
visió	vision
laterals	lateral
cim	cim
international	international
passant	happening
americans	americans
elegit	chosen
esteve	stephen
diòcesi	diocese
musulmans	muslims
gira	rotate
retorn	return
nostra	nostra
concurs	contest
acceptar	accepting
acceptar	accept
possiblement	possibly
reacció	reaction
golf	golf
global	global
directe	direct
textos	texts
marit	husband
terrestre	terrestrial
navarra	navarre
rang	rank
tractar	treat
reus	reus
actuals	current
responsable	responsible
gonzález	gonzález
partida	game
ribera	ribera
capaç	capable
pacífic	pacific
matèria	matter
arbre	tree
florida	florida
propis	own
declarar	declare
cicle	cycle
llegenda	legend
llançament	launch
processos	processes
orient	orient
patir	suffer
donen	dan
similars	similar
estrelles	stars
notable	remarkable
enviat	sent
arran	arran
caixa	box
utilitzant	using
estructures	structures
ciutadans	citizens
inicis	beginnings
signar	sign
guerres	wars
femení	female
generació	generation
survey	survey
platja	beach
publicacions	posts
pell	skin
invasió	invasion
all	garlic
eix	axis
papers	papers
fao	fao
casat	married
àrabs	arabs
alegre	cheerful
ago	aug
valign	valign
successió	succession
deixant	leaving
andorra	andorra
serrat	serrat
aliats	allies
comptes	accounts
pràcticament	practically
atenes	athens
nobel	nobel
terrassa	terrace
terrassa	terrassa
ermita	hermitage
crist	christ
gèneres	genres
biografia	biography
pilot	pilot
coalició	coalition
ambdues	both
igualment	equally
igualment	similarly
arbres	trees
liberal	liberal
ulls	eyes
conservació	conservation
presidència	presidency
actuació	performance
usa	use
usa	usa
documentació	documentation
concerts	concerts
hongria	hungary
comunitats	communities
plans	plans
artístic	artistic
ducat	duchy
freqüència	frequency
aconsegueix	get
mètodes	methods
poques	few
trajectòria	trajectory
sub	sub
algú	someone
experiència	experience
xile	chile
zelanda	zealand
esmenta	mentions
expansió	expansion
aeroport	airport
curt	curt
curt	short
alumnes	students
veïns	neighbors
veïns	neighbours
restaurant	restaurant
retornar	return
representar	represent
respectivament	respectively
bellesa	beauty
punta	tip
man	man
guitarra	guitar
tradicionals	traditional
democràtica	democratic
turquia	turkey
decisió	decision
mesures	measures
atlàntic	atlantic
selva	jungle
instrument	instrument
guàrdia	guard
esmentat	mentioned
titular	headline
titular	holder
escrits	writings
elèctric	electric
advocat	lawyer
menors	minors
fruit	fruit
ucraïna	ukraine
solució	solution
conserven	retain
eslovàquia	slovakia
vent	wind
primavera	spring
tinent	lieutenant
grand	grand
correu	mail
dinamarca	denmark
desenvolupat	developed
vella	vella
aplicacions	applications
aplicacions	apps
texas	texas
relativament	relatively
badia	bay
sicília	sicily
breu	brief
mario	mario
ordres	commands
ordres	orders
coordenades	coordinates
banc	bank
aires	aires
religiós	religious
vehicles	vehicles
pintors	painters
districtes	districts
augment	increase
ocell	bird
possessió	possession
conseller	counsellor
persecució	persecution
càrrecs	charges
científic	scientist
carl	carl
belles	belles
oceà	ocean
joaquim	joaquim
cònsol	consul
manté	maintains
rebut	received
august	augustus
jardí	garden
nàpols	naples
perú	peru
medalles	medals
autoritats	authorities
registre	register
tribunal	court
mestres	teachers
recorregut	tour
error	mistake
error	error
denominació	name
denominació	denomination
capítol	chapter
realitza	performs
malalties	diseases
reunir	gather
dolça	sweet
rosselló	roussillon
rosselló	rosselló
castells	castles
castells	castells
morí	died
absis	apse
joventut	youth
molí	mill
artística	artistic
matemàtiques	mathematics
peus	feet
decoració	decoration
decret	decree
recentment	recently
culte	cult
culte	worship
grecs	greeks
columna	column
ebre	ebro
ebre	ebre
menjar	food
inclòs	included
inclòs	including
japonès	japanese
noble	noble
murs	walls
dotze	twelve
london	london
immediatament	immediately
conferència	conference
reconèixer	recognize
reconèixer	acknowledge
xinès	chinese
columnes	columns
lluna	moon
institució	institution
tallers	workshops
ple	full
cua	queue
cua	tail
finestra	window
altes	ups
sèries	series
singh	singh
rodríguez	rodriguez
franco	franco
moments	moments
corea	korea
png	png
ferrocarril	railroad
ferrocarril	railway
bloc	blog
bloc	bloc
bloc	block
turisme	tourism
psoe	psoe
estany	pond
definició	definition
òrbita	orbit
condició	condition
intenció	intention
músic	musician
nació	nation
groc	yellow
cercle	circle
victòries	wins
victòries	victories
aèria	aerial
defensar	defend
falta	lack
falta	missing
notables	notable
objectius	goals
torn	shift
torn	lathe
torn	turn
contrari	contrary
contrari	opposite
parets	walls
originalment	originally
ferrer	blacksmith
abadia	abbey
notícies	news
determinar	determine
mark	mark
poemes	poems
funcionament	operation
familia	family
nen	child
cat	cat
diàmetre	diameter
escòcia	scotland
mandat	mandate
elecció	choice
introducció	introduction
introducció	intro
infanteria	infantry
característica	feature
setmanes	weeks
martín	martín
martín	martin
anunciar	announce
ofereix	offers
trenta	thirty
descriu	describes
descriu	describe
posicions	positions
pdf	pdf
esport	sport
bases	bases
esclaus	slaves
familiar	familiar
escriptura	writing
reconegut	recognized
vendre	sell
veus	voices
cementiri	cemetery
oxford	oxford
castelló	castellón
castelló	castelló
ajut	help
components	components
patró	pattern
físic	physicist
físic	physical
vic	vic
tom	tom
jones	jones
perdut	lost
saló	lounge
saló	salon
naturalesa	nature
organitzacions	organizations
jacques	jacques
saragossa	zaragoza
natura	natura
natura	nature
jerusalem	jerusalem
segurament	surely
diego	diego
cuba	cuba
científics	scientists
potència	power
roba	clothes
fotografies	photographs
fotografies	pictures
serveix	serves
coronel	colonel
hem	hem
possibles	possible
white	white
cavaller	knight
hoboken	hoboken
propera	next
armènia	armenia
permanent	permanent
destacat	featured
guió	dash
guió	script
google	google
escenes	scenes
lingüística	linguistics
xavier	xavier
descendents	descendants
orígens	origins
descobert	discovered
retirada	retreat
retirada	withdrawal
professionals	professionals
professionals	professional
antigament	formerly
pisos	flats
pisos	floors
batlle	batlle
cadascun	each
colòmbia	colombia
taiwan	taiwan
carolina	carolina
episodi	episode
derrotat	defeated
superiors	superiors
intervenció	intervention
territorial	territorial
tocar	touching
bach	bach
esperit	spirit
documental	documentary
síria	syria
tret	gunshot
independents	independent
independents	independents
observar	observe
scott	scott
diferències	differences
lateral	lateral
alliberament	release
alliberament	liberation
gel	ice
límits	limits
vilanova	vilanova
gens	gens
clàssic	classic
tram	stretch
canals	channels
canals	canals
fusió	fusion
abandona	quit
cops	beatings
equivalent	equivalent
homenatge	tribute
olímpic	olympic
ocells	birds
portada	cover
poema	poem
kullander	kullander
naval	naval
idioma	language
fàcil	easy
marie	marie
hereu	heir
perill	danger
capa	layer
mediterrània	mediterranean
exili	exile
múltiples	multiple
venda	sale
desert	desert
especials	specials
especials	special
públiques	public
protegir	protect
programari	software
king	king
alacant	alicante
amplada	width
cel	heaven
cel	sky
durada	duration
demostrar	demonstrate
senat	senate
mitologia	mythology
civils	civilians
html	html
minerals	minerals
explicar	explain
esdeveniment	event
disponible	available
abat	abbot
sánchez	sanchez
àngel	angel
uruguai	uruguay
curses	careers
mediterrani	mediterranean
proteïnes	protein
proteïnes	proteins
circumscripció	constituency
naus	ships
islam	islam
normes	rules
françois	françois
virus	virus
tomba	tomb
frank	frank
plena	full
representants	representatives
regular	regular
productor	producer
carregat	loaded
assegurar	secure
arribant	coming
risc	risk
contracte	contract
factors	factors
tenint	bearing
tenint	taking
corresponent	corresponding
trets	gunshots
trets	shots
sultà	sultan
oberta	open
verge	virgin
descobriment	discovery
trobada	meeting
autonomia	autonomy
car	expensive
bandes	bands
provincial	provincial
alps	alps
campionats	championships
sòl	soil
enginyeria	engineering
paisatge	landscape
granada	granada
catalina	catalina
opinió	opinion
regnes	kingdoms
revistes	magazines
chicago	chicago
deriva	drift
edward	edward
globus	globe
globus	balloons
globus	balloon
rica	rica
dominis	domains
parlants	speakers
val	val
difusió	diffusion
difusió	spread
difusió	dissemination
acabat	finish
acabat	finished
relleu	relief
carboni	carbon
identitat	identity
humanitat	humanity
rio	rio
bisbat	bishopric
protagonista	protagonist
são	são
cartes	cards
roques	roques
roques	rocks
tradicionalment	traditionally
adquirir	acquire
catàleg	catalogue
catàleg	catalog
escultor	sculptor
tony	tony
bisbes	bishops
propietari	owner
journal	journal
harry	harry
comportament	behavior
exposicions	exhibitions
enemic	enemy
ningú	anyone
ningú	nobody
republicà	republican
cavalleria	cavalry
paleta	palette
marge	margin
restaurants	restaurants
finalitat	purpose
congo	congo
representen	represent
converteix	convert
candidat	candidate
plataforma	platform
presents	present
angle	angle
habitualment	usually
dansa	dance
visita	visit
coral	coral
entrevista	interview
motors	engines
fred	cold
fred	fred
portuguès	portuguese
dècades	decades
corda	rope
corda	chord
classificada	classified
pensament	thought
milers	thousands
armada	navy
inscripció	registration
iniciativa	initiative
voluntat	will
flandes	flanders
perfil	profile
transició	transition
cova	cave
adaptació	adaptation
teresa	teresa
tasques	tasks
ceràmica	ceramic
ceràmica	ceramics
ràpid	fast
jan	jan
arxius	files
arxius	archives
dubte	doubt
moneda	currency
moneda	coin
facultat	faculty
foto	photo
lsp	lsp
salt	salt
enginyer	engineer
vessants	strands
consum	consumption
associat	associate
boca	mouth
boca	boca
nobles	nobles
realment	really
caça	hunting
soler	soler
partícules	particles
college	college
destrucció	destruction
tren	train
usat	used
belga	belgian
cavalls	horses
calendari	calendar
pedres	stones
descriure	describe
aconseguit	achieved
adoptar	adopt
infant	child
reunió	meeting
aliments	foods
parell	peer
williams	williams
pop	pop
astúries	asturias
resolució	resolution
berenguer	berengar
berenguer	berenguer
oncle	uncle
ficció	fiction
ocasió	occasion
nadal	christmas
time	time
públics	public
walter	walter
anat	gone
pesca	fishing
crític	critic
crític	critical
geòrgia	georgia
carn	meat
produït	produced
comuns	common
marroc	morocco
detalls	details
ordo	ordo
bàsquet	basketball
costes	coasts
senzill	simple
css	css
incorporar	incorporate
volums	volumes
exteriors	foreign
gabriel	gabriel
eines	tools
retrat	portrait
exèrcits	armies
pantalla	screen
estrena	premiere
diccionari	dictionary
definitivament	definitely
conquerir	conquer
penedès	penedès
nuclear	nuclear
guanyat	won
guanyat	earned
accident	accident
vot	vote
tendència	trend
sexual	sexual
comtes	earls
ordinador	computer
ruïnes	ruins
fama	fame
cuina	kitchen
vols	flights
variant	variant
russos	russians
comarques	counties
lemmon	lemmon
cèsar	caesar
llistes	lists
comèdia	comedy
interpretar	interpret
das	das
originals	originals
clarament	clearly
univers	universe
significat	meaning
alfred	alfred
concretament	specifically
lleugerament	slightly
manresa	manresa
continental	continental
extinció	extinction
destruir	destroy
persa	persian
equipament	equipment
llegir	read
max	max
avions	planes
masculí	male
nota	note
fàcilment	easily
convertit	converted
sorgir	arise
actors	actors
compondre	compose
creixent	growing
vocal	vowel
jack	jack
eduard	edward
eduard	eduard
florència	florence
interna	internal
vapor	vapor
vapor	steam
directa	direct
certes	certain
roman	roman
bateria	battery
guia	guide
gràcia	grace
romania	romania
màquina	machine
màquina	host
unesco	unesco
inofensiu	harmless
noguera	noguera
decideix	decides
execució	execution
estacions	seasons
estacions	stations
excepció	exception
canó	cannon
designació	appointment
literària	literary
costats	sides
comprar	buy
estret	strait
estret	narrow
escriu	write
system	system
fenomen	phenomenon
cost	cost
agent	agent
impacte	impact
fosc	dark
colla	gang
organismes	agencies
organismes	organisms
ull	eye
flor	flower
raja	raja
ala	ala
promoció	promotion
declaració	statement
declaració	declaration
guanyador	winner
della	della
vehicle	vehicle
seccions	sections
fusteria	carpentry
depèn	depends
postal	postcard
bell	bell
millora	improvement
preu	price
super	super
llar	home
circular	circular
metall	metal
escriptors	writers
crítiques	reviews
encarregat	commissioned
veneçuela	venezuela
violí	violin
violí	fiddle
feliu	feliu
aniversari	birthday
aniversari	anniversary
disputa	dispute
esports	sports
ocupat	busy
gòtic	gothic
filòsof	philosopher
èxits	achievements
barris	neighborhoods
vicente	vicente
interessos	interests
dibuixos	drawings
johann	johann
controlar	controlling
entendre	understand
avinguda	avenue
michel	michel
democràtic	democratic
santuari	sanctuary
defineix	defines
defineix	define
emir	emir
natal	natal
tolosa	toulouse
comunicacions	communications
saxònia	saxony
designada	designated
cant	cant
cant	singing
nostre	ours
lee	lee
aus	birds
construccions	constructions
infantil	childish
cristianisme	christianity
segur	sure
electoral	electoral
exemplars	copies
suma	sum
baviera	bavaria
centrals	central
lectura	reading
raons	reasons
còmic	comics
occidentals	westerners
secret	secret
tècnic	technical
tècnic	technician
nacionalitat	nationality
estén	extends
estén	extend
donada	given
dura	hard
alexander	alexander
financera	financial
francesco	francesco
cristià	christian
zero	zero
contenen	contain
definir	define
nebot	nephew
colònies	colonies
produeixen	produce
sonora	sonora
vies	tracks
hotel	hotel
temperatures	temperatures
otomà	ottoman
proclamar	proclaim
crea	create
enemics	enemies
utilitzats	used
senyors	gentlemen
altar	altar
protegit	protected
amenaça	threat
vegetació	vegetation
iraq	iraq
conflictes	conflicts
aran	aran
músics	musicians
nacionalista	nationalist
déus	gods
resoldre	resolve
resoldre	solve
dibuix	drawing
monarquia	monarchy
factor	factor
activa	activate
missatge	message
presentació	presentation
anell	ring
mary	mary
democràcia	democracy
filipines	philippines
absència	absence
prefix	prefix
històries	stories
branques	branching
branques	branches
barroc	baroque
disciplina	discipline
presoners	prisoners
plantilles	templates
one	one
discurs	discourse
discurs	speech
transmissió	transmission
transmissió	transmit
testament	testament
flora	flora
cadascuna	each
profunditat	depth
capçalera	header
mineral	ore
mineral	mineral
superar	overcome
constantinoble	constantinople
voltes	laps
composicions	compositions
goya	goya
continent	continent
paret	wall
arthur	arthur
períodes	periods
sierra	sierra
criteris	criteria
recinte	enclosure
andré	andré
ramón	ramón
ramón	ramon
atmosfera	atmosphere
bones	good
bizantí	byzantine
geografia	geography
proposat	proposed
combinació	combination
macedònia	macedonia
botigues	shops
botigues	stores
nét	grandson
disposició	layout
disposició	provision
sacerdot	priest
windows	windows
adn	dna
havent	having
coma	coma
coma	comma
episodis	episodes
ona	wave
organisme	organism
paletes	pallets
taules	tables
onze	eleven
pati	courtyard
pati	yard
víctor	victor
veritat	truth
junts	together
horta	horta
particularment	particularly
maneres	ways
calor	heat
munic	munich
sectors	sectors
cruz	cruz
conservatori	conservatory
manteniment	maintenance
útil	useful
reformes	reforms
rècord	record
treballant	working
artilleria	artillery
western	western
utilització	use
blancs	whites
substituït	replaced
illinois	illinois
ascens	ascent
renaixement	renaissance
renaixement	rebirth
alfabet	alphabet
avió	airplane
avió	plane
mines	mines
escenari	stage
pilar	pillar
pilar	pilar
uneix	join
provença	provence
ales	wings
ales	ales
quarts	quarters
oxigen	oxygen
actuacions	performances
nintendo	nintendo
mode	mode
vietnam	vietnam
variable	variable
declarat	declared
individuals	individual
karl	karl
suec	swedish
lampisteria	thorium
constitueix	constitutes
cerdanya	cerdanya
romànic	romanesque
desaparèixer	disappear
recuperació	recovery
regiment	regiment
elevat	elevated
tancat	closed
legal	legal
gai	gay
camins	roads
camins	paths
iran	iran
bilbao	bilbao
divideix	split
divideix	divides
bàsicament	basically
tardor	autumn
violència	violence
vidre	glass
programació	programming
dividit	divided
ous	eggs
continguts	contents
formats	formats
fetes	made
determinat	determined
lord	lord
aquelles	those
relacionat	related
necessitats	needs
identificar	identify
comentaris	comments
dificultats	difficulties
compostos	compounds
probable	likely
vidal	vidal
consulta	query
consulta	consultation
assaig	testing
passeig	walk
sales	rooms
sales	halls
estableix	set
fauna	fauna
marró	brown
arrels	roots
nuclis	kernels
nuclis	nuclei
nuclis	cores
perpinyà	perpignan
puerto	puerto
ciclisme	cycling
judici	trial
manual	manual
amistat	friendship
amistat	friend
assistir	attend
italians	italians
llicència	licence
llicència	license
universitats	universities
antiguitat	seniority
sal	salt
poders	powers
lisboa	lisbon
cavallers	gentlemen
savoia	savoy
savoia	savoia
letònia	latvia
wiki	wiki
equació	equation
enterrat	buried
petició	request
petició	petition
escapar	escape
baró	baron
miró	miro
miró	miró
metro	subway
metro	metro
diaris	newspapers
diaris	journals
diaris	diaries
pertanyia	belonged
imposar	impose
alba	alba
càncer	cancer
graus	degrees
historiadors	historians
majoritàriament	mostly
amsterdam	amsterdam
usos	uses
nicolau	nicholas
turc	turkish
blat	wheat
borgonya	burgundy
caracteritza	characterized
adults	adults
arriben	arrive
giuseppe	giuseppe
nominacions	nominations
norma	norma
norma	norm
mor	dies
mor	mor
sobirania	sovereignty
conjuntament	jointly
benet	benet
nasa	nasa
georges	georges
viatges	travel
jazz	jazz
coure	copper
ohio	ohio
portat	ported
portat	brought
dissenyat	designed
monedes	coins
monedes	currencies
fragments	fragments
quin	what
temporal	temporary
confederació	confederation
localització	location
senador	senator
valladolid	valladolid
pablo	pablo
delta	delta
basílica	basilica
alberto	alberto
javier	javier
existir	exist
potencial	potential
tennis	tennis
cobert	covered
cobert	shed
oficines	offices
buit	empty
buit	vacuum
juvenil	youth
gust	taste
borbó	bourbon
neerlandès	dutch
colom	pigeon
colom	colom
gómez	gomez
gómez	gómez
turcs	turks
lituània	lithuania
pro	pro
convertint	converting
convertint	turning
tothom	everyone
hans	hans
traduït	translated
moral	moral
moral	morals
moral	morality
hitler	hitler
barreja	shuffle
barreja	mix
henri	henri
rebels	rebels
equador	equator
equador	ecuador
notícia	news
femelles	females
publica	commit
catòlic	catholic
acer	steel
aquitània	aquitaine
farmàcia	pharmacy
rodes	wheels
celebració	celebration
utc+	utc+
informe	report
dictadura	dictatorship
finlàndia	finland
uci	icu
recents	recent
personals	personal
cursos	courses
seqüència	sequence
galícia	galicia
califa	caliph
flux	flow
badalona	badalona
acabada	finished
roda	wheel
estàtua	statue
retirat	retired
secundari	secondary
cotxe	car
registres	records
golden	golden
electricista	electrician
esforços	efforts
líders	leaders
fotos	photos
jardins	gardens
soviètic	soviet
lès	lès
arma	weapon
arma	gun
agustí	augustine
agustí	agustí
seguidors	followers
seguidors	trackers
campanyes	campaigns
open	open
bages	bages
cinquè	fifth
aprofitar	seize
noia	girl
aprendre	learn
radiació	radiation
braç	arm
noblesa	nobility
interessant	interesting
químic	chemical
químic	chemist
pertanyen	belong
ports	ports
idiomes	languages
teories	theories
catòlics	catholics
raça	breed
econòmics	economic
haleakala	haleakalā
pacific	pacific
missions	missions
burgos	burgos
travessa	crosses
navegació	navigation
hidrogen	hydrogen
jurisdicció	jurisdiction
separació	separation
popularitat	popularity
divisions	divisions
rebé	received
pols	dust
símbols	symbols
literari	literary
friedrich	friedrich
hamburg	hamburg
indis	indians
senyora	madam
senyora	lady
salamanca	salamanca
sort	lucky
andalusia	andalusia
contribuir	contributing
contribuir	contribute
vicenç	vicenç
online	online
índex	index
var	var
mecànica	mechanical
realització	realisation
realització	realization
sec	sec
placa	plate
frase	phrase
frase	sentence
explotació	exploitation
tortosa	tortosa
conservador	conservative
preparar	prepare
suficient	enough
executiu	executive
heroi	hero
insectes	insects
concepció	conception
passos	steps
passos	footsteps
christian	christian
vivia	lived
opera	opera
mecanisme	mechanism
empresari	entrepreneur
empresari	employer
regles	rules
regles	rulers
conservat	preserved
exclusivament	exclusively
xarxes	networks
senyals	signals
senyals	signs
prat	prat
eina	tool
termini	term
alaska	alaska
competir	compete
assistència	assistance
matí	morning
distingir	distinguish
caràcters	characters
indonèsia	indonesia
radical	radical
emmy	emmy
investigacions	investigations
posseeix	possesses
regla	rule
cardona	cardona
desenvolupa	develops
mot	mot
campiona	champion
repartiment	cast
últimes	latest
causes	causes
irlandès	irish
parcialment	partly
parcialment	partially
centenars	hundreds
alternativa	alternative
brown	brown
regidors	councillors
debat	discussion
debat	debate
compromís	engagement
compromís	commitment
absoluta	absolute
aprovat	approved
contes	tales
professió	profession
quantitats	quantities
audiència	audience
suprem	supreme
dama	lady
claude	claude
quadres	tables
existents	existing
estatut	statute
editors	editors
coneixements	knowledge
òrgan	organ
polonès	polish
competicions	competitions
sotmetre	subdue
oklahoma	oklahoma
diumenge	sunday
crònica	chronicle
connexió	connection
equilibri	balance
equilibri	equilibrium
den	den
càmera	camera
pilots	pilots
jaciment	reservoir
drama	drama
estada	stay
cognom	surname
ritme	rhythm
companyies	companies
privat	private
estrangers	foreigners
deixeble	disciple
màquines	machines
sèrbia	serbia
gamma	gamma
avaluació	evaluation
taxa	rate
solitari	lonely
agents	agents
propòsit	purpose
varietats	varieties
esquerre	left
ideal	ideal
pena	penalty
pena	pena
contemporània	contemporary
esperança	hope
tesi	thesis
personalitat	personality
comparació	comparison
errors	bugs
errors	mistakes
éssers	beings
propers	upcoming
museus	museums
pèrsia	persia
aprenentatge	learning
estadística	statistics
pujol	pujol
napoleó	napoleon
debut	debut
matemàtic	mathematician
cultures	cultures
estranger	foreigner
prèviament	previously
mamífers	mammals
petroli	petroleum
enrique	enrique
separat	separated
separat	disjoint
governs	governments
live	live
pacte	covenant
administrador	admin
administrador	administrator
pakistan	pakistan
líquid	liquid
congregació	congregation
àmpliament	widely
reducció	reduction
cònjuge	spouse
margarida	margherita
representacions	representations
tomàs	thomas
dorsal	engine
dorsal	dorsal
carbó	coal
presentat	submitted
presentat	presented
shao	shao
mozart	mozart
bot	bot
urbana	urbana
bons	bonds
teatral	theatrical
gos	dog
pilota	ball
luci	lucius
llinda	lintel
citat	quoted
pic	pic
maó	brick
visual	visual
gris	grey
paràmetres	parameters
víctimes	victims
loira	loire
julià	julian
cinquanta	fifty
arrel	root
filles	daughters
jutge	judge
cerca	search
negocis	business
almirall	admiral
variacions	variations
fronteres	boundaries
fronteres	borders
còpies	copies
forts	strong
transformació	transformation
johnson	johnson
verlag	verlag
wikimedia	wikimedia
creant	creating
molècules	molecules
refugi	shelter
refugi	refuge
brillant	brilliant
neu	snow
associacions	associations
associacions	partnerships
indicar	indicate
electrons	electrons
aleta	fin
tensió	tension
tensió	voltage
batalles	battles
participa	participates
obre	open
masses	masses
considerable	considerable
tradicions	traditions
participat	participated
treballat	worked
regidor	alderman
regidor	councillor
component	component
porter	doorman
porter	goalkeeper
porter	porter
contemporani	contemporary
wilson	wilson
presoner	prisoner
demanda	demand
muller	muller
missa	missa
missa	mass
caterina	catherine
castro	castro
nazi	nazi
traduir	translate
visible	visible
trofeu	trophy
laboratori	laboratory
laboratori	lab
urss	ussr
estils	styles
capelles	chapels
blocs	blocks
càlcul	calculus
càlcul	calculation
abast	scope
hug	hugh
ofensiva	offensive
cau	cau
fleca	bakery
simfonia	symphony
pràctiques	internship
pràctiques	practices
moda	fashion
jorge	jorge
mentrestant	meanwhile
substitució	replacement
petersburg	petersburg
soc	soc
regionals	regional
regionals	regionals
bob	bob
revisió	review
revisió	revision
gil	gil
observatori	observatory
provisional	provisional
infants	children
signatura	signature
llet	milk
dates	dates
nigèria	nigeria
afluent	tributary
colonial	colonial
esforç	effort
combustible	fuel
alan	alan
recorda	remember
rector	rector
nat	nat
francis	francis
desaparició	disappearance
enorme	huge
iso	iso
oliver	oliver
clan	clan
menorca	minorca
menorca	menorca
missouri	missouri
arxipèlag	archipelago
partidaris	loyalists
partidaris	supporters
pietro	pietro
arqueològic	archaeological
sucre	sugar
teorema	theorem
estima	loves
grande	grande
freqüent	frequent
saga	saga
dents	teeth
facilitar	facilitate
oportunitat	chance
lai	lai
acompanyat	accompanied
acompanyat	escorted
afegit	added
designat	designated
trànsit	traffic
garcia	garcia
quina	what
costums	customs
distinció	distinction
implica	implies
marítim	maritime
alonso	alonso
rin	rhine
sofia	sofia
campions	champions
tractats	treaties
sardenya	sardinia
conceptes	concepts
espectacle	show
influències	influences
sous	sous
sous	salaries
significativa	meaningful
cinquena	fifth
bernard	bernard
prats	prats
virtual	virtual
ford	ford
qüestions	issues
montevideo	montevideo
victor	victor
emprat	used
llevat	yeast
fira	fair
pol	pol
estratègia	strategy
sudan	sudan
regent	regent
rellotge	watch
rellotge	clock
disponibles	available
carlo	carlo
semblants	similar
fundadors	founders
radio	radio
gaudí	gaudi
gaudí	gaudí
ricard	ricard
ricard	richard
boston	boston
vicent	vincent
desaparegut	disappeared
desaparegut	missing
membrana	membrane
files	ranks
files	rows
específic	specific
proteïna	protein
precisament	precisely
sainte	sainte
desig	desire
desig	wish
quinze	fifteen
hipòtesi	hypothesis
electrònica	electronics
cafè	coffee
dispositius	devices
prestigi	prestige
pianista	pianist
bill	bill
seixanta	sixty
hollywood	hollywood
conreu	cultivation
conreu	crop
rico	rico
praga	prague
ernest	ernest
crítics	critics
pastor	pastor
cosí	cousin
òrgans	organs
expressar	express
històricament	historically
unep	unep
danys	damage
ratpenat	myotis
bulgària	bulgaria
adam	adam
mostres	samples
substàncies	substances
candidatura	candidacy
candidatura	nomination
números	numbers
variants	variants
aproximació	approximation
individu	individual
magnitud	magnitude
ruiz	ruiz
tall	cutting
wcmc	wcmc
british	british
guionista	screenwriter
mateu	matthew
association	association
observació	observation
viles	villages
viles	vile
teulada	roof
reconstrucció	reconstruction
prefectura	prefecture
riquesa	wealth
mariscal	marshal
esborra	delete
posada	posada
alexandria	alexandria
sobreviure	survive
sobreviure	surviving
renunciar	resign
unanimitat	unanimity
herència	legacy
herència	inheritance
òperes	operas
braços	arms
espera	wait
sorra	sand
vocals	vowels
herba	grass
herba	weed
avantatge	advantage
ivan	ivan
prínceps	princes
greus	serious
long	long
young	young
clàssics	classics
ampliació	extension
segell	stamp
segell	seal
allen	allen
aliat	ally
constantí	constantine
arnau	arnau
classificar	classify
tossal	summit
figueres	figueres
bits	bits
lògica	logic
coloma	coloma
claus	keys
claus	claus
llacs	lakes
varia	varies
síntesi	synthesis
societats	societies
menció	mention
escuts	shields
cúpula	dome
propostes	proposals
argument	argument
màrtir	martyr
hisenda	hacienda
àlbums	albums
mèrit	merit
orientació	guidance
orientació	orientation
ministres	ministers
actitud	attitude
escultures	sculptures
vídua	widowed
vídua	widow
reproducció	reproduction
tipologia	typology
jueu	jewish
jueu	jew
will	will
ambaixador	ambassador
còpia	copy
integrat	integrated
matriu	matrix
existia	existed
proporciona	provides
competència	competition
perruqueria	hairdresser
desconegut	unknown
impossible	impossible
procediment	procedure
constitucional	constitutional
liceu	lyceum
intents	attempts
quaranta	forty
alma	alma
germanes	sisters
variables	variables
gregori	gregory
africà	african
villa	villa
subordo	subordo
quadrats	squares
responsabilitat	liability
responsabilitat	responsibility
youtube	youtube
monarca	monarch
testimoni	witness
testimoni	testimony
temàtica	topic
temàtica	theme
massís	massif
alimentació	food
metalls	metals
taylor	taylor
sostre	roof
proporcionar	provide
avi	grandparent
avi	grandpa
avi	grandfather
orleans	orleans
orleans	orléans
pobres	poor
votació	vote
molecular	molecular
maternal	maternal
pluja	rain
brigada	brigade
típic	typical
judicial	judicial
generar	generate
samuel	samuel
acords	agreements
determinada	determined
rival	rival
pagament	payment
teixits	tissues
bibliografia	bibliography
reaccions	reactions
representat	represented
acadèmic	academic
lorenzo	lorenzo
prússia	prussia
permís	permission
permís	permit
dei	dei
integració	integration
osona	osona
vestit	dress
vestit	suit
marcel	marcellus
marcel	marcel
primària	primary
fòssils	fossils
tones	tons
cerimònia	ceremony
panamà	panama
franz	franz
abella	abella
abella	bee
dispositiu	device
criteri	criterion
compositors	composers
recollir	collect
relacionada	related
condemnat	sentenced
cup	cup
ciclistes	cyclists
triomf	triumph
penya	peña
cultiu	cultivation
cultiu	crop
francs	franks
teologia	theology
mercè	mercè
litoral	coastline
administratiu	administrative
pou	pou
pou	pit
agrupació	grouping
espectadors	spectators
espectadors	viewers
creador	creator
subjecte	subject
artificial	artificial
perspectiva	perspective
candidats	candidates
magdalena	magdalena
carmen	carmen
gegants	giants
banderes	flags
decisions	decisions
canvia	switch
canvia	change
habilitat	skill
habilitat	enabled
ajudant	assistant
ajudant	helper
tripulació	crew
lineal	linear
afirmar	affirm
air	air
etiòpia	ethiopia
tecnologies	technologies
obtingut	obtained
temples	temples
palestina	palestine
literalment	literally
estocolm	stockholm
monjo	monk
assumir	assume
conseqüències	consequences
grammy	grammy
jueva	jewish
xxi	xxi
mascle	male
elisabet	elizabeth
zootaxa	zootaxa
passen	pass
fracàs	failure
atlantic	atlantic
consens	consensus
green	green
maurice	maurice
granota	frog
mapes	maps
restar	subtract
lieja	liège
fidel	faithful
fidel	fidel
madagascar	madagascar
capítols	chapters
redacció	drafting
berguedà	berguedà
fruits	fruits
casal	casal
franja	strip
publicitat	advertising
transformar	transform
conjunts	sets
confiança	trust
marbre	marble
dominar	dominate
record	souvenir
començat	started
interiors	interiors
espinosa	espinosa
descendent	descending
ànima	soul
possibilitats	possibilities
marcat	marked
andrés	andrés
canons	cannons
possessions	possessions
mata	kill
mata	mata
lima	lima
àngels	angels
múrcia	murcia
perruqueries	salons
perruqueries	hairdressers
amateur	amateur
castellana	castellana
descens	downhill
envair	invaded
envair	invade
teixit	tissue
teixit	fabric
abandonat	abandoned
orgue	organ
dvd	dvd
aprovació	approval
ric	rich
desemboca	empties
vegetals	vegetables
preparació	preparation
virgínia	virginia
dominant	dominant
diversitat	diversity
comunistes	communists
gegant	giant
eduardo	eduardo
executat	executed
mataró	mataró
claudi	claudius
derivats	derivatives
joe	joe
joaquín	joaquin
joaquín	joaquín
pamplona	pamplona
doctrina	doctrine
electricistes	electricians
rendiment	performance
rendiment	yield
dipòsit	deposit
integrar	integrate
balaguer	balaguer
assentament	settlement
precisió	precision
precisió	accuracy
ponts	bridges
usant	using
leipzig	leipzig
famosos	famous
famosos	celebrities
mina	mina
mina	mine
creek	creek
biologia	biology
pal	suit
pres	taken
pennsilvània	pennsylvania
indiana	indiana
ubicació	location
femella	female
situacions	situations
ordinadors	computers
cridar	scream
cors	hearts
cors	corsican
documentat	documented
dissolució	dissolution
quadrat	square
pisces	pisces
adreça	address
índies	indies
escollir	choose
gir	twist
dificultat	difficulty
cooperació	cooperation
bíblia	bible
conferències	conferences
mart	mart
mart	mars
segura	segura
oferta	offer
emissió	broadcast
emissió	emission
destruïda	destroyed
animació	animation
editat	edited
trens	trains
cabrera	cabrera
cita	appointment
cotxes	cars
gruix	thick
gruix	thickness
existent	existing
afegeix	add
campo	campo
intercanvi	exchange
consciència	conscience
consciència	consciousness
preses	shots
jackson	jackson
confirmar	confirm
otomans	ottomans
evident	obvious
fortament	strongly
modificacions	modifications
soldat	soldier
acta	acta
relleus	relay
addicionals	additional
signat	signed
capturat	captured
signe	signe
signe	sign
dolor	pain
llenguadoc	languedoc
terminal	terminal
tècnics	technical
tècnics	technicians
ideologia	ideology
espiritual	spiritual
soprano	soprano
metal	metal
absolut	absolute
nba	nba
impostos	taxes
intensitat	intensity
actius	assets
llegat	legacy
millores	improvements
singular	singular
monte	monte
high	high
socialistes	socialists
vendes	sales
reduït	reduced
cinta	tape
granollers	granollers
stephen	stephen
menja	eat
marco	marco
patriarca	patriarch
exercici	exercise
molins	molins
paulo	paulo
díaz	díaz
díaz	diaz
capes	layers
alfonso	alfonso
proporció	ratio
proporció	proportion
vilafranca	vilafranca
freqüents	frequent
ahmad	ahmad
cantar	sing
associada	associated
legislatura	legislature
apartament	apartment
símptomes	symptoms
fases	phases
establerta	established
negoci	business
mars	mars
lewis	lewis
separa	separates
missatges	messages
fam	hunger
rurals	rural
dirigeix	directs
arròs	rice
estable	stable
davis	davis
negociacions	negotiations
perd	loses
inaugurar	inaugurate
rol	role
guarnició	garrison
cadenes	chains
cadenes	strings
torí	turin
iowa	iowa
oviedo	oviedo
circumstàncies	circumstances
dient	saying
biblioteques	libraries
bretó	breton
aventures	adventures
sitges	sitges
sitges	silos
venus	venus
rivera	rivera
separats	separated
guanya	wins
iugoslàvia	yugoslavia
donació	donation
places	squares
continu	continuous
continu	continuum
adolf	adolf
eric	eric
memorial	memorial
revolucionari	revolutionary
canàries	canary
catedràtic	professor
algèria	algeria
hebreu	hebrew
uniforme	uniform
incendi	fire
vives	vives
depressió	depression
substància	substance
sens	sens
mir	mir
cervera	cervera
assalt	assault
investigadors	researchers
seminari	seminary
seminari	seminar
single	single
regulars	regular
roc	ocr
roc	roc
mike	mike
aplica	apply
governant	ruler
oral	oral
minnesota	minnesota
estètica	aesthetics
álvarez	alvarez
anne	anne
assumptes	matters
passió	passion
mater	mater
forn	oven
ray	ray
rendir	surrendering
ones	waves
cao	cao
andrea	andrea
indústries	industries
claustre	cloister
miller	miller
èpoques	eras
repressió	repression
santos	santos
voluntaris	volunteers
himne	hymn
himne	anthem
croàcia	croatia
admissibilitat	admissibility
ana	ana
pascual	pascual
pagès	pagès
springer	springer
parlant	talking
parlant	speaking
legió	legion
puntuació	rating
puntuació	score
ofici	craft
tancs	tanks
bomba	bomb
microsoft	microsoft
marne	marne
nomenament	appointment
pavelló	pavilion
bolívia	bolivia
retrats	portraits
pilars	pillars
cadis	cádiz
amant	lover
restaurar	restore
segarra	segarra
matemàtica	maths
matemàtica	mathematics
matemàtica	math
quedant	staying
pacients	patients
gasos	gases
destí	destiny
kong	kong
subsp	subsp
cichlids	cichlids
ciudad	ciudad
asteroides	asteroids
exactament	exactly
maryland	maryland
pèrdues	losses
traduccions	translations
convenció	convention
consells	tips
elevació	elevation
enginyers	engineers
mòdul	module
intervenir	intervene
corba	curve
fulla	leaf
cordes	ropes
maine	maine
creix	grows
hoquei	hockey
setanta	seventy
silva	silva
dieta	diet
mundo	mundo
indi	indian
indi	indi
continuïtat	continuity
istat	istat
césar	césar
talla	cut
designar	designate
empúries	empúries
anti	anti
planetes	planets
confondre	confuse
inicials	initials
rellevant	relevant
anvers	antwerp
agències	agencies
delegació	delegation
rené	rené
solucions	solutions
inspiració	inspiration
berlin	berlin
cantons	cantons
integral	integral
geometria	geometry
ferits	injured
ferits	wounded
rutes	routes
steve	steve
beneficis	benefits
wilhelm	wilhelm
vega	vega
essencial	essential
moro	moro
colorado	colorado
bestiar	cattle
dramàtica	dramatic
compra	purchase
compra	buy
dialecte	dialect
gat	cat
professors	teachers
vents	winds
originari	originating
amenaçada	threatened
liberals	liberals
angles	angles
drac	dragon
union	union
governació	governorate
rugbi	rugby
ací	here
milió	million
hawaii	hawaii
empresonat	imprisoned
classificacions	classifications
típica	typical
convèncer	convince
txeca	czech
bacteris	bacteria
adaptar	adapt
fiscal	prosecutor
kansas	kansas
tub	tube
java	java
oliva	oliva
patrick	patrick
identificació	identification
bbc	bbc
tombes	graves
cervell	brain
herbert	herbert
tèxtil	textile
lluites	struggles
devia	owed
julio	julio
àtoms	atoms
múscul	muscle
júpiter	jupiter
mobles	furniture
eva	eva
acompanyar	accompany
organitza	organizes
nil	nil
nil	nile
químics	chemists
químics	chemicals
casas	houses
casas	casas
interacció	interaction
incorpora	incorporates
directors	directors
arizona	arizona
douglas	douglas
recta	straight
botànic	botanist
anualment	annually
arquitectes	architects
entrades	tickets
trobades	encounters
ciutadella	citadel
propaganda	propaganda
formalment	formally
chris	chris
abundant	abundant
tòquio	tokyo
manifest	manifesto
enfrontament	showdown
repertori	repertoire
iguals	equals
gordon	gordon
canviat	changed
commons	commons
irregular	irregular
eivissa	ibiza
localitats	localities
sena	sena
sena	seine
lawrence	lawrence
luigi	luigi
volien	wanted
ribes	ribes
mira	look
pressupost	budget
argentí	argentine
manchester	manchester
observacions	comments
esfera	sphere
tancament	closure
bàsics	basic
aviació	aviation
intern	internal
forat	hole
brian	brian
batalló	battalion
montjuïc	montjuïc
sam	sam
modernista	modernist
córrer	run
natació	swimming
impuls	impulse
impuls	momentum
cares	faces
patrons	patterns
caire	cairo
narrativa	narrative
militant	militant
azerbaidjan	azerbaijan
rànquing	ranking
rànquing	rankings
captura	capture
extern	external
pirates	pirates
destruït	destroyed
compartir	share
igualada	igualada
progrés	progress
recórrer	resorting
tempesta	storm
olot	olot
tanca	close
tanca	fence
video	video
popularment	popularly
dimensió	dimension
wagner	wagner
plaques	plates
anells	rings
civilització	civilization
urbanització	urbanization
stalin	stalin
url	url
resistir	resist
esquema	scheme
esquema	outline
esquema	schema
gros	gros
protocol	protocol
deessa	goddess
pons	pons
proximitat	proximity
cobertes	covered
cobertes	decks
vèncer	defeating
mac	mac
houten	houten
otto	otto
afectar	affect
organista	organist
fragment	fragment
humor	mood
humor	humour
creuer	cruise
rellevància	relevance
ballet	ballet
començant	starting
compon	compose
instruccions	instructions
xipre	cyprus
igualtat	equality
manifestacions	demonstrations
gilbert	gilbert
progressivament	progressively
limitat	limited
vincent	vincent
rotació	rotation
gossos	dogs
jugant	playing
inscripcions	inscriptions
representada	represented
contribucions	contributions
films	films
operatiu	operational
proposa	proposes
mòbil	mobile
excavacions	excavations
costum	habit
detingut	arrested
uefa	uefa
gravetat	gravity
lema	motto
baronia	barony
anoia	anoia
roberto	roberto
classis	classis
dits	fingers
doctorat	phd
horitzontal	horizontal
campament	camp
contrast	contrast
delegat	delegate
capaços	capable
noi	boy
legislació	legislation
austríac	austrian
anton	anton
nicolas	nicolas
gòtica	gotham
fortuna	fortune
sòlid	solid
guatemala	guatemala
arqueologia	archaeology
calcular	calculate
coves	caves
mesquita	mosque
equacions	equations
façanes	facades
harold	harold
electricitat	electricity
detectar	detect
vaga	strike
característic	characteristic
jacob	jacob
march	march
egipci	egyptian
rcd	rcd
experiments	experiments
entrenament	training
entrenament	workout
seguiment	tracking
descobreix	discover
periodisme	journalism
posant	putting
fox	fox
vaticà	vatican
tenor	tenor
bwv	bwv
fòrum	forum
escales	stairs
escales	scales
quartet	quartet
aràbia	arabia
mecanismes	mechanisms
comentari	comment
infància	childhood
triangle	triangle
reserves	reservations
insecte	insect
musulmà	muslim
ucraïnès	ukrainian
projecció	projection
suís	swiss
determinats	certain
ptolemeu	ptolemy
proclamat	proclaimed
leopold	leopold
subfamília	subfamily
sultan	sultan
dirigents	leaders
gabinet	cabinet
deportivo	deportivo
pit	chest
facilitat	ease
facilitat	facilitated
bartomeu	bartholomew
cobertura	coverage
bosch	bosch
jim	jim
ferit	hurt
fusionar	merge
howard	howard
plus	plus
conversió	conversion
concessió	concession
llistat	listing
freda	freda
experts	experts
extensa	extensive
discos	disks
isaac	isaac
visir	vizier
franc	franc
hongarès	hungarian
duquessa	duchess
variació	variation
jurat	jury
bull	bull
àcids	acids
receptor	receptor
receptor	receiver
barrera	barrera
barrera	barrier
roses	roses
atlético	atlético
columbia	columbia
demostrat	demonstrated
associats	associates
viola	viola
escocès	scots
aparells	appliances
pensa	think
pensa	thinks
tarda	afternoon
poetes	poets
aliment	sustenance
addicional	additional
passatgers	passengers
htm	htm
plat	dish
rambla	rambla
ibrahim	ibrahim
alcohol	alcohol
martorell	martorell
frankfurt	frankfurt
definit	defined
definit	definite
song	song
classificat	classified
raigs	rays
victoria	victoria
mantenint	keeping
mantenint	maintaining
olympic	olympic
especialitzat	specialized
denis	denis
configuració	setup
configuració	configuration
alliberat	freed
adoptat	adopted
llop	wolf
danès	danish
realitzen	perform
evidència	evidence
sydney	sydney
versos	verses
protectorat	protectorate
doblada	dubbed
marines	marines
explicació	explanation
globe	globe
xinesos	chinese
derivat	derivative
lent	lens
lent	slow
anthony	anthony
adult	adult
finca	finca
sisè	sixth
directora	director
creus	crosses
manuscrit	manuscript
tretze	thirteen
vuitanta	eighty
ginebra	geneva
philippe	philippe
desconeguda	unknown
estabilitat	stability
navarro	navarro
testimonis	witnesses
calais	calais
expressa	expresses
negativa	refusal
kenya	kenya
mahmud	mahmud
víctima	victim
priorat	priorat
correspondència	correspondence
expulsat	expelled
expulsat	ejected
experimental	experimental
trama	plot
afganistan	afghanistan
espines	thorns
brasiler	brazilian
dependències	units
dependències	dependencies
broadway	broadway
immigrants	immigrants
verds	greens
bou	bou
típicament	typically
jornada	day
especialista	specialist
circulació	circulation
síndrome	syndrome
cronologia	timeline
croada	crusade
impressió	impression
impressió	printing
pagesos	peasants
terror	terror
ricardo	ricardo
une	une
russell	russell
obrer	workman
rovira	rovira
paisatges	landscapes
adams	adams
reduïda	reduced
atorgat	granted
janeiro	janeiro
instrucció	instruction
faria	faria
damasc	damascus
descendència	offspring
metges	doctors
ripoll	ripoll
refugiats	refugees
crema	burn
crema	cream
pseudònim	pseudonym
tresor	treasure
lea	lea
assentaments	seats
marta	marta
ossos	bones
lorena	lorena
lorena	lorraine
medina	medina
dipòsits	deposits
afecta	affects
exploració	exploration
exploració	scan
tervuren	tervuren
generacions	generations
conques	basins
heinrich	heinrich
federico	federico
funcionaris	officials
agulla	needle
genètica	genetics
probabilitat	probability
parròquies	parishes
suposadament	supposedly
privilegis	privileges
comerciants	traders
centro	centro
harmonia	harmony
esquena	back
declarada	declared
permès	allowed
dibuixant	cartoonist
interpreta	interprets
eliminació	removal
eliminació	elimination
astronomia	astronomy
istanbul	istanbul
alabama	alabama
plural	plural
barberà	barberà
ignasi	ignasi
conte	conte
sobrenom	nickname
pregunta	question
visites	visits
clients	customers
clients	clients
adaptat	adapted
ramaderia	livestock
resultant	resulting
dedica	dedicates
dedica	devotes
pendent	pending
gènova	genoa
dissenys	designs
espectacles	shows
caucas	caucasus
nacionalisme	nationalism
tailàndia	thailand
inaugurat	inaugurated
promesa	engaged
rey	rey
dita	dita
paràmetre	parameter
àmbits	areas
beta	beta
sri	sri
aventura	adventure
carib	caribbean
holanda	holland
transferència	transfer
transferència	transference
produccions	productions
enviats	sent
arguments	arguments
esquí	skiing
duresa	hardness
georg	georg
residents	residents
ombra	shadow
magnètic	magnetic
virrei	viceroy
parcs	parks
renovació	renewal
multitud	crowd
concedit	granted
maresme	maresme
pistes	tracks
bois	bois
preus	prices
desembocadura	mouth
christopher	christopher
racing	racing
llicenciat	graduate
parlat	spoken
muntatge	mounting
taques	spots
derivada	derivative
iniciat	started
ocupant	occupying
residus	waste
documentada	documented
crimea	crimea
sagrat	sacred
tunísia	tunisia
mercats	markets
externa	external
aux	aux
consellers	counselors
zool	zool
fischer	fischer
cugat	cugat
moreno	moreno
originàriament	originally
transmetre	transmit
habitació	room
dan	dan
memòries	memoirs
pour	pour
participant	participant
triple	triple
extremadament	extremely
reconeix	recognizes
reconeix	acknowledge
far	lighthouse
vinya	vineyard
monestirs	monasteries
portaveu	spokesperson
llull	llull
servidor	server
moore	moore
coronat	crowned
molècula	molecule
dublín	dublin
llinatge	lineage
bàsic	basic
inspirat	inspired
introduït	introduced
mínima	minimal
específics	specific
col	cabbage
col	col
hernández	hernández
hernández	hernandez
assassinats	murders
visitants	visitors
paraguai	paraguay
vela	candle
vela	sailing
balcó	balcony
vídeos	videos
talent	talent
talent	talented
fidels	loyal
casament	wedding
toscana	tuscany
manel	manuel
manel	manel
manuscrits	manuscripts
cornisa	ledge
luna	luna
venut	sold
constància	perseverance
anuals	annual
màlaga	málaga
màlaga	malaga
elementals	elemental
reputació	reputation
semifinals	semifinals
rodatge	shooting
ateneu	ateneo
triat	chose
mides	sizes
orgànica	organic
emilio	emilio
virtut	virtue
european	european
php	php
mexicà	mexican
florals	floral
platges	beaches
ciutadà	citizen
periòdic	newspaper
benefici	benefit
espectre	spectrum
supervivència	survival
específicament	specifically
inversió	inversion
inversió	investment
suggereix	suggest
suggereix	suggests
fenòmens	phenomena
fenòmens	freaks
ciutadania	citizenship
positiu	positive
oriol	oriol
traçat	tracing
granja	farm
laura	laura
vegetal	vegetable
habilitats	abilities
habilitats	skills
somni	dream
golfes	attic
polèmica	controversy
trinitat	trinity
trinitat	trinidad
index	index
pokémon	pokémon
camerun	cameroon
banu	banu
leonardo	leonardo
picasso	picasso
bagdad	baghdad
parma	parma
kíev	kiev
marsella	marseille
simetria	symmetry
road	road
client	client
vigo	vigo
rebel	rebel
extractives	extractive
departaments	departments
freqüentment	frequently
llit	bed
accedit	accessed
creure	believe
solsona	solsona
felipe	felipe
mantingut	kept
experiment	experiment
tauler	dashboard
tauler	board
muñoz	muñoz
sonata	sonata
baden	baden
sessió	session
sessió	meeting
alumne	student
otó	oto
còrsega	corsica
poblet	poblet
castellar	castellar
fonamentalment	fundamentally
pals	pals
pals	sticks
ros	ros
fleques	bakeries
sepultura	grave
who	who
relats	stories
narcís	narcissus
pèl	hair
harvard	harvard
niça	nice
adrià	hadrian
nadius	natives
taronja	orange
percentatge	percentage
percentatge	percent
blues	blues
manifestació	demonstration
altament	highly
bruce	bruce
recurs	appeal
recurs	resource
permetent	allowing
lector	reader
republicans	republicans
eliminat	deleted
eliminat	removed
ordenat	ordained
ordenat	ordered
perfectament	perfectly
monumental	monumental
acollir	hosting
aportar	provide
budapest	budapest
ter	ter
reflecteix	reflect
aparegut	appeared
activament	actively
honors	honours
honors	honors
noies	girls
incorporació	incorporation
egipcis	egyptians
valle	valle
conclusió	conclusion
manga	manga
modalitat	mode
aparentment	apparently
contactes	contacts
còmics	comics
favorable	favourable
favorable	favorable
ram	ram
senegal	senegal
allah	allah
hugo	hugo
african	african
mestra	teacher
pre	pre
balcons	balconies
marshall	marshall
non	non
ernst	ernst
feble	weak
profund	deep
aprovada	approved
psicologia	psychology
confusió	confusion
circuits	circuits
feudal	liege
croats	croats
forats	holes
land	land
llegendes	legends
ambaixada	embassy
cala	cala
modificació	modification
efectiu	cash
efectiu	effective
minoria	minority
aragonès	aragonese
rose	rose
diàleg	dialogue
magistrat	magistrate
hospitalet	hospitalet
ann	ann
viva	viva
normandia	normandy
gravats	engravings
àudio	audio
gramàtica	grammar
esperava	awaited
vigilància	surveillance
referèndum	referendum
socis	partners
centímetres	centimeters
infecció	infection
delhi	delhi
fàbriques	factories
raymond	raymond
sentència	judgment
definida	definite
tendències	trends
lucas	lucas
foment	foment
antoine	antoine
llança	spear
quercus	quercus
protagonistes	protagonists
valencia	valencia
quint	quintus
vestits	dresses
out	out
ludwig	ludwig
arena	arena
sorpresa	surprise
krasnodar	krasnodar
altiplà	plateau
reunions	meetings
explosió	explosion
rasa	rasa
lideratge	leadership
fruita	fruit
construïts	constructed
demostració	demo
demostració	demonstration
humitat	humidity
centra	center
lió	lyon
tela	cloth
personalitats	personalities
perdent	losing
comissari	commissioner
bòsnia	bosnia
informes	reports
angola	angola
atp	atp
suau	soft
suau	smooth
poderós	mighty
poderós	powerful
tronc	trunk
identificat	identified
ocupen	occupy
negociar	negotiate
bancs	banks
regència	regency
defensor	defender
superfícies	surfaces
expulsió	expulsion
nazis	nazis
bohèmia	bohemia
guitarrista	guitarist
terratrèmol	earthquake
estàtues	statues
aportació	input
aportació	contribution
túnel	tunnel
eulàlia	eulalia
guerrers	warriors
competències	skills
competències	powers
experiències	experiences
tsar	tsar
infraclassis	infraclassis
atletisme	athletics
proporcions	proportions
aportacions	contributions
enfrontaments	clashes
alejandro	alejandro
orange	orange
setze	sixteen
fil	fil
fil	thread
malta	malta
júnior	junior
sentiment	feeling
directiva	directive
vital	vital
laurent	laurent
accepta	accepts
accepta	accept
trasllat	transfer
equatorial	equatorial
finances	finance
dependència	dependency
desplaçament	displacement
desplaçament	offset
dinàmica	dynamic
japan	japan
cantonada	corner
milles	miles
cercles	circles
auxiliar	auxiliary
fresc	fresh
presidents	presidents
coordinació	coordination
formacions	ensembles
formacions	formations
tractaments	treatments
opcions	options
quilòmetre	kilometre
paolo	paolo
corrupció	corruption
alfa	alpha
conrad	conrad
disminució	decrease
montcada	montcada
interfície	interface
pintat	painted
canes	canes
canes	cannes
fang	fang
reconstruir	rebuild
considerablement	considerably
obrers	workers
kennedy	kennedy
tinguin	have
turons	hills
anal	anal
galeries	galleries
activista	activist
prado	prado
parker	parker
toni	toni
sessions	sessions
concloure	conclude
mongols	mongols
governadors	governors
copenhaguen	copenhagen
veí	neighbour
veí	neighbor
receptors	receivers
mariano	mariano
fabricant	manufacturer
contenir	contain
incident	incident
pàtria	homeland
pàtria	fatherland
velocitats	speeds
elizabeth	elizabeth
enzim	enzyme
mental	mental
edificació	building
despeses	expenses
oregon	oregon
religions	religions
opinions	feedback
cria	breeding
corredor	runner
corredor	corridor
incorporat	incorporated
publi	publius
prosa	prose
significatiu	meaningful
louisiana	louisiana
contaminació	pollution
necessàries	necessary
creences	beliefs
colonització	colonization
bàsiques	basic
codis	codes
destinació	destination
destinació	destiny
assistent	assistant
assistent	wizard
líbia	libya
garriga	garriga
osca	huesca
malàisia	malaysia
garrotxa	garrotxa
ottawa	ottawa
minut	minute
psc	psc
tennessee	tennessee
demogràfica	demographic
bailey	bailey
catorze	fourteen
maurici	mauritius
cròniques	chronicles
festivitat	festivity
suite	suite
gra	grain
gra	gra
alumini	aluminium
alumini	aluminum
fide	fide
xifres	figures
wolfgang	wolfgang
processó	procession
rics	rich
foix	foix
melle	melle
reforçar	strengthen
teatres	theaters
comporta	behaves
cross	cross
escorça	bark
llibreria	bookstore
liu	liu
enregistrament	recording
evangeli	gospel
flauta	flute
conducta	conduct
transcripció	transcription
transcripció	transcript
pacient	patient
sibèria	siberia
ivori	ivory
arnold	arnold
salvatge	wild
salvatge	savage
diplomàtic	diplomat
mexicana	mexicana
weber	weber
cinturó	belt
posen	posen
plats	dishes
bassa	raft
comitès	committees
races	breeds
test	test
party	party
essencialment	essentially
infraordo	infraordo
sisena	sixth
nebraska	nebraska
flamenc	flamenco
flamenc	flemish
extracció	extraction
varsòvia	warsaw
down	down
franquisme	francoism
mercuri	mercury
teula	teja
personalment	personally
mèdica	medical
cabal	flow
about	about
ordenació	sorting
cartago	carthage
setè	seventh
monges	nuns
oposat	opposite
hàbitats	habitats
myers	myers
sinònim	synonym
castillo	castillo
parells	peers
parells	pairs
endèmica	endemic
puntes	lace
fra	fra
representava	pictured
rao	rao
sentiments	feelings
acceptat	accepted
prim	prim
avançada	advanced
estretament	closely
sòls	soils
sòls	floors
discussions	discussions
vides	lives
expedicions	expeditions
primo	primo
finançament	financing
finançament	funding
plom	lead
cota	cota
ment	mind
zuric	zürich
zuric	zurich
fotògraf	photographer
canviant	changing
disney	disney
wii	wii
òptica	optics
penal	criminal
newton	newton
estrany	strange
dalmau	dalmau
hamilton	hamilton
líban	lebanon
polar	polar
hammond	hammond
murray	murray
consolidar	consolidate
consolidar	consolidating
blog	blog
cereals	cereals
cereals	cereal
pitjor	worst
traductor	translator
emirat	emirate
aleksandr	aleksandr
lleuger	slight
lleuger	lightweight
resident	resident
jugat	played
bolonya	bologna
emmagatzematge	storage
militants	atheists
militants	militants
saturn	saturn
toca	tap
uicn	iucn
jiménez	jiménez
funcional	functional
verb	verb
sport	sport
renom	renowned
renom	renown
temporalment	temporarily
assessor	adviser
independentment	regardless
formatge	cheese
shakespeare	shakespeare
cridat	screamed
cridat	called
tenerife	tenerife
quebec	quebec
ciceró	cicero
sencer	whole
citar	cite
franklin	franklin
bombardeig	bombardment
ducs	dukes
stuttgart	stuttgart
classificats	classified
jonathan	jonathan
solista	soloist
campus	campus
vector	vector
aixecament	lifting
algorisme	algorithm
metre	meter
abraham	abraham
etiqueta	label
poètica	poetic
duran	duran
duran	durán
pen	pen
hola	hello
plenament	fully
segre	segre
billy	billy
primitiu	primitive
parents	relatives
sigles	acronym
redueix	reduces
socks	socks
malalt	sick
beethoven	beethoven
creença	belief
grant	grant
athletic	athletic
avantatges	advantages
avantatges	pros
utah	utah
vari	vario
morter	mortar
defensors	defenders
ross	ross
molina	molina
cotó	cotton
emplaçament	placement
emplaçament	location
sporting	sporting
antena	antenna
juntes	boards
apple	apple
crèdits	credits
convocar	convene
gerard	gerard
stanley	stanley
seda	silk
narra	narrates
creats	created
panorama	panorama
connecta	connect
bombes	pumps
bombes	bombs
faraó	pharaoh
calci	calcium
sonda	probe
dissabte	saturday
lectors	readers
academia	academy
bec	bec
adequada	adequate
aletes	fins
hispània	hispania
aguilar	aguilar
estònia	estonia
territorials	territorial
quelcom	something
notació	notation
clark	clark
nitrogen	nitrogen
main	main
kelly	kelly
botànica	botany
reflexió	reflection
pasqua	passover
màrtirs	martyrs
cnt	cnt
distàncies	distances
escenaris	scenarios
oberts	open
requisits	requirements
convergència	convergence
rebuig	rejection
corneli	cornelius
hermann	hermann
dissoldre	dissolve
opus	opus
protestes	protests
modifica	modify
regulació	regulation
simultàniament	simultaneously
pequín	beijing
administradors	admins
realisme	realism
fita	cairn
eixos	axes
benjamin	benjamin
convidat	guest
lincoln	lincoln
somàlia	somalia
polonesa	polonaise
defecte	defect
lleialtat	loyalty
demòcrata	democrat
issn	issn
matèries	materials
periodistes	journalists
germain	germain
berga	berga
córdoba	córdoba
instrumental	instrumental
armeni	armenian
soroll	noise
off	off
armament	weaponry
mel	honey
morgan	morgan
consort	consort
planificació	planning
islàndia	iceland
perfecte	perfect
charlie	charlie
retorna	returns
armat	armed
guy	guy
localitzat	localised
localitzat	localized
kim	kim
queensland	queensland
documentals	documentaries
discs	disks
considerades	considered
adquirit	acquired
protesta	protest
noruec	norwegian
rarament	rarely
modes	modes
negatiu	negative
meta	meta
extrema	extreme
successivament	successively
ahmed	ahmed
islàmic	islamic
filial	subsidiary
míssils	missiles
som	som
fonaments	fundamentals
glòria	gloria
glòria	glory
bloqueig	locking
bloqueig	lock
assolit	reached
camperols	peasants
gràfics	graphics
constants	constant
astrònom	astronomer
ambiental	environmental
helena	helena
europe	europe
respon	reply
für	für
pins	pines
contraforts	spurs
eta	eta
recollida	pickup
recollida	collection
trastorns	disorders
ghana	ghana
relíquies	relics
alex	alex
produint	producing
lanka	lanka
canadenc	canadian
físics	physicists
utilitat	utility
dell	dell
estàndards	standards
orelles	ears
restaurat	restored
positiva	positive
norman	norman
establint	establishing
malalts	sick
fina	fina
fina	thin
exposar	expose
càmeres	cameras
fabra	fabra
trio	trio
iemen	yemen
divendres	friday
aproximada	fuzzy
circ	circus
corpus	corpus
islàmica	islamic
potent	powerful
barça	barça
creta	crete
garona	garonne
dramaturg	playwright
influenciat	influenced
àrbitre	referee
visibles	visible
amiga	amiga
conductor	driver
galàxies	galaxies
volcà	volcano
ferides	wounds
intèrpret	interpreter
casc	helmet
oficis	trades
divina	divine
ltd	ltd
tribú	tribune
determina	determines
practicar	practise
orbital	orbital
combina	combines
realitzant	performing
aparent	apparent
suspensió	suspension
alsàcia	alsace
alternatiu	alternative
alternatiu	alternate
governants	rulers
nevada	nevada
toronto	toronto
escollida	chosen
latm	latm
bastida	scaffolding
analitzar	analyze
leo	leo
robin	robin
longm	longm
coet	rocket
abundants	abundant
accent	accent
pilastres	pilasters
deixebles	disciples
controvèrsia	controversy
controvèrsia	dispute
alí	ali
fidelitat	fidelity
focus	focus
emperadriu	empress
blanco	blanco
pura	pure
queen	queen
vermells	reds
lesió	injury
lesió	lesion
roland	roland
operador	operator
simó	simon
crim	crime
dionís	dionysus
dionís	dionysius
sans	sans
mite	myth
mer	mer
enzims	enzymes
inspecció	inspection
barroca	baroque
productors	producers
càrregues	loads
zeus	zeus
suárez	suarez
directes	direct
frases	phrases
frases	sentences
estel	star
barbara	barbara
cercador	seeker
requereixen	require
acceptació	acceptance
mari	mari
semicircular	semicircular
plàstic	plastic
malament	wrong
donald	donald
enfocament	approach
expressions	expressions
tanzània	tanzania
extremadura	extremadura
guanyadora	winner
confluència	confluence
núvols	clouds
dewey	dewey
telescopi	telescope
dissenyada	designed
pròleg	prologue
zhang	zhang
bros	bros
dimitir	resign
conselleria	counseling
útils	helpful
profundament	deeply
jutjat	courthouse
bengala	bengal
reconeguts	recognized
convencional	conventional
consideració	consideration
procediments	procedures
gradualment	gradually
pobre	poor
fantasia	fantasy
mongòlia	mongolia
prohibició	prohibition
adquisició	acquisition
optar	opt
restaurada	restored
quins	what
extra	extra
interpretacions	interpretations
cable	wire
cable	cable
afrique	afrique
blasco	blasco
especialitat	specialty
barres	bars
músculs	muscles
lunar	lunar
mons	mons
lesions	injuries
dominació	domination
abc	abc
educatiu	educational
garrigues	garrigues
automàticament	automatically
violinista	fiddler
radicals	radicals
johnny	johnny
capacitats	capabilities
dissenyador	designer
asteroide	asteroid
beat	beat
elena	elena
roberts	roberts
qualitats	qualities
porc	pig
solidaritat	solidarity
maçoneria	masonry
kevin	kevin
pluges	rains
innovació	innovation
secretaria	secretariat
legals	legal
barca	barca
ortografia	spelling
roy	roy
complexes	complex
nois	boys
nois	guys
atemptat	assassination
dictador	dictator
jurista	jurist
wang	wang
disciplines	disciplines
conflent	conflent
prima	cousin
anarquista	anarchist
presos	prisoners
preguntes	questions
nena	nena
teu	yours
hessen	hesse
afectat	concerned
regularment	regularly
avançat	advanced
alessandro	alessandro
extens	extensive
neteja	clear
neteja	cleaning
supercopa	supercopa
disparar	shoot
jules	jules
disposats	willing
jaime	jaime
afluents	tributaries
causant	deceased
supervivents	survivors
malik	malik
mora	mora
galàxia	galaxy
complexitat	complexity
biografies	biographies
edificacions	buildings
cremar	burn
culpa	guilt
sodi	sodium
defenses	defenses
barret	hat
unión	unión
forestal	forestry
elx	elche
níger	niger
nepal	nepal
processament	processing
estimat	loved
giacomo	giacomo
financer	financial
soci	partner
grahamstown	grahamstown
like	like
comparteix	share
sabia	knew
romanès	romanian
esparta	sparta
fongs	fungi
renovar	renew
johannes	johannes
economista	economist
rossini	rossini
diferenciar	differentiate
seguí	followed
cantants	singers
traïció	treason
paco	paco
estrictament	strictly
roser	roser
leftarm	leftarm
censura	censorship
combustió	combustion
niem	niem
koch	koch
comprensió	understanding
seqüències	sequences
investigar	investigate
calcula	calculate
pantà	swamp
pantà	marsh
carlemany	charlemagne
revelar	reveal
fitxers	files
mit	mit
fortaleses	fortresses
serrano	serrano
taxes	fees
txec	czech
modernisme	modernism
serres	serres
aïllat	isolated
necessàriament	necessarily
rehabilitació	rehabilitation
veient	watching
immigració	immigration
hab	viv
tracte	deal
protestant	protestant
partidari	supporter
dame	dame
casals	casals
festivals	festivals
obtenció	obtaining
minor	minor
jutges	judges
montana	montana
mercaderies	goods
mercaderies	freight
filip	filip
caritat	charity
ions	ions
avís	warning
filologia	philology
alice	alice
melodia	melody
elèctrics	electrical
frederick	frederick
vanguardia	vanguard
hemisferi	hemisphere
vera	vera
ruptura	breakup
costos	costs
infraestructures	infrastructure
infraestructures	infrastructures
facebook	facebook
veïna	neighbor
sanç	sancho
decidit	decided
normals	normal
campana	bell
félix	félix
havana	havana
lligues	leagues
teòric	theoretical
rec	rec
centenari	centenary
