bones	bones
bones	buto
css	css
cox	cox
consequences	kahihinatnan
circulation	sirkulasyon
butterfly	butterfly
hugo	hugo
abolished	abolished
algeria	algeria
edu	edu
armies	armies
separation	paghihiwalay
spy	spy
cliff	bangin
cliff	cliff
technically	technically
reactions	reaksyon
lithuanian	lithuanian
trick	trick
curve	curve
curve	liko
horizontal	pahigang
horizontal	pahalang
legends	legends
enzyme	enzyme
freight	kargada
freight	kargamento
hydrogen	hydrogen
viii	viii
caroline	caroline
pull	hilahin
plymouth	plymouth
twentieth	twentieth
cuts	biyak
catalog	katalogo
catalog	catalog
dale	dale
synthesis	sintesis
rape	panggagahasa
seoul	seoul
engagement	engagement
coin	barya
coin	coin
lucy	lucy
consequently	consequently
platinum	platinum
twins	kambal
memories	alaala
robertson	robertson
anthology	anthology
milton	milton
geological	geological
dinner	hapunan
hosting	hosting
thriller	thriller
retreat	retiro
retreat	retreat
albany	albany
abdul	abdul
ignore	pansinin
ignore	ignore
ignore	balewalain
migration	paglilipat
migration	migration
carefully	maingat
magnitude	magnitude
sudan	sudan
duration	tagal
henderson	henderson
explorer	explorer
marco	marco
fusion	fusion
aids	aids
gathered	inipon
gathered	kapnayan
reflected	naaninag
afraid	natatakot
presbyterian	presbyterian
automobile	sasakyan
pound	libra
pound	pound
allegedly	daw
delay	delay
developers	developers
semifinals	semifinals
belfast	belfast
arctic	arctic
kurt	kurt
windsor	windsor
assumption	palagay
plates	plates
plates	plato
fourteen	katorse
nominee	nominee
disruption	pagkaputol
monroe	monroe
hearts	hearts
victories	pagkapanalo
extending	pagpapalawak
pale	pale
pursuit	pursuit
glory	glory
glory	luwalhati
glory	kaluwalhatian
destroyer	destroyer
deeply	malalim
lectures	lektura
affiliate	kaakibat
affiliate	affiliate
affiliate	kaanib
preston	preston
deceased	namayapa
deceased	namatay
speaks	nagsasalita
gathering	pagtitipon
angry	magalit
angry	galit
angry	nagagalit
enrolled	enroll
configuration	configuration
configuration	pagsasaayos
brad	brad
skill	skill
skill	kasanayan
skill	kakayahan
intense	matinding
tasmania	tasmania
commitment	pangako
loved	minamahal
uruguay	uruguay
napoleon	napoleon
confirm	kumpirmado
confirm	kumpirmahin
breed	lahi
auxiliary	auxiliary
enabled	pinapagana
enabled	pinagana
discography	discography
licence	lisensya
licence	licence
adrian	adrian
pipe	pipe
pipe	tubo
karen	karen
altered	nagpabago
budapest	budapest
designers	designer
heir	tagapagmana
advisor	tagapayo
illustrate	illustrate
authorized	pinahintulutan
hide	itago
announcement	pagpapahayag
compact	compact
tissue	tissue
particles	particles
receiver	pinadalhan
receiver	tatanggap
receiver	receiver
civilians	sibilyan
marsh	marsh
vinyl	vinyl
delayed	delayed
delayed	naantala
wednesday	miyerkules
checking	checking
checking	tinitingnan
checking	tinitignan
chilean	chilean
hey	oy
chambers	chambers
demo	demo
demo	pagpapakita
ahmad	ahmad
santos	santos
paying	nagbabayad
submit	magsumite
desired	desired
followers	tagasunod
observatory	obserbatoryo
springfield	springfield
kit	kit
burton	burton
monarch	monarch
observations	obserbasyon
beetle	salagubang
promised	pinangako
promised	nangako
promised	ipinangako
promised	nangakong
palomar	palomar
cream	cream
presenter	naghahandog
potter	potter
favourite	favourite
transformation	pagbabagong
transformation	transformation
mcdonald	mcdonald
bavaria	bavaria
kumar	kumar
mixture	halo
browser	browser
endangered	endangered
mate	mate
lyon	lyon
illustration	illustration
kyle	kyle
afl	afl
brook	brook
geometry	heometriya
ping	ping
extends	nagpalawak
variants	variants
baroque	baroque
iso	iso
collapsed	collapsed
jake	jake
hopes	aasa
cornell	cornell
servant	lingkod
kenny	kenny
hurt	nasaktan
maker	maker
inline	inline
carlo	carlo
lynn	lynn
stability	katatagan
imposed	ipapatupad
imposed	ipataw
confusing	nakakalito
joel	joel
jets	jets
logos	logo
vital	mahalaga
vital	vital
malcolm	malcolm
winnipeg	winnipeg
kilometers	kilometro
songwriters	songwriters
buddhism	budismo
nose	ilong
respected	tinitingala
respected	iginagalang
respected	irespeto
pace	pace
thunder	kulog
centered	centered
bolivia	bolivia
forget	kalimutang
forget	kalimutan
forget	makakalimutan
implies	nagpapahiwatig
crops	pananim
crops	tanim
halifax	halifax
toll	toll
monk	monk
extraordinary	extraordinary
lessons	lessons
pub	pub
paralympics	paralympics
monte	monte
segments	segments
deer	usa
wireless	wireless
mysterious	misteryosong
mysterious	mahiwaga
consultant	consultant
fraser	fraser
jam	jam
chicken	chicken
chicken	manok
enable	paganahin
idol	idol
reid	reid
amazing	amazing
pet	pet
pet	alaga
upset	naiinis
loves	loves
nominate	nominate
striker	striker
accidentally	sinasadyang
louisville	louisville
hopkins	hopkins
eds	eds
goddess	diwata
goddess	diyosa
goddess	dyosa
resumed	naipagpatuloy
voltage	boltahe
betty	betty
marion	marion
geology	geology
cyclone	cyclone
export	export
lightning	kidlat
lightning	lightning
impressed	namangha
maintains	nagpapanatili
logical	lohikal
aggressive	aggressive
aggressive	agresibo
aggressive	mapusok
jin	jin
julie	julie
fbi	fbi
yankees	yankees
ludwig	ludwig
pond	pond
pond	lawa
suburban	suburban
moments	moments
moments	sandali
conjunction	kasabay
lucky	swerte
lucky	suwerte
lucky	lucky
lon	lon
prevented	pinigilan
toy	toy
toy	laruan
bicycle	bisikleta
purely	pulos
purely	panay
fraud	panloloko
fraud	pandaraya
arcade	arcade
lecture	lecture
lecture	panayam
sanctuary	banal
sanctuary	sanctuary
dragons	dragons
copa	copa
careful	ingat
careful	maingat
nurse	nurse
nurse	nars
rivals	karibal
module	module
supplement	supplement
supplement	madagdagan
lens	lens
lens	lente
patron	patron
commands	utos
trend	uso
trend	trend
superintendent	superintendent
gerald	gerald
geneva	geneva
ash	ash
blade	blade
disappeared	naglaho
array	array
predominantly	predominantly
committees	committees
loose	maluwag
boom	boom
smoke	usok
assassination	asasinasyon
lancaster	lancaster
reynolds	reynolds
divorce	diborsiyo
dust	alikabok
saxon	matingkad
separately	magkahiwalay
separately	hiwalay
grain	butil
translations	pagsasalin
zimbabwe	zimbabwe
cohen	cohen
puts	inilalagay
diving	diving
diving	sisid
carroll	carroll
accounting	accounting
mesa	mesa
prussia	prussia
intelligent	talino
cherry	cherry
cherry	seresa
underlying	pinagbabatayan
tobacco	tabako
varieties	varieties
bench	bench
directions	direksiyon
ellen	ellen
padding	padding
measurement	pagsukat
paradise	paraiso
paradise	paradise
alexandria	alexandria
witch	witch
attraction	attraction
attraction	akit
diana	diana
personalities	personalities
colleagues	kasamahan
busy	abala
busy	busy
cia	cia
screenwriter	screenwriter
rankings	rankings
aboriginal	aboriginal
commanders	commanders
salem	salem
wagner	wagner
sanctions	sanksiyon
americas	amerika
instructor	instructor
divorced	diborsiyado
tomorrow	bukas
manuscripts	manuscripts
unified	unified
clarify	linawin
scouts	scout
silva	silva
derek	derek
agenda	agenda
provision	pagkakaloob
humanity	sangkatauhan
admit	umamin
admit	aminin
terror	terror
terror	kilabot
contestants	contestants
trinidad	trinidad
distant	malayo
burke	burke
circles	activities
assignment	assignment
assignment	pagtatalaga
releasing	releasing
shrine	shrine
willie	willie
karnataka	karnataka
celebrate	magdiwang
celebrate	ipagdiwang
collaborated	collaborated
vampire	bampira
vampire	vampire
playwright	playwright
sick	nagkasakit
sick	maysakit
sick	sick
associates	associates
heinrich	heinrich
ethiopia	ethiopia
tel	tel
shorts	shorts
drives	itaboy
uprising	warsaw
edwin	edwin
velocity	hagibis
terminology	terminolohiya
raiders	raiders
coordinates	coordinate
brighton	brighton
viola	viola
morrison	morrison
boxer	boxer
finale	finale
shoulder	balikat
disabled	disable
div	div
tactics	tactics
tactics	taktika
ernst	ernst
innocent	inosenteng
innocent	inosente
innocent	inocencio
innocent	innocent
rapper	rapper
privacy	privacy
boeing	boeing
cites	cites
bunch	kumpol
bunch	bunch
emmy	emmy
indo	indo
rosa	rosa
thermal	thermal
marines	marines
feminist	feminist
trustees	trustees
bacteria	bacteria
introduce	ipakilala
landmarks	palatandaan
disorders	karamdaman
disorders	disorder
disorders	disorders
rivalry	pagalingan
prevention	prevention
prevention	pagpigil
honored	honored
healthy	healthy
healthy	malulusog
healthy	malusog
circus	circus
speculation	haka
burma	burma
sec	sec
quiet	tahimik
knee	tuhod
deliver	deliver
deliver	ihatid
deliver	iligtas
deliver	naghahatid
threw	bumato
hypothesis	hipotesis
referendum	reperendum
travelling	naglalakbay
estonian	estonian
pastor	pastor
sofia	sofia
tribune	tribune
lasting	panghabang
lasting	pangmatagalang
permit	pahintulutan
permit	permit
priority	priority
priority	prayoridad
pounds	pounds
cent	cent
rica	rica
furniture	furniture
macdonald	macdonald
honest	matapat
honest	honest
innovative	makabago
estimate	pagtantiya
estimate	tantiya
estimate	pagtatantya
atp	atp
rotation	rotation
rotation	ikot
syracuse	siracusa
lecturer	lektor
automated	automated
kosovo	kosovo
julius	julius
appreciated	appreciated
naples	naples
sebastian	sebastian
varied	naiba
offense	kasalanan
offense	pagkakasala
offense	offense
barnes	barnes
exceptions	eksepsiyon
martha	martha
drawings	drawings
barely	bahagya
hitting	tumitira
maharashtra	maharashtra
conventions	conventions
elliott	elliott
diplomat	diplomat
brigadier	brigadier
particle	butil
malayalam	malayalam
thursday	huwebes
icon	imahen
icon	icon
ulster	ulster
genes	genes
infinite	infinite
vale	vale
paste	alamang
paste	paste
randy	randy
saxony	sahonya
annie	annie
excessive	sobrang
believing	mananampalataya
mineral	mineral
implement	ipatupad
surgeon	siruhano
badge	badge
charleston	charleston
clause	clause
infection	impeksiyon
infection	infection
electron	elektron
walt	walt
cnn	cnn
confederation	kompederasyon
casino	kasino
casino	casino
doctorate	doctorate
aux	aux
guatemala	guatemala
mask	mask
mask	maskara
shelter	tirahan
dorothy	dorothy
ethnicity	lahi
elimination	natatanggal
heath	heath
pregnant	buntis
richards	richards
theodore	theodore
delegates	delegates
blair	blair
phrases	parirala
preference	kagustuhan
janeiro	janeiro
concerto	concerto
bits	bits
tune	tune
unofficial	unofficial
bulk	bulk
bulk	maramihang
lighthouse	paro
lighthouse	parola
stan	stan
highland	highland
mascot	mascot
acceptance	acceptance
acceptance	pagtanggap
tight	masikip
tight	mahigpit
considers	isinasaalang
hub	hub
mess	gulo
routine	gawain
dubbed	dubbed
dozens	dozens
harmony	pagkakatugma
harmony	harmony
harmony	pagkakaisa
entrepreneur	entrepreneur
entrepreneur	negosyante
wwe	wwe
apollo	apollo
naked	hubad
anton	anton
moses	moises
legally	legal
fake	peke
fake	fake
biased	biased
revolt	kokhba
equity	equity
providence	providence
reliability	maaasahan
tenor	tenor
fights	fights
pocket	bulsa
sad	malungkot
sad	sad
troy	troy
treasure	kayamanan
ion	iono
transformed	transformed
roberto	roberto
adoption	adoption
decrease	bumaba
decrease	bawasan
reserved	reserved
forgotten	nakalimutang
forgotten	nakalimutan
lok	lok
crop	crop
licensing	licensing
advocacy	advocacy
collecting	pangongolekta
treasury	treasury
trumpet	trumpeta
johnston	johnston
norton	norton
collector	collector
cluster	kumpol
cluster	cluster
dear	dear
georges	georges
roller	roller
clothes	damit
enhanced	pinaganda
enhanced	enhanced
compensation	compensation
compensation	sweldo
consent	pahintulot
outline	plot
outline	outline
holdings	holdings
jorge	jorge
darkness	kadiliman
bombers	bombers
holes	butas
blow	suntok
cooking	nagluluto
cooking	pagluluto
trainer	trainer
consciousness	kamalayan
consciousness	ulirat
archaeology	arkeolohiya
latvia	latbiya
telugu	telugu
blogs	blogs
protecting	pagprotekta
hardy	hardy
scorer	scorer
stamp	stamp
nat	nat
fur	fur
fur	balahibo
estimates	pagtantiya
lit	lit
lit	maliwanag
ritual	ritwal
locality	lokalidad
trace	bakas
marble	marmol
foundations	pundasyon
nottingham	nottingham
derivative	deribatibo
boxers	boxers
touchdowns	touchdowns
crawford	crawford
yugoslav	yugoslav
tanzania	tanzania
succeed	nagtagumpay
succeed	magtagumpay
motto	motto
motto	moto
streak	streak
dirty	marumi
hayes	hayes
xbox	xbox
identifying	kinikilala
likes	likes
genres	genres
galleries	galleries
forbes	forbes
councils	konseho
adequate	husto
adequate	sapat
brass	tanso
bach	bach
alias	alyas
counsel	counsel
tough	matigas
advertisement	anunsyo
advertisement	anunsiyo
advertisement	advertisement
advertisement	patalastas
claire	claire
mistakes	pagkakamali
bruno	bruno
dylan	dylan
bag	supot
bag	bag
throwing	itapon
churchill	churchill
tan	tan
spelled	spelling
climb	umakyat
climb	akyatin
witnesses	jehova
thames	tamesis
kazakhstan	kazakhstan
bots	bot
highlights	highlight
highlights	highlights
jumping	pagtalon
jumping	jumping
prof	prof
slovak	eslobako
skull	bungo
missionaries	missionaries
eventual	eventual
hoped	umasa
myth	mito
myth	myth
mandatory	sapilitan
stern	stern
fees	bayad
bet	taya
monks	monks
dancers	dancer
quantity	dami
inventor	imbentor
cairo	cairo
graves	graves
sue	sue
barrier	hadlang
barrier	harang
creatures	nilalang
logan	logan
erik	erik
leicester	leicester
silence	katahimikan
jessica	jessica
plateau	plateau
finite	finite
precedent	precedent
walsh	walsh
intensity	intensity
exterior	panlabas
murders	murders
costume	kasuutan
costume	costume
bike	bike
suffolk	suffolk
differ	iiba
tin	tin
tin	lata
garcia	garcia
madagascar	madagascar
viewing	tinitingnan
viewing	pagtingin
explore	galugarin
explore	tumuklas
explore	explore
explore	siyasatin
explore	tuklasin
builder	builder
bullet	bala
kerry	kerry
subway	subway
arrow	arrow
economist	economist
bread	tinapay
lou	lou
strategies	estratehiya
rubber	goma
cognitive	cognitive
nest	pugad
slam	slam
ancestry	ancestry
portsmouth	portsmouth
convince	kumbinsihin
boarding	boarding
boarding	pagsakay
bonds	bono
joshua	joshua
joshua	josue
inhabited	pinamumugaran
casey	casey
attract	maakit
kilometres	kilometres
pump	poso
feeding	pagpapakain
prey	manghuli
ain	ain
mathematician	matematiko
diary	talaarawan
diary	diary
dubai	dubai
michelle	michelle
lebanese	lebanese
productive	produktibo
guided	guided
guided	ginagabayan
happening	nangyayari
researcher	researcher
della	della
baden	baden
upgraded	upgraded
upgraded	upgrade
demonstration	pakita
philosophers	pilosopong
trap	trap
clara	clara
invitation	paanyaya
invitation	imbitasyon
marking	pagmamarka
expertise	kadalubhasaan
admission	pagpasok
sacramento	sacramento
certification	sertipikasyon
certification	katibayan
precisely	tiyak
casting	casting
submarines	submarines
prohibited	ipinagbabawal
prohibited	bawal
prohibited	pinagbabawal
supposedly	kuno
governance	pamamahala
frog	palaka
mhz	mhz
secular	secular
tracking	pagsubaybay
spa	spa
publicity	propaganda
cleared	clear
watts	watts
gibraltar	gibraltar
renewed	nabago
renewed	renew
fever	lagnat
fever	fever
melody	melody
supporter	tagasuporta
elaborate	elaborate
jeffrey	jeffrey
surnames	surname
swift	swift
tuesday	tuesday
tuesday	martes
silly	tanga
silly	loko
empress	emperatris
capabilities	kakayahan
newman	newman
scales	scales
beatles	beatles
clergy	pari
jacksonville	jacksonville
sara	sara
lifestyle	pamumuhay
bee	bubuyog
bee	bee
baltic	baltiko
czechoslovakia	czechoslovakia
brandon	brandon
loaded	loaded
maya	maya
evangelical	evangelical
imo	imo
mature	mature
sequences	integers
breast	dibdib
breast	suso
beast	beast
raja	raja
raja	raha
für	für
educator	educator
bang	bang
griffin	griffin
rhodes	rhodes
preparing	hinahanda
preparing	naghahanda
preparing	paghahanda
preparing	inihahanda
proportion	proporsyon
itv	itv
ana	ana
rainbow	rainbow
rainbow	bahaghari
demon	dimonyo
demon	demonyo
prussian	prussian
answered	nasagot
answered	sinagot
ist	ist
perception	perception
distributor	distributor
entities	entidad
jackie	jackie
dynamics	dinamika
fiji	fiji
homer	homer
larvae	larvae
limestone	apog
johns	johns
chaos	nagkagulo
chaos	kaguluhan
chang	chang
layers	layers
crater	crater
chad	chad
webster	webster
excess	sobra
excess	labis
ashley	ashley
dot	tuldok
dot	dot
gif	gif
translator	tagapagsalin
translator	translator
translator	tagasalin
cowboys	cowboys
counted	mabibilang
counted	counted
hanging	tambay
hanging	pabitin
soprano	soprano
belarus	belarus
liked	ginusto
liked	nagustuhan
console	console
nascar	nascar
teenage	teenage
vandal	vandal
graduates	nagtapos
graduates	graduates
jungle	gubat
jungle	jungle
ballot	balota
placement	paglalagay
placement	paglalagyan
fairy	fairy
tourists	turista
performs	gumaganap
quarterly	quarterly
romans	romans
romans	roma
rpm	rpm
diploma	diploma
circa	circa
collaborative	tulungang
swan	swan
carpenter	carpenter
carpenter	karpintero
petition	petisyon
boris	boris
berry	berry
invention	imbento
southampton	southampton
prairie	prairie
bend	bend
app	app
finalist	finalist
explicit	kalaswaan
draws	kumukuha
governed	pinamamahalaan
slight	slight
maxwell	maxwell
oriental	oriental
manufacture	paggawa
coordinator	coordinator
mohammad	mohammad
bassist	bassist
superman	superman
colombian	colombian
philippe	philippe
felix	felix
bengali	bengali
greene	greene
voluntary	kusang
floating	lumulutang
floating	nakalutang
floating	lutang
montenegro	montenegro
sketch	sketch
mann	mann
flooding	baha
flooding	pagbaha
dressed	bihis
astronomy	astronomiya
sudden	biglaang
sudden	sudden
variables	variables
arbitrary	arbitrary
skiing	ski
timothy	timothy
cello	cello
rafael	rafael
sphere	sphere
georg	georg
cinematography	cinematography
canvas	canvas
chest	dibdib
krishna	krishna
provider	tagapagkaloob
provider	provider
frances	frances
crowned	crowned
wanting	kulang
carved	kinatay
poles	poles
civilization	sibilisasyon
civilization	kabihasnan
lisbon	lisboa
tongue	dila
eliminate	alisin
panels	panel
darwin	darwin
cheese	keso
easter	pagkabuhay
easter	easter
rat	rat
rat	daga
papua	papua
insert	insert
informal	informal
cry	umiyak
cry	cry
cry	iiyak
loyal	loyal
surfaces	surface
surfaces	ibabaw
nicolas	nicolas
institutes	institutes
humor	katatawanan
humor	pagpapatawa
madonna	madonna
worcester	worcester
cooperative	matulungin
cooperative	kooperatiba
trips	trips
winston	winston
introducing	ipinakikilala
llc	llc
drake	drake
lunar	lunar
fountain	fountain
fountain	balong
consulting	pagsangguni
consulting	pagkonsulta
patricia	patricia
ers	ers
garcía	garcía
quit	lumabas
rid	alisan
maple	maple
aberdeen	aberdeen
verb	pandiwa
illustrations	illustrations
mechanisms	mekanismo
posters	poster
leipzig	leipzig
roland	roland
evident	maliwanag
strait	kipot
unanimous	unanimous
misleading	mapanlinlang
misleading	nakakalinlang
sherman	sherman
stefan	stefan
sleeping	natulog
sleeping	natutulog
alto	alto
thomson	thomson
communicate	kinakausap
alphabet	alpabeto
zagreb	zagreb
chef	chef
tubes	tubes
carnegie	carnegie
hostile	masungit
prizes	prizes
prizes	premyo
eighteen	eighteen
shirt	shirt
weird	weird
weird	kakaiba
weird	kaiba
loading	nilo
plantation	plantasyon
vernon	vernon
practiced	ginagampanan
finger	daliri
finger	finger
garage	garahe
garage	garage
technological	teknolohikal
shoes	sapatos
climbing	umaakyat
barrel	barrel
biographies	biographies
assembled	tipunin
assembled	binuo
ham	magpatawa
ham	ham
hon	hon
geoffrey	geoffrey
valve	valve
commenting	pagkomento
osaka	osaka
beck	beck
analog	analog
monkey	unggoy
tackle	harapin
listening	nakikinig
integrity	integridad
definitions	kahulugan
critically	critically
baldwin	baldwin
troop	tropa
marina	marina
detection	detection
detection	pagtuklas
differential	differential
linguistic	antropolohiyang
venus	venus
salmon	salmon
monarchy	monarkiya
stade	stade
francesco	francesco
abortion	pagpapalaglag
monica	monica
elephant	elepante
elephant	elephant
polar	polar
trademark	trademark
ton	ton
provisional	probisyonal
counting	bilangin
counting	counting
counting	nagbibilang
counting	pagbibilang
corn	mais
airborne	makalipad
deutsche	deutsche
absorbed	buyo
par	par
tension	tension
tension	igting
pablo	pablo
aviv	aviv
cleaning	linis
cleaning	paglilinis
judgement	parusa
physicist	pisiko
catalina	catalina
preventing	iwas
lesbian	tomboy
lesbian	lesbian
withdrawal	pagalis
trailer	trailer
janet	janet
tornado	tornado
tornado	buhawi
aunt	tiyahin
aunt	tita
aunt	tiya
distribute	mamahagi
distribute	ipamahagi
genesis	genesis
shallow	mababaw
makers	makers
requesting	humihiling
floors	sahig
violate	lumalabag
violate	nilalabag
scattered	kalat
boyfriend	bf
boyfriend	boyfriend
consolidated	consolidated
determining	inaalam
determining	pagtukoy
catholicism	katolisismo
luther	luther
pleasure	tuwa
pleasure	kasiyahan
constructive	nakabubuti
webb	webb
alberto	alberto
magical	magical
deliberately	kusa
sacrifice	alay
olive	olive
corridor	corridor
compatible	compatible
compatible	katugma
receptor	reseptor
molecules	molecules
kiev	kiev
vista	vista
castro	castro
preceded	preceded
wei	wei
miscellaneous	miscellaneous
miscellaneous	kalokohan
lineup	pila
ultra	ultra
bulletin	bulletin
clinic	klinika
clinic	clinic
itunes	itunes
patriots	patriots
pollution	polusyon
treasurer	treasurer
herman	herman
sally	sally
rex	rex
mvp	mvp
stuck	mapagmataas
afghan	afghan
inferior	inferior
vatican	vatican
folklore	alamat
affiliation	kaanib
cruiser	cruiser
princes	princes
silk	sutla
silk	silk
agreements	kasunduan
trilogy	trilogy
eng	eng
stamps	stamps
consumers	consumers
defines	tumutukoy
cage	cage
vicinity	paligid
ferguson	ferguson
illustrates	illustrates
cheshire	cheshire
pageant	pageant
amanda	amanda
pos	pos
bye	bye
employer	employer
browns	browns
static	static
tibetan	tibetan
nixon	nixon
sociology	sosyolohiya
capability	kapabilidad
addressing	addressing
panthers	panthers
objection	pagtutol
systematic	sistematikong
violated	lumabag
violated	nilabag
chocolate	tsokolate
chocolate	chocolate
helsinki	helsinki
cambodia	cambodia
grandmother	lola
rounded	bilugan
fitness	fitness
halls	bulwagan
midlands	midlands
jung	jung
brilliant	brilliant
brilliant	shining
libya	libya
transported	sasakay
angela	angela
creature	nilalang
creature	creature
gather	tipunin
gather	magtipon
android	android
filmography	filmography
mentor	mentor
freeman	freeman
puppet	puppet
carey	carey
hiding	tinatago
hiding	nagtatago
hiding	itinatago
hiding	pagtatago
sends	nagpapadala
meyer	meyer
gameplay	gameplay
lima	lima
kirk	kirk
chains	kadena
chains	chains
ucla	ucla
recover	makuha
recover	recover
recover	mabawi
wong	wong
ear	tainga
servants	tagapaglingkod
combine	pagsamahin
decent	disente
deputies	deputies
hawk	lawin
hawk	hawk
contestant	contestant
cumberland	cumberland
rational	talino
altar	dambana
ufc	ufc
organize	maisaayos
organize	isaayos
organize	ayusin
determination	pagpapasiya
chennai	chennai
dong	dong
myanmar	myanmar
proud	pinagmamalaki
proud	proud
proud	ipinagmamalaki
proud	maipagmamalaki
custody	kustodiya
surveillance	pagbabantay
threatening	nagbabanta
discharge	puke
penny	penny
kannada	kannada
astronomical	astronomical
rector	rector
petroleum	petroleum
bug	bug
proceed	magpatuloy
chapman	chapman
mud	putik
honey	honey
diagram	diagram
broadcaster	broadcaster
riley	riley
displacement	displacement
sponsor	sponsor
ira	ira
haiti	hayti
haiti	haiti
wisdom	karunungan
pierce	pierce
stupid	bobo
stupid	tanga
alma	alma
alexandra	alexandra
shuttle	shuttle
hampton	hampton
eva	eva
mickey	mickey
gastropod	gastropod
yuan	yuan
lynch	lynch
johannes	johannes
ecclesiastical	lating
destroying	naninira
trunk	trunk
proclaimed	proclaimed
adolf	adolf
sharon	sharon
hung	hung
gardner	gardner
artifacts	artifacts
handful	dakot
mandate	kautusan
locked	locked
mohammed	mohammed
dish	ulam
terrible	terrible
revived	revived
reagan	reagan
rebecca	rebecca
toledo	toledo
divide	hatiin
recommendations	rekomendasyon
gymnastics	gymnastics
alter	ibahin
ideology	ideology
constantinople	constantinople
fatal	aswang
modeling	modeling
notified	inabisuhan
bulls	bulls
harassment	panggugulo
harassment	pananakot
censorship	censorship
favorable	makabubuti
inserted	ipinasok
paramount	paramount
luxury	luho
luxury	marangyang
luxury	luxury
yahoo	yahoo
ecology	ekolohiya
reviewers	reviewers
emirates	emirates
neutrality	neutrality
chronicles	chronicles
deployment	paglawak
lepidoptera	lepidoptera
blast	sabog
jenkins	jenkins
omaha	omaha
detected	natukoy
overcome	nagtagumpay
overcome	overcome
facilitate	mapadali
hermann	hermann
morton	morton
sake	sake
roma	roma
accredited	accredited
echo	echo
bangkok	bangkok
achieving	pagkamit
bergen	bergen
hawks	hawks
availability	pagkakaroon
availability	availability
organizing	aayos
lung	baga
andreas	andreas
cedar	cedar
stake	stake
bankruptcy	bangkarota
basement	saligan
basement	silong
basement	basement
torture	torture
toyota	toyota
wheat	trigo
examined	napagmasdan
membrane	balamban
knockout	knockout
coleman	coleman
maiden	pagkadalaga
maiden	maiden
dhaka	dhaka
christine	christine
curious	curious
tucker	tucker
evolutionary	ebolusyonaryong
responsibilities	pananagutan
viscount	biskonde
pavilion	pavilion
fantastic	fantastic
ceremonies	seremonya
joey	joey
corporations	corporations
tagging	tagging
moss	mos
moss	moss
moss	lumot
parody	patawa
yield	ani
armored	pagsakay
armored	armored
cheap	mura
cheap	murang
cheap	cheap
stuttgart	stuttgart
dialects	dialects
backup	backup
forbidden	forbidden
forbidden	ipinagbabawal
neill	neill
knife	kutsilyo
wade	wade
humanities	humanities
gonzález	gonzález
yesterday	kahapon
percy	percy
expressway	expressway
transform	transform
vegetation	behetasyon
tickets	tiket
adopt	adopt
braves	braves
filmmaker	filmmaker
sicily	sicilia
sicily	sicily
zip	zip
updates	updates
updates	update
replied	sumagot
restriction	pagbabawal
lin	lin
siblings	magkakapatid
siblings	magkapatid
siblings	kapatid
uttar	uttar
tide	tide
laps	laps
predicted	predicted
feast	kapistahan
feast	feast
poker	poker
promising	promising
kane	kane
trevor	trevor
reprinted	reprinted
sidney	sidney
holidays	pasko
holidays	holidays
holidays	bakasyon
holidays	kapaskuhan
comfortable	komportable
comfortable	kumportable
fletcher	fletcher
airways	airways
floyd	floyd
snail	kuhol
genocide	genocide
saga	saga
scots	eskoses
kingdoms	kaharian
archdiocese	archdiocese
fossils	fossils
buying	binibili
buying	bumibili
buying	pagbili
smoking	naninigarilyo
smoking	paninigarilyo
subdivision	subdivision
leather	leather
def	def
patch	patch
porto	porto
valencia	valencia
subfamily	subfamily
tracy	tracy
breakfast	agahan
breakfast	almusal
subspecies	subspecies
andhra	andhra
mercy	awa
botanical	botanical
ore	ore
lone	lone
bottle	bote
tunisia	tunisia
angola	angola
humanitarian	humanitarian
slide	slide
generating	pagbuo
trapped	nakulong
rao	rao
guru	guru
telescope	telescope
dense	siksik
satisfied	nasiyahan
satisfied	kuntento
satisfied	kontento
satisfied	nasisiyahan
coral	sagay
coral	coral
coral	koral
xavier	xavier
helena	helena
anatomy	anatomiya
binary	binary
controlling	pagkontrol
wound	sugat
conviction	paninindigan
dixon	dixon
kuwait	kuwait
ridiculous	nakakatawa
suffer	magdusa
nsw	nsw
nord	nord
caves	tabon
regent	regent
shane	shane
balanced	balanseng
balanced	balanse
fitzgerald	fitzgerald
highlight	highlight
payments	pagbabayad
tendency	tendency
lópez	lópez
joyce	joyce
lifted	lifted
davidson	davidson
decorative	pandekorasyon
rouge	rouge
rockets	rockets
cure	gamutin
cure	lunas
bolton	bolton
slope	libis
manning	manning
boyd	boyd
organisms	organismo
organisms	organism
paraguay	paraguay
preview	preview
preview	silipin
qatar	qatar
import	import
buddy	pare
buddy	buddy
iucn	iucn
dock	pantalan
clare	clare
penguin	penguin
rapids	rapids
exceptional	natatanging
papal	papal
shed	shed
shed	malaglag
cologne	cologne
norwich	norwich
challenging	naghahamon
anthem	awit
supervision	binabantayan
investigator	imbestigador
ming	ming
lease	lease
yours	yours
cecil	cecil
toys	laruan
conrad	conrad
buck	buck
buck	alma
hang	hang
italia	italia
portable	portable
dell	dell
irving	irving
bells	bells
tibet	tibet
composite	pinaghalo
councillors	councillors
salary	sahod
salary	suweldo
enhance	pagandahin
enhance	pagbutihin
enhance	pagpapaganda
staying	lumalayo
fragments	fragments
caesar	caesar
tragedy	trahedya
macedonian	masedonyo
unesco	unesco
investigated	inimbestigahan
cameroon	cameroon
carson	carson
slot	slot
rams	rams
sophie	sophie
jenny	jenny
comparative	anatomiyang
apostolic	apostolic
venezuelan	venezuelan
pirate	pirata
pirate	pirate
paralympic	paralympic
accompanying	hatid
seasonal	seasonal
delegation	delegasyon
combining	ipinagsama
portfolio	portfolio
machinery	makinarya
embedded	embedded
keen	matalim
keen	keen
gandhi	gandhi
fiscal	piskal
testimony	patotoo
duchess	dukesa
reflection	reflection
middlesex	middlesex
carr	carr
booth	booth
rudolf	rudolph
rudolf	rudolf
león	león
userpage	userpage
courage	katapangan
courage	tapang
midland	midland
riots	stonewall
develops	develops
pier	pantalan
pier	pier
pier	daungan
auction	subasta
auction	auction
cbc	cbc
specifications	detalye
secrets	lihim
crest	crest
sutton	sutton
decreased	nabawasan
ups	ups
prominence	katanyagan
phantom	phantom
hartford	hartford
alps	alpes
liner	liner
ease	kadalian
ease	madalian
cet	cet
investments	investments
auburn	auburn
flame	apoy
exeter	exeter
kay	kay
rent	umupa
rent	upahan
rent	rent
rent	upa
highlands	kabundukan
highlands	highlands
induced	sapilitan
verses	verses
crane	crane
latitude	latitude
lance	lance
networking	networking
keeper	tagabantay
fixing	aayos
fixing	fixing
asset	asset
stance	tindig
gymnasium	gymnasium
gloria	gloria
trent	trent
horizon	horizon
yemen	yemen
riot	riot
riot	kaguluhan
quinn	quinn
excluded	excluded
elena	elena
anger	galit
anger	poot
hierarchy	hierarchy
decoration	hiyas
decoration	dekorasyon
decoration	pamasko
nerve	nerve
disability	kapansanan
giuseppe	giuseppe
