glider	เครื่องร่อน
glider	glider
xxx	xxx
arithmetic	คณิต
arithmetic	เลขคณิต
rancho	rancho
dump	ทิ้ง
merchandise	สินค้า
patches	หย่อม
humble	เจียม
humble	ถ่อม
javascript	javascript
dungeons	dungeons
gig	กิ๊ก
stellar	ดาวฤกษ์
sans	sans
skyscrapers	ตึกระฟ้า
diaries	ไดอารี่
adjust	ปรับ
rot	เน่า
hungry	หิว
fremantle	fremantle
sheldon	sheldon
giro	giro
hee	ฮี
bind	เชื่อม
needle	เข็ม
spurs	spurs
exodus	exodus
potassium	โพแทสเซียม
rossi	รอสซี่
admired	ชื่นชม
modernist	modernist
monitors	จอภาพ
shit	อึ
cbn	cbn
bracket	วงเล็บ
pray	ภาวนา
pray	สวด
pray	อธิษฐาน
pam	pam
pam	แพม
pam	แพ
bunker	บังเกอร์
regret	เสียใจ
regret	เสียดาย
supermarket	ซุปเปอร์มาร์เก็ต
weights	เวท
charm	เสน่ห์
petrol	น้ำมัน
melting	ละลาย
psychic	กายสิทธิ์
zach	แซบ
zach	แซ
zach	แซก
zach	แซค
otago	otago
eager	กระตือรือร้น
weighing	ชั่ง
hint	ใบ้
punished	ลงโทษ
crying	ร้องไห้
bunny	กระต่าย
bunny	บัน
spl	special
gangs	แก๊ง
hernández	hernández
grocery	ของชำ
restrict	จำกัด
shoulders	บ่า
shoulders	ไหล่
ret	ret
bald	โล้น
seminars	สัมมนา
pants	กางเกง
allegheny	allegheny
moose	มูส
consonant	พยัญชนะ
nun	นูน
knot	เงื่อน
knot	ปม
null	null
null	ว่าง
tsunami	tsunami
adventist	adventist
ordination	บวช
rpg	rpg
prep	เตรียม
mushroom	เห็ด
mosques	มัสยิด
humidity	ความชื้น
len	len
len	เลน
trash	ขยะ
litre	ลิตร
midi	midi
seminar	สัมมนา
cart	ตะกร้า
cart	เกวียน
seize	คร่า
seize	จิก
fibers	เส้นใย
respects	เคารพ
philips	philips
megan	megan
quiz	สอบ
surround	ล้อม
loops	ลูป
symphonic	symphonic
rae	แร
rae	rae
junk	ขยะ
cod	คอด
cod	cod
discount	ส่วนลด
chun	ชุน
hussain	hussain
exhausted	เหนื่อย
luca	luca
behave	ประพฤติ
podium	แท่น
pneumonia	ปอดบวม
lao	ลาว
mantle	อาภรณ์
sac	sac
planting	ปลูก
bonn	bonn
mono	โมโน
mono	mono
lips	ปาก
treasures	สมบัติ
ceramics	เซรามิค
bowls	ชาม
playhouse	playhouse
immortal	อมตะ
cambridgeshire	cambridgeshire
intentional	จงใจ
bei	ปี่
lan	ลาน
gala	กาลา
awesome	เยี่ยม
crab	ปู
butt	ก้น
butt	ตูด
ambush	ซุ่ม
shea	เช
shea	เชีย
loc	loc
adb	adb
blanket	ผ้าห่ม
expose	เปิดโปง
lbs	ปอนด์
nora	นอ
beams	คาน
wehrmacht	wehrmacht
rhineland	rhineland
subsection	วรรค
neutron	นิวตรอน
cho	โชว
cho	โชโช
cho	โช
locke	ล็อค
evolve	พัฒนา
perimeter	ปริมณฑล
vertex	vertex
bali	บาหลี
rift	rift
henrik	henrik
leak	รั่ว
bricks	อิฐ
kendall	kendall
raion	raion
cindy	cindy
watford	watford
theodor	theodor
mysore	mysore
gmbh	gmbh
prophecy	พยากรณ์
sanitation	สุขาภิบาล
demos	สาธิต
demos	demos
tops	รำ
tops	ท็อปส์
coefficient	สัมประสิทธิ์
gwen	กวน
jstor	jstor
spear	หอน
spear	หอก
dev	dev
vertices	vertices
sins	บาป
wat	วัด
stepping	ก้าว
remixed	remixed
analyze	วิเคราะห์
earls	earls
nail	nail
nail	เล็บ
nail	ตะปู
squirrel	กระรอก
vida	beef
tablets	แท็บเล็ต
neon	นีออน
tails	หาง
tails	ก้อย
thessaloniki	thessaloniki
dictatorship	เผด็จการ
kris	kris
battleships	เรือรบ
infoboxes	infoboxes
announcements	ประกาศ
nikki	nikki
tyson	tyson
doi	ดอย
slalom	slalom
comune	comune
sack	กระสอบ
mister	มิสเตอร์
quintet	quintet
counseling	ปรึกษา
khmer	เขมร
foil	ฟอยล์
urgent	ด่วน
colorful	สีสัน
mariana	มาเรียนา
viva	viva
fia	fia
krai	krai
coke	โค้ก
coke	โคเคน
conquer	เอาชนะ
conquer	พิชิต
imagesize	imagesize
whistle	หวีด
whistle	นกหวีด
whistle	ผิวปาก
glamorgan	glamorgan
sms	sms
shu	ชุ
shu	ชู
uni	uni
emerald	มรกต
emerald	emerald
nokia	โนเกีย
chalk	ชอล์ค
chalk	ชอล์ก
decimal	ทศนิยม
ching	จิง
ching	ชิง
clues	เงื่อนงำ
clues	เบาะแส
disciple	สาวก
disciple	ศิษย์
obe	obe
rté	rté
nan	แนน
nan	น่าน
snooker	สนุกเกอร์
yen	เยน
concession	concession
amiga	amiga
userboxes	userboxes
purge	ขจัด
algae	สาหร่าย
jesuits	jesuits
pathology	พยาธิ
handsome	หล่อ
dvds	dvd
dvds	ดีวีดี
rip	ฉีก
rip	rip
ginger	ขิง
diagrams	ไดอะแกรม
champ	champ
champ	แชมป์
uncomfortable	อึดอัด
kahn	คาห์น
caring	ห่วงใย
postage	แสตมป์
postage	ไปรษณีย์
equals	เท่ากับ
obsessed	หมกมุ่น
obsessed	หลงใหล
colon	ลำไส้
fist	หมัด
fist	กำปั้น
fist	ปั้น
insults	ดูถูก
asa	asa
lol	lol
lol	ฮ่าๆ
yin	หยิน
cbe	cbe
wikinews	wikinews
bernhard	bernhard
nests	รัง
moe	โม
moe	moe
pixels	พิกเซล
yves	yves
gymnast	ยิมนาสติก
helm	นำร่อง
vie	vie
gem	อัญมณี
saul	โซล
saul	ซอล
epa	epa
disturbing	รบกวน
lend	ยืม
tandem	tandem
palaces	พระราชวัง
silesia	silesia
isis	isis
tires	ยาง
fluent	คล่อง
swindon	swindon
poole	พูล
mohan	mohan
moisture	ความชื้น
venom	พิษ
tha	ท่า
elton	elton
capitalist	นายทุน
ramón	ramón
awb	awb
geologist	ธรณีวิทยา
veins	เส้นเลือด
organizer	จัด
galloway	กัลโลเวย์
bengals	เบงกอล
sud	sud
desires	กิเลส
pak	ปาก
fatty	อ้วน
ottomans	ottomans
nike	nike
manners	มารยาท
tao	เต๋า
tao	เต่า
tao	เทา
tao	tao
rusty	สนิม
shout	ตะโกน
pixel	พิกเซล
tile	กระเบื้อง
cis	cis
preaching	เทศน์
distortion	บิดเบือน
hail	ลูกเห็บ
mis	mis
montréal	montréal
île	île
lever	โยก
blowing	ฟุ้ง
blowing	เป่า
thieves	ขโมย
thieves	โจร
sabbath	บาธ
uhf	uhf
mystical	ลึกลับ
société	société
faa	faa
sexy	sexy
sexy	เซ็กซี่
quantitative	quantitative
guessing	เดา
lai	ลาย
treats	ปฏิบัติ
washing	ล้าง
skies	ท้องฟ้า
gum	ฝรั่ง
bathroom	ห้องน้ำ
benfica	benfica
psychiatrist	จิตแพทย์
cavity	โพรง
cavity	โหว่
forgive	อภัย
roc	roc
fam	ครอบครัว
fam	fam
pumps	ปั๊ม
kindly	ใจดี
kin	kin
kin	ญาติ
nowrap	nowrap
hormone	ฮอร์โมน
gut	พุง
archers	ธนู
galerie	galerie
mas	mas
drafts	ร่าง
anhalt	anhalt
apples	แอ๊ปเปิ้ล
apples	แอปเปิล
apples	เปิ้ล
emails	อีเมล
dictator	เผด็จการ
montenegrin	montenegrin
laughing	หัวเราะ
ames	เอม
ars	ars
psi	psi
nil	นิล
cigarette	บุหรี่
clinics	คลินิก
snap	snap
chick	เจี๊ยบ
chick	ลูกไก่
recipes	สูตร
appealing	อุทธรณ์
consult	ปรึกษา
maldives	มัลดีฟ
dart	โผ
boiling	เดือด
ferreira	ferreira
browsers	บราวเซอร์
insertion	แทรก
macintosh	sad
packs	แพ็ค
université	université
reproduced	แพร่
millionaire	เศรษฐี
urine	ปัสสาวะ
mer	เมอ
wes	เวสส
wes	เวส
mal	มอล
mal	มาล
stripe	stripe
envelope	ซอง
dice	เต๋า
dice	ลูกเต๋า
masks	หน้ากาก
dismiss	ยกเลิก
swallow	กลืน
transcript	transcript
enjoying	เพลิน
malaria	มาลาเรีย
cska	cska
downloads	ดาวน์โหลด
tow	พ่วง
tattoo	tattoo
depressed	หดหู่
sergey	sergey
dickson	dickson
slovene	slovene
rainforest	ป่าดิบ
aol	aol
swap	สลับ
fanny	fanny
lal	lal
viaf	viaf
dharma	ธรรมะ
ying	ying
ying	อิง
gesture	น้ำใจ
nfc	nfc
pontifical	pontifical
dictionaries	พจนานุกรม
bey	bey
safari	ซาฟารี
safari	safari
centimeters	เซนติเมตร
ndp	ndp
discarded	ละทิ้ง
jiang	เจียง
kobe	โกเบ
orthodoxy	orthodoxy
chattanooga	chattanooga
fuji	fuji
fuji	ฟูจิ
gothenburg	gothenburg
stiff	แข็ง
honneur	honneur
cheek	แก้ม
bucket	ถัง
carleton	carleton
woodstock	woodstock
ufo	ufo
sharpe	sharpe
ffa	ffa
blogger	blogger
meg	เมก
translating	แปล
heels	ส้น
discographies	discographies
lau	เหลา
homework	การบ้าน
concealed	ปกปิด
diaz	diaz
camel	อูฐ
waterfalls	น้ำตก
til	จนถึง
delicate	บอบบาง
glorious	รุ่งโรจน์
wikibooks	wikibooks
nana	นานา
cosmos	จักรวาล
togo	โตโก
fig	ฟิก
fig	ฟิค
trance	ภวังค์
haryana	haryana
microwave	ไมโครเวฟ
ras	ras
gangster	มาเฟีย
gangster	นักเลง
msg	msg
dino	dino
deserted	ร้าง
pricing	ราคา
avatar	avatar
interpreter	ล่าม
pfc	pfc
chords	คอร์ด
fireworks	พลุ
betrayed	ทรยศ
coincidence	บังเอิญ
feather	ขน
roe	roe
roe	โร
transporting	ขนส่ง
elbow	ข้อศอก
elbow	ศอก
hats	หมวก
forecast	พยากรณ์
instructors	วิทยากร
brains	สมอง
plaster	ปูน
knesset	knesset
coma	โคม่า
gee	gee
fernandez	fernandez
cathy	แคธี
pops	ป็อป
raped	ข่มขืน
heroine	นางเอก
salford	salford
zoom	ขยาย
zoom	ซูม
gail	เกิล
gail	เกล
oliveira	oliveira
boise	บอยซี
keynes	keynes
cerro	cerro
excel	excel
wai	หวาย
bafta	bafta
monsoon	มรสุม
weed	วัชพืช
weed	กัญชา
queue	คิว
scattering	ลวดลาย
soda	โซดา
agg	agg
rec	rec
rec	สันทนาการ
sim	ซิม
sim	sim
nails	เล็บ
nails	ตะปู
joker	joker
joker	โจ๊ก
virgil	เฝอ
grab	คว้า
bounty	ค่าหัว
decca	decca
microphone	ไมโครโฟน
fang	ฟาง
fracture	แตกหัก
asleep	หลับ
hidalgo	hidalgo
hack	แฮ็ก
hack	แฮก
hum	ฮัม
continuum	continuum
sas	sas
somme	somme
kangaroo	จิงโจ้
taxonomic	taxonomic
ari	อารีย์
ari	อารี
heck	เฮ็ค
chiba	ชิบะ
absorb	ซึมซับ
absorb	ซึม
prevalence	ชุก
hints	บอกใบ้
tug	ชัก
cambodian	กัมพูชา
knives	มีด
zeus	ซุส
zeus	ซุซุ
appendix	ไส้ติ่ง
appendix	ผนวก
otter	นาก
gillespie	กิลเลส
seminal	อสุจิ
wrap	ห่อ
penis	จู๋
penis	องคชาติ
verdi	verdi
donkey	ลา
puzzles	ปริศนา
hokkaido	ฮอกไกโด
worries	ห่วง
hotspur	hotspur
blows	พัด
cows	วัว
clutch	คลัช
clutch	คลัตช์
ramírez	ramírez
shower	ฝักบัว
ipa	ipa
audi	audi
ignorant	งมงาย
implication	นัย
mariano	mariano
hoc	hoc
prosecutors	อัยการ
peck	เพ็ก
peck	เพค
peck	เพ็ค
wikipedias	wikipedias
prosperous	รุ่งเรือง
rewards	รางวัล
wikia	wikia
sbs	sbs
aviator	aviator
panda	แพนด้า
liberalism	เสรีนิยม
seizure	ชัก
caravan	คาราวาน
independents	independents
printers	เครื่องพิมพ์
tam	tam
tam	แทม
wandering	เร่ร่อน
rowe	rowe
tutorial	สอน
remastered	remastered
gloves	ถุงมือ
reese	รีซ
reese	รีส
unitary	unitary
volvo	volvo
rhyme	คล้อง
rhyme	คล้องจอง
herrera	herrera
heroin	เฮโรอีน
chili	พริก
cochrane	cochrane
flyer	ใบปลิว
slots	สล๊อต
slots	สล็อต
slots	ล็อต
donate	บริจาค
marius	marius
ate	กิน
muller	muller
sap	sap
goats	แพะ
analyzing	วิเคราะห์
cheung	จาง
johnstone	johnstone
mari	mari
scared	กลัว
neglect	หลงลืม
confuse	สับสน
bsc	bsc
certifications	certifications
futebol	futebol
dreaming	ฝัน
mein	mein
dora	dora
prostitute	โสเภณี
implicit	นัย
hygiene	อนามัย
maclean	maclean
yun	ยุน
thorn	หนาม
banners	แบนเนอร์
amc	amc
wedge	สลิ่ม
wedge	ลิ่ม
fir	ฟิ
iss	iss
evenings	ค่ำ
evenings	เย็น
augsburg	augsburg
mold	รา
mold	เบ้า
delight	พอใจ
haas	ฮาร์ส
contaminated	เจือปน
bandits	โจร
mcgee	แมคกี
nationalities	สัญชาติ
cookie	คุกกี้
repertory	repertory
coated	เคลือบ
belts	เข็มขัด
wrocław	wrocław
junta	uprising
slash	เฉือน
obstacle	อุปสรรค
gridcolor	gridcolor
stm	stm
oricon	oricon
jewels	อัญมณี
gotta	gotta
condensed	ข้น
realization	ตระหนัก
prc	prc
laundry	ซักรีด
fragile	บอบบาง
nes	nes
pickup	กระบะ
oblique	เฉียง
rye	ไรย์
investing	ลงทุน
fern	fern
blitz	blitz
rods	แท่ง
markus	markus
peach	ท้อ
peach	พีช
migrant	ต่างด้าว
congestion	แออัด
striped	ลาย
göttingen	göttingen
sumo	ซูโม่
mixes	มิกซ์
broker	โบรกเกอร์
broker	broker
okrug	okrug
knocking	เคาะ
hua	หัว
spruce	ต้นสน
yamaha	yamaha
stout	พร้อมใจ
gareth	gareth
astrology	โหราศาสตร์
rehearsal	ซ้อม
jing	จิง
remembering	จดจำ
requiem	requiem
ratios	อัตราส่วน
conserved	conserved
sediment	ตะกอน
electors	electors
biochemistry	ชีวเคมี
exposing	แฉ
revolutionaries	ปฏิวัติ
bicycles	จักรยาน
textcolor	textcolor
hacker	แฮกเกอร์
sour	เปรี้ยว
heel	ส้น
isp	isp
scarce	ขาดแคลน
badges	ป้าย
badges	เครื่องหมาย
ness	เนส
ccc	ccc
dane	เดนมาร์ก
puebla	puebla
bully	รังแก
pencil	ดินสอ
directional	ทิศทาง
heal	หาย
heal	รักษา
heal	เยียวยา
contempt	ดูถูก
ger	ger
sudanese	ซูดาน
nepalese	เนปาล
defect	บกพร่อง
ich	ich
martina	martina
pubs	ผับ
fuse	ฟิวส์
nicknames	ฉายา
opium	ฝิ่น
drone	drone
quota	จัดสรร
karma	กรรม
vis	สุดวิสัย
ogden	ogden
cigarettes	บุหรี่
kamal	kamal
cartridges	ตลับ
bog	ห้วย
bog	บึง
sal	แซล
euros	ยูโร
jae	แจ
polished	ขัด
fabricius	fabricius
delle	delle
kawasaki	kawasaki
domenico	domenico
hannover	hannover
stephan	stephan
vojvodina	vojvodina
kat	แคท
stdinchi	stdinchi
thom	ท่อม
thom	ธอม
bidding	ประมูล
pensions	บำนาญ
scenery	บรรยากาศ
scenery	ทัศนียภาพ
scenery	ทิวทัศน์
almanac	almanac
siemens	เมนส์
stdinchikey	stdinchikey
caspian	แคสเปียน
fatigue	เหน็ดเหนื่อย
fatigue	อ่อนเพลีย
quay	quay
souza	souza
assign	กำหนด
slipped	ลื่น
bose	bose
pluto	พลูโต
iata	iata
montane	montane
gerais	gerais
usher	usher
sesame	งา
breathe	หายใจ
româniei	româniei
barley	บาร์เลย์
balcony	ระเบียง
bored	เบื่อ
ayrshire	ayrshire
mandir	mandir
glee	glee
onion	หอม
maize	ข้าวโพด
gogh	โก๊ะ
lsp	lsp
wetland	wetland
auditor	display
gems	อัญมณี
shocking	ตกใจ
lungs	ปอด
manuals	คู่มือ
curb	ทางเท้า
whiskey	วิสกี้
bai	ไบ
bai	ไป๋
dude	dude
distorted	บิดเบือน
manly	แมน
köln	köln
titlestyle	titlestyle
aquino	aquino
ribs	ซี่โครง
yao	เหยาะ
yao	เหยา
gently	เบาๆ
pawn	หมาก
pawn	เบี้ย
secession	secession
tyrol	tyrol
hated	เกลียด
psycho	จิต
psycho	โรคจิต
clade	clade
kan	กานต์
gears	เกียร์
lifts	เหิร
jang	ชัง
jang	จาง
jang	jang
jang	แจง
coating	coating
coating	เคลือบ
issn	issn
parc	parc
cheating	โกง
cheating	นอกใจ
paraná	paraná
rihanna	rihanna
wah	ว้า
wah	วา
asturias	asturias
palo	ปาโล
palo	พาโล
dcc	dcc
shrimp	กุ้ง
dungeon	ใต้ดิน
crust	เปลือก
scriptures	คัมภีร์
glove	ถุงมือ
muscular	กล้าม
cleaner	สะอาด
kinase	kinase
guise	guise
calculating	คำนวณ
jar	โหล
jar	กระปุก
insulin	อินซูลิน
dagger	กริช
ren	หยิน
ren	เรน
orkney	orkney
tae	แท
tae	แท่
earle	earle
img	img
mcleod	mcleod
paige	เพจ
comp	comp
pity	สงสาร
inherit	สืบทอด
zack	แซ็ก
zack	แซ็ค
shen	เชิน
shen	สิม
toad	คางคก
als	als
regis	regis
login	ล็อกอิน
msn	msn
sven	sven
nicky	nicky
tastes	รสนิยม
tastes	รสชาติ
vivid	สดใส
plaintiff	โจทก์
plaintiff	โจทย์
topographic	topographic
bwv	bwv
reg	reg
crafted	หัตถกรรม
implementations	implementations
gazetteer	gazetteer
knees	เข่า
ser	เซอร์
cradle	เปล
rust	สนิม
southend	southend
topological	topological
variance	แปรผัน
guo	กัว
razor	มีดโกน
veil	มิติ
veil	ปกคลุม
argonauts	argonauts
filmfare	filmfare
clones	โคลน
riaa	riaa
éditions	éditions
supplementary	เสริม
agrarian	agrarian
blossom	blossom
jude	จู๊ด
ropes	เชือก
cdc	cdc
fade	จาง
egyptians	อียิปต์
timeaxis	timeaxis
groningen	groningen
stanisław	stanisław
skins	ผิวหนัง
crocodile	จระเข้
republished	republished
chong	ชอง
fiesta	fiesta
invertebrates	invertebrates
novice	สามเณร
simulcast	simulcast
foam	โฟม
dresses	ชุด
milne	milne
herbs	สมุนไพร
phoebe	ฟีบี
reset	รีเซ็ต
viz	viz
fuzzy	ฝอย
beech	บีช
ding	ติง
apprenticeship	ฝึกงาน
msc	msc
royale	รอยัล
insider	วงใน
sweat	เหงื่อ
alignbars	alignbars
tulane	tulane
boiled	ต้ม
warmer	อุ่น
usefulness	ประโยชน์
vegetarian	มังสวิรัติ
alam	alam
kissing	จูบ
annoyed	รำคาญ
shattered	แตก
noaa	noaa
seo	seo
seo	ซอ
lillian	lilian
virtues	คุณธรรม
gui	gui
bounce	เด้ง
bounce	กระเด้ง
orchids	กล้วยไม้
hamburger	แฮมเบอร์เกอร์
aeronautical	aeronautical
programmers	โปรแกรมเมอร์
att	att
tnt	tnt
bubbles	ฟอง
crypt	ป่าช้า
overwhelmed	ท่วม
miocene	miocene
waist	เอว
waist	waist
tunis	ตูนิส
scorpion	แมงป่อง
advertise	โฆษณา
butch	บุช
thriving	รุ่งเรือง
wiener	ไส้กรอก
librarians	บรรณารักษ์
aerodrome	aerodrome
bodyguard	bodyguard
byte	ไบต์
splash	สาด
peña	peña
classify	จำแนก
scalemajor	scalemajor
wikidata	wikidata
rabbits	กระต่าย
synthesizers	synthesizers
cue	คิว
peng	peng
peng	เผิง
peng	ผิง
rum	รัม
topography	ภูมิประเทศ
nic	nic
blazers	blazers
abusing	ชำ
rhino	แรด
outlaws	outlaws
pronouns	สรรพนาม
buddhists	พุทธ
fai	fai
gin	gin
gin	จิน
eintracht	eintracht
prem	prem
eats	กิน
booking	จอง
booking	สังกัด
icf	icf
tilt	เอียง
hillside	เนิน
chaotic	โกลาหล
chaotic	วุ่นวาย
matrices	matrices
mani	มณี
mosquito	ยุง
plotarea	plotarea
multiplication	คูณ
darmstadt	darmstadt
rhymes	คล้อง
rhymes	คล้องจอง
commodities	commodities
tensor	tensor
islamabad	อิสลามาบัด
mbe	mbe
skyscraper	ตึกระฟ้า
attach	แนบ
nec	nec
melt	ละลาย
disks	ดิสก์
broughton	broughton
supermarkets	ซุปเปอร์มาร์เก็ต
amar	amar
scrub	ถู
scrub	ขัด
gotham	กอธ
mermaid	เงือก
fishery	ประมง
inflammation	อักเสบ
petals	กลีบ
cocktail	ค็อกเทล
cocktail	cocktail
bard	กวี
kimberley	kimberley
schizophrenia	โรคจิตเภท
prophets	ศาสดา
truss	truss
outsider	คนนอก
staples	staples
maha	มหา
elf	เอลฟ์
octopus	ปลาหมึก
deserved	สมควร
beau	บัว
beau	beau
deutsch	deutsch
aegean	อีเจียน
evenly	สม่ำเสมอ
palms	ฝ่ามือ
palms	ปาล์ม
naive	ซื่อๆ
naive	ซื่อ
vase	แจกัน
dominica	โดมินิกา
ode	ode
arboretum	arboretum
lew	ลูว์
footsteps	ฝีเท้า
trier	trier
iain	iain
moravian	moravian
peppers	พริก
mundo	mundo
pedersen	pedersen
mist	หมอก
baked	อบ
lure	ล่อ
karabakh	karabakh
severn	severn
mornings	เช้า
injected	ฉีด
artifact	วัตถุ
fluids	ของเหลว
grams	กรัม
moonlight	แสงจันทร์
telecommunication	โทรคมนาคม
octagonal	octagonal
gunpowder	ดินปืน
curvature	โค้ง
vip	vip
borg	borg
sinn	sinn
mavericks	mavericks
siam	สยาม
frustrating	ท้อแท้
passports	หนังสือเดินทาง
susquehanna	susquehanna
danzig	danzig
rallies	หล่า
rallies	หลวย
serials	serials
drunken	เมา
stalled	ติดขัด
candle	เทียน
candle	เทียนไข
interwiki	interwiki
parcel	พัสดุ
welcoming	ต้อนรับ
shouting	ตะโกน
breeze	สายลม
hrs	hrs
sebastián	sebastián
cms	cms
civilizations	อารยธรรม
originals	ดั้งเดิม
phylogenetic	phylogenetic
lyle	lyle
lyle	ไลล์
lyle	ไลน์
musique	musique
koreans	เกาหลี
floral	floral
kilometer	กิโลเมตร
mazda	mazda
ter	ter
ghz	ghz
ape	ลิง
doubleday	doubleday
jess	เจส
magnesium	แมกนีเซียม
taunton	taunton
gladys	gladys
clerical	เสมียน
kant	kant
ops	ops
mersin	mersin
sonar	โซนาร์
sonar	โซนา
spiegel	spiegel
muzzle	ตะกร้อ
rotate	หมุน
lcd	lcd
scary	สยอง
jurisprudence	นิติศาสตร์
andersson	andersson
enfield	enfield
rostov	rostov
goodwill	goodwill
superfamily	superfamily
amadeus	amadeus
opéra	opéra
appropriations	จัดสรร
vedic	vedic
gwynedd	gwynedd
sticky	หนึบ
sticky	เหนียว
mallorca	mallorca
vent	ระบาย
jena	jena
historiography	historiography
rave	เพ้อ
taxon	taxon
bae	เบ
bae	เบเบ
bae	ที่รัก
bae	เบย์
bae	เบย
zee	ซี
garment	อาภรณ์
kisses	จุ๊บ
kisses	จูบ
sig	sig
rudd	รัดรูป
rudd	รัด
biz	วงการ
biz	biz
nguyen	nguyen
éireann	éireann
mule	ล่อ
kindness	น้ำใจ
deportation	เนรเทศ
bland	จืด
sincere	จริงใจ
awake	ตื่น
subsp	subsp
álvarez	álvarez
admiration	ชื่นชม
multiply	ทวีคูณ
multiply	คูณ
kei	เค
avoidance	เลี่ยง
nsa	nsa
protesting	ประท้วง
forerunner	forerunner
galatasaray	galatasaray
brace	รั้ง
ruthless	เหี้ยม
ruthless	อำมหิต
valentin	valentin
neue	neue
regression	ถดถอย
equator	เส้นศูนย์สูตร
equator	ศูนย์สูตร
ict	ict
glam	glam
fallout	fallout
anarchy	อนาธิปไตย
arias	arias
hacking	แฮ็ก
gama	กามา
eun	อุน
omnibus	omnibus
slice	เฉือน
laughter	หัวเราะ
glands	ต่อม
spd	spd
charismatic	บารมี
abstraction	นามธรรม
cid	cid
slides	สไลด์
temp	ชั่วคราว
adele	อะเดล
adele	อเดล
och	och
moors	ทุ่ง
encyclopædia	encyclopædia
tun	ตุน
constantin	constantin
mustard	มัสตาร์ด
hun	ฮุน
upton	upton
methane	มีเทน
keane	คีน
pollen	เกสร
yoon	ยุน
yoon	ยูน
chill	ชิล
chill	chill
jealousy	อิจฉา
diva	diva
coe	coe
litter	กระบะ
sfr	sfr
orr	orr
sikkim	sikkim
crushing	บดขยี้
permissions	สิทธิ์
heraldic	heraldic
msnbc	msnbc
elves	เอลฟ์
rockwell	ร็อคเวลล์
olympian	โอลิมปิค
turk	เติร์ก
turk	turk
sql	sql
stuffed	ยัด
pcs	พีซ
squid	ปลาหมึก
milo	milo
milo	ไมโล
ryu	ริว
overture	โหมโรง
ipad	ipad
newell	newell
mcmillan	mcmillan
oven	เตา
atm	atm
atm	เอทีเอ็ม
dormitory	หอพัก
univ	univ
jolly	jolly
jolly	ร่าเริง
jolly	รื่นเริง
ubuntu	ubuntu
charcoal	ถ่าน
salad	สลัด
needles	เข็ม
duluth	duluth
tee	tee
jasmine	มะลิ
moons	พระจันทร์
innsbruck	innsbruck
olympique	olympique
frescoes	frescoes
epsom	epsom
riddle	ปริศนา
günther	günther
münster	münster
federalist	federalist
haarlem	haarlem
standardization	standardization
dateformat	dateformat
cookies	คุกกี้
telegram	โทรเลข
fips	fips
scaleminor	scaleminor
swear	สาบาน
oops	อุ๊บ
oops	อุ๊ย
oops	อ๊ะ
ferrer	ferrer
arrogant	หยิ่ง
elle	แอล
nepali	เนปาล
cones	กรวย
maitland	maitland
seton	seton
barron	barron
montagu	montagu
csa	csa
coco	coco
praying	ภาวนา
boo	boo
boo	บู
boo	บู้
fujian	fujian
gland	ต่อม
angie	angie
vivo	vivo
parodies	parodies
menon	menon
override	แทนที่
unión	unión
thuringia	thuringia
stir	ผัด
spoon	ช้อน
oldid	oldid
lasers	เลเซอร์
magyar	magyar
worldcat	worldcat
grill	ย่าง
evacuate	อพยพ
faq	faq
intern	ฝึกงาน
cpc	cpc
sneak	แอบ
antónio	antónio
bam	แบม
bam	bam
reckless	สะเพร่า
reckless	มุทะลุ
seminole	seminole
harassing	ก่อกวน
mercenary	รับจ้าง
svenska	svenska
azad	azad
gardener	คนสวน
spikes	หนาม
residual	ตกค้าง
fountains	น้ำพุ
dissolve	ละลาย
duane	ดวน
masjid	มัสยิด
amp	amp
amp	แอมป์
yoo	ยู
balloons	บอลลูน
gnome	gnome
instinct	สัญชาตญาณ
deutschland	deutschland
crowns	มงกุฎ
losers	ขาดทุน
pau	pau
townsville	townsville
michelin	michelin
homme	homme
horsepower	แรงม้า
valladolid	valladolid
tung	tung
adm	adm
dns	dns
pavement	ทางเท้า
braking	เบรก
grinding	บด
apa	apa
combo	คอมโบ
pentecostal	pentecostal
nasser	nasser
himalayan	himalayan
himalayan	หิมาลัย
soccerway	soccerway
sakura	ซากุระ
maison	maison
nawab	nawab
sway	แกว่ง
sway	sway
toilets	ส้วม
frazier	frazier
maths	คณิตศาสตร์
piotr	piotr
gaul	กอล
botanic	botanic
smackdown	smackdown
schloss	schloss
abdel	abdel
lid	ฝา
dunlop	dunlop
carmichael	คาร์ไมเคิล
snack	ขนม
jalan	jalan
naia	naia
mun	มูล
mun	mun
subgenus	subgenus
izmir	izmir
nytimes	nytimes
deng	เติ้ง
deng	เตง
nur	nur
cmll	cmll
antagonists	antagonists
clover	clover
soy	soy
couch	โซฟา
confess	สารภาพ
spreads	แพร่
andrey	andrey
colourful	สีสัน
bump	ตุ่ม
bump	กระแทก
paranoid	หวาดระแวง
paranoid	ระแวง
gel	เจล
risky	เสี่ยง
nbl	nbl
gesellschaft	gesellschaft
funky	funky
sato	sato
pronoun	สรรพนาม
mango	mango
mango	มะม่วง
astra	astra
banco	banco
adolph	adolph
jelly	jelly
arg	arg
oder	oder
icao	icao
blanca	blanca
battista	battista
crises	วิกฤตการณ์
crises	วิกฤต
pill	เม็ด
marge	มาร์
crooked	คด
crooked	เบี้ยว
cbd	cbd
iqbal	iqbal
folder	โฟลเดอร์
ipod	ipod
batter	แรงๆ
beads	ประคำ
creditors	หนี้
mimi	mimi
dakar	ดาการ์
pots	หม้อ
anatomical	วิภาค
anatomical	กายวิภาค
andrzej	andrzej
scala	scala
insulation	ฉนวน
rodrigues	rodrigues
tyres	ยาง
vines	องุ่น
rss	rss
lust	ราคะ
lust	ตัณหา
gratitude	กตัญญู
naga	นาคา
whisky	วิสกี้
lycée	lycée
mort	มอร์ท
baggage	สัมภาระ
slick	เนียน
sigismund	sigismund
hurts	เจ็บ
saba	สะ
jimi	jimi
kia	เกียด
kia	เกีย
waffen	waffen
outrageous	ฝ่าฝืน
outrageous	อุกอาจ
tomás	tomás
aix	aix
router	เตอร์
plastics	พลาสติก
distracted	ใจลอย
stéphane	stéphane
furnished	ตกแต่ง
anarchists	อนาธิปไตย
pst	pst
gadget	gadget
józef	józef
ligament	เอ็น
projective	projective
dentist	ทันตแพทย์
adi	อาทิ
skirt	กระโปรง
csi	csi
phosphorus	ฟอสฟอรัส
char	ชาร์
mccall	คอล
triangles	สามเหลี่ยม
arundel	arundel
wrestlemania	wrestlemania
javanese	ชวา
sedimentary	ตะกอน
linn	linn
heresy	นอกรีต
sejm	sejm
tak	ตาก
bukit	บูกิต
widowed	หม้าย
oldenburg	oldenburg
gaulle	โกล
huh	หือ
humber	humber
mbc	mbc
spit	คาย
fianna	fianna
polydor	polydor
libertadores	libertadores
dod	กลาโหม
dod	dod
preschool	อนุบาล
forsyth	forsyth
mcfarland	mcfarland
marriott	marriott
ymca	ymca
cries	ร้องไห้
tds	tds
nirvana	นิพพาน
falkirk	falkirk
transliteration	transliteration
tabs	แท็บ
tuna	ทูน่า
mushrooms	เห็ด
resin	เกด
wiesbaden	wiesbaden
bayou	bayou
malvern	malvern
situ	situ
egan	egan
bandit	โจร
afi	afi
bash	bash
bash	ทุบ
hormones	ฮอร์โมน
liter	ลิตร
spurious	spurious
kun	คุง
fulbright	fulbright
calf	ลูกวัว
enriched	อุดม
selena	selena
maher	maher
vertebrates	vertebrates
joshi	joshi
seaplane	seaplane
harpercollins	harpercollins
cigar	ซิการ์
orthogonal	orthogonal
hypotheses	hypotheses
bless	พร
bless	อวยพร
pia	เพียร์
patna	patna
blindness	ตาบอด
abba	abba
asean	อาเซียน
absorbing	หมก
anxious	กระวนกระวาย
cocoa	โกโก้
expressive	เริงร่า
kok	ก๊ก
kew	kew
ammonia	แอมโมเนีย
trujillo	trujillo
convertible	ประทุน
riff	riff
popmatters	popmatters
alleviate	บรรเทา
wadi	wadi
joaquín	joaquín
cham	จาม
afp	afp
cultivars	cultivars
himalayas	หิมาลัย
inhibit	inhibit
raft	แพ
boon	บุญ
occidental	occidental
esporte	esporte
westport	westport
authoritarian	เผด็จการ
zodiac	ราศี
zodiac	จักรราศี
bra	บรา
barbuda	บาร์บูดา
grenoble	grenoble
braunschweig	braunschweig
cock	จู๋
krasnodar	krasnodar
adorned	ประดับ
internship	ฝึกงาน
sync	ซิงค์
philanthropy	ทำบุญ
spec	สเปค
spec	spec
durable	ทนทาน
ddr	ddr
wellness	สุขภาพ
hermes	hermes
władysław	władysław
yuki	ยูกิ
beverley	beverley
slap	ตบ
trident	สามง่าม
subunit	subunit
trousers	กางเกง
jiménez	jiménez
kunst	kunst
consultative	consultative
stratigraphic	stratigraphic
plurality	plurality
naacp	naacp
warlord	ขุนศึก
rhein	rhein
ipc	ipc
entertain	บันเทิง
simulate	จำลอง
gustaf	gustaf
messy	เลอะเทอะ
messy	วุ่นวาย
messy	ยุ่งเหยิง
biota	biota
chunk	ท่อน
iberia	iberia
nyu	nyu
selby	selby
