mhz	mhz
secular	மதச்சார்பற்ற
tracking	கண்காணிப்பு
tracking	தடமறிதல்
spa	ஸ்பா
publicity	publicity
watts	வாட்ஸ்
gibraltar	ஜிப்ரால்டர்
renewed	renewed
fever	காய்ச்சல்
melody	மெல்லிசை
supporter	ஆதரவாளர்
jeffrey	ஜெஃப்ரி
surnames	surnames
useless	பயனற்றது
tuesday	செவ்வாய்க்கிழமை
tuesday	செவ்வாய்
tuesday	செவ்வாய்கிழமை
empress	பேரழகி
newman	நியூமன்
jacksonville	ஜாக்சன்வில்
sara	சாரா
lifestyle	வாழ்வியல்
lifestyle	வாழ்க்கைமுறை
bee	தேனீ
bee	பீ
holders	holders
holders	வைத்திருப்பவர்கள்
baltic	பால்டிக்
brandon	பிராண்டன்
loaded	ஏற்றப்பட்ட
loaded	ஏற்றப்பட்டது
maya	மாயா
enterprises	enterprises
imo	imo
mature	முதிர்ந்த
physically	உடல்ரீதியாக
physically	உடலும்
breast	மார்பக
breast	மார்பகம்
breast	நெஞ்சத்தை
beast	மிருகம்
raja	ராஜா
für	für
griffin	கிரிஃபின்
rhodes	ரோட்ஸ்
ana	ஆனா
rainbow	வானவில்
prussian	prussian
equations	சமன்பாடுகள்
answered	பதிலளித்த
entities	தன்மைகள்
jackie	ஜாக்கி
dynamics	இயக்கவியல்
fiji	பிஜி
algebra	இயற்கணிதம்
homer	ஹோமர்
larvae	லார்வா
limestone	சுண்ணக்கல்
johns	ஜான்ஸ்
chaos	குழப்பம்
chaos	குழப்பமான
chang	சாங்
layers	அடுக்குகள்
crater	கிண்ணக்குழி
chad	சாட்
chad	சாத்
webster	வெப்ஸ்டர்
excess	அதிகப்படியான
ashley	ஆஷ்லே
dot	டாட்
dot	dot
gif	gif
translator	மொழிபெயர்ப்பாளர்
hanging	தொங்கும்
workshops	பட்டறைகள்
belarus	பெலாரஸ்
liked	விரும்பியது
liked	விரும்பப்பட்டது
liked	விரும்பினார்
applying	பூசும்
graduates	பட்டதாரிகள்
jungle	காடு
quarterly	காலாண்டு
romans	ரோமர்
rpm	rpm
diploma	பட்டயம்
diploma	diploma
circa	சிர்கா
swan	அன்னம்
carpenter	தச்சர்
petition	மனு
boris	போரிஸ்
berry	பெர்ரி
invention	கண்டுபிடிப்பு
bend	வளைத்து
app	பயன்பாட்டை
app	பயன்பாடு
app	பயன்பாட்டைப்
app	செயலி
draws	வரைகிறது
slight	கொஞ்சம்
drag	இழு
drag	இழுக்கவும்
drag	இழுத்து
maxwell	மேக்ஸ்வெல்
oriental	ஓரியண்டல்
coordinator	ஒருங்கிணைப்பாளர்
bombs	குண்டுகள்
bombs	வெடிகுண்டுகள்
mohammad	முகமது
mohammad	முகம்மது
superman	சூப்பர்மேன்
colombian	கொலம்பிய
felix	பெலிக்ஸ்
bengali	வங்காளம்
bengali	பெங்காலி
floating	மிதவை
floating	நடமாடும்
floating	மிதக்கும்
montenegro	மாண்டினீக்ரோ
mann	மன்
flooding	வெள்ளம்
flooding	வெள்ளப்பெருக்கு
escort	எஸ்கார்ட்
astronomy	வானியல்
sudden	திடீர்
variables	மாறிகள்
sphere	கோளம்
sphere	கோலம்
sphere	உருளை
sphere	கோளங்கள்
canvas	கேன்வாஸ்
chest	நெஞ்சு
chest	மார்பு
krishna	கிருஷ்ணர்
krishna	கிருஷ்ணா
krishna	கிருஷ்ண
provider	வழங்குநர்
provider	வழங்குவோர்
carved	செதுக்கப்பட்ட
poles	துருவங்கள்
civilization	நாகரிகம்
avoided	தவிர்க்க
lisbon	லிஸ்பன்
tongue	நாக்கு
tongue	நாக்கை
panels	பேனல்கள்
darwin	டார்வின்
cheese	சீஸ்
easter	ஈஸ்டர்
rat	எலி
papua	பப்புவா
insert	நுழை
insert	நுழைக்க
insert	செருகு
cry	அழ
cry	அழுகை
loyal	விசுவாசமான
loyal	விசுவாசமாக
nicolas	நிக்கோலஸ்
madonna	மடோனா
cooperative	கூட்டுறவு
substantially	substantially
trips	பயணங்களை
trips	பயணங்கள்
winston	வின்ஸ்டன்
llc	llc
drake	டிரேக்
lunar	சந்திர
fountain	நீரூற்று
fountain	ஊற்று
consulting	ஆலோசனை
patricia	பாட்ரிசியா
ers	ers
garcía	கார்சியா
rid	rid
maple	மேப்பிள்
aberdeen	அபர்தீன்
verb	வினைச்சொல்
mechanisms	பொறிமுறைகள்
posters	சுவரொட்டிகள்
leipzig	லீப்சிக்
santo	சாண்டோ
telecommunications	தொலைத்தொடர்பு
strait	நீரிணை
sherman	செர்மன்
stefan	ஸ்டீபன்
sleeping	உறங்க
sleeping	உறங்கும்
sleeping	தூங்கி
sleeping	தூங்கும்
alto	ஆல்டோ
thomson	தாம்சன்
alphabet	எழுத்துக்கள்
alphabet	அகரவரிசை
carnegie	கார்னிகி
eighteen	பதினெட்டு
shirt	சட்டையை
shirt	சட்டை
weird	வித்தியாசமான
loading	ஏற்றப்படுகிறது
plantation	plantation
acre	ஏக்கர்
wonderful	அதிசயமாக
wonderful	அற்புதமான
missiles	ஏவுகணைகள்
guides	வழிகாட்டிகள்
finger	விரலை
finger	விரல்
savage	காட்டுமிராண்டி
shoes	காலணி
shoes	காலணிகள்
climbing	ஏறுதல்
biographies	biographies
geoffrey	ஜெப்ரி
valve	வால்வ்
histories	வரலாறுகள்
osaka	ஒசாகா
monkey	குரங்கு
tackle	சமாளிக்க
listening	கேட்டு
listening	கவனித்தல்
listening	கேட்டுக்
integrity	சீர்மை
troop	படையாக
marina	மெரினா
marina	மெரீனா
detection	கண்டறிதல்
sixty	அறுபது
sixty	அறுபத்து
venus	வீனஸ்
salmon	சால்மன்
monarchy	முடியாட்சி
abortion	கருக்கலைப்பு
monica	மோனிகா
elephant	யானை
polar	துருவ
ton	டன்
counting	எண்ணும்
corn	சோளம்
trucks	டிரக்குகள்
deutsche	deutsche
absorbed	நினைப்பவர்கள்
tension	பதற்றம்
pablo	பாப்லோ
aviv	அவிவ்
cleaning	சுத்தம்
judgement	தீர்ப்பை
judgement	தீர்ப்பு
physicist	physicist
disasters	பேரழிவுகள்
lesbian	லெஸ்பியன்
trailer	டிரெய்லர்
janet	ஜேனட்
aunt	அத்தை
shallow	ஆழமற்ற
floors	தரைகள்
boyfriend	காதலன்
catholicism	கத்தோலிக்கம்
luther	லூதர்
constructive	ஆக்கபூர்வமான
webb	வெப்
alberto	ஆல்பர்டோ
magical	மந்திர
deliberately	வேண்டுமென்றே
sacrifice	தியாகத்தை
sacrifice	தியாகம்
olive	ஆலிவ்
compatible	இணக்கமான
molecules	மூலக்கூறுகள்
vista	விஸ்டா
castro	காஸ்ட்ரோ
wei	வெய்யில்
wei	வெய்
miscellaneous	மற்றவை
ultra	அல்ட்ரா
clinic	கிளினிக்
clinic	மருத்துவமனை
itunes	itunes
pollution	மாசு
treasurer	பொருளாளர்
herman	ஹெர்மன்
questionable	கேள்விக்குரிய
sally	சாலி
rex	ரெக்ஸ்
stuck	மாட்டிக்
openly	வெளிப்படையாக
afghan	ஆப்கான்
vatican	வத்திக்கான்
folklore	நாட்டாரியல்
silk	பட்டு
silk	சில்க்
eng	eng
differently	வித்தியாசமாக
cage	கூண்டு
ferguson	ferguson
correspondence	correspondence
tehran	தெஹ்ரான்
cheshire	cheshire
pos	pos
bye	பை
bye	வருகிறேன்
employer	நிறுவனம்
tibetan	திபெத்திய
nixon	நிக்சன்
sociology	சமூகவியல்
chocolate	சாக்கலேட்
chocolate	சாக்லெட்
chocolate	சாக்லேட்
bedford	பெட்போர்ட்
cambodia	கம்போடியா
grandmother	பாட்டி
fitness	உடற்தகுதி
fitness	உடற்பயிற்சி
jung	ஜங்
libya	லிபியா
gather	ஒன்று
android	அண்ட்ராய்டு
android	android
android	ஆண்ட்ராய்டு
filmography	filmography
mentor	ஆசான்
freeman	ஃபிரீமன்
apartments	குடியிருப்புகள்
puppet	கைப்பாவை
hiding	மறைத்தல்
meyer	மேயர்
lima	லீமா
kirk	கிர்க்
batteries	பேட்டரிகள்
ucla	ucla
recover	மீட்க
recover	மீட்டெடுக்க
wong	வோங்
ear	காது
ear	செவி
ear	காதில்
servants	அடியார்கள்
decent	சுமாராக
decent	ஒழுக்கமான
cubs	குட்டிகள்
deputies	deputies
hawk	ஹாக்
altar	பீடம்
subjective	subjective
determination	தீர்மானம்
chennai	சென்னை
dong	டாங்
myanmar	மியான்மர்
proud	பெருமை
proud	பெருமையாக
custody	பாதுகாப்பில்
penny	பென்னி
kannada	கன்னட
kannada	கன்னடம்
rector	rector
petroleum	பெட்ரோலிய
petroleum	பெட்ரோலியம்
bug	வழு
bug	பக்
proceed	தொடரவும்
proceed	தொடர்
chapman	சேப்மன்
mud	சேற்றில்
mud	சேறு
honey	தேன்
diagram	வரைப்படம்
complexity	சிக்கலானது
displacement	displacement
sponsor	ஸ்பான்சர்
ira	இரா
condemned	கண்டனம்
careers	careers
haiti	ஹெய்டி
wisdom	ஞானம்
wisdom	ஞானத்தை
pierce	துளைத்து
pierce	பியர்ஸ்
stupid	முட்டாள்தனமாக
stupid	முட்டாள்
alexandra	அலெக்ஸாண்ட்ரா
continuously	தொடர்ச்சியாக
shuttle	ஷட்டில்
hampton	ஹாம்ப்டன்
eva	ஈவா
eva	இவா
yuan	யுவான்
lynch	லிஞ்ச்
ecclesiastical	ecclesiastical
destroying	அழிக்கிறார்
trunk	ட்ரங்க்
genuine	உண்மையான
adolf	அடால்ப்
sharon	ஷரோன்
hung	தொங்க
locked	பூட்டிய
mohammed	முகமது
mohammed	mohammed
dish	டிஷ்
terrible	பயங்கரமான
terrible	பயங்கர
reagan	ரீகன்
rebecca	ரெபேக்கா
indefinitely	காலவரையின்றி
divide	ஊர
recommendations	பரிந்துரைகள்
ideology	கருத்தியல்
ideology	சித்தாந்தம்
carriers	கேரியர்கள்
fatal	ஆபத்தாக
modeling	மாடலிங்
monsters	அசுரர்கள்
bulls	காளைகள்
harassment	தொந்தரவு
harassment	துன்புறுத்தல்
censorship	தணிக்கை
favorable	சாதகமானது
paramount	பாராமவுண்ட்
luxury	சொகுசு
luxury	ஆடம்பர
luxury	ஆடம்பரம்
yahoo	யாஹூ
ecology	சூழலியல்
emirates	எமிரேட்ஸ்
neutrality	சமத்துவம்
chronicles	நாளாகமம்
lepidoptera	lepidoptera
blast	வெடிப்பு
jenkins	ஜென்கின்ஸ்
omaha	ஒமஹா
detected	கண்டறியப்பட்டுள்ளது
detected	கண்டறியப்பட்டது
attribution	ஒதுக்கீடு
harsh	ஹர்ஷ்
hermann	ஹெர்மன்
roma	ரோமா
echo	எதிரொலி
bangkok	பாங்காக்
bergen	பேர்கன்
hawks	ஹாக்ஸ்
lung	நுரையீரல்
andreas	andreas
cedar	சீடர்
bankruptcy	திவால்
basement	அடித்தள
spirits	மதுபானங்கள்
torture	சித்திரவதை
torture	இம்சை
toyota	டொயோட்டா
wheat	கோதுமை
examined	examined
membrane	சவ்வு
knockout	நாக்அவுட்
coleman	கோல்மன்
homeland	தாய்நாடு
dhaka	டாக்கா
dental	பல்
christine	கிறிஸ்டின்
tucker	டக்கர்
responsibilities	பொறுப்புகள்
communists	கம்யூனிஸ்டுகள்
fantastic	அட்டகாசம்
fantastic	அருமை
ceremonies	சடங்குகள்
augustus	அகஸ்டஸ்
loans	கடன்கள்
loans	கடன்
joey	ஜோய்
moss	மோஸ்
parody	பகடி
sizes	அளவுகள்
armored	கவச
cheap	மலிவான
backup	காப்பு
forbidden	தடுக்கப்பட்டு
sanskrit	சமஸ்கிருதம்
sanskrit	சமஸ்கிருதத்தில்
sanskrit	சமஸ்கிருத
councillor	கவுன்சிலர்
knife	கத்தி
wade	வேட்
humanities	மனிதநேயம்
gonzález	gonzález
yesterday	நேற்று
yesterday	நேற்றைய
percy	பெர்சி
dams	dams
dams	அணைகள்
plural	பன்மை
filmmaker	filmmaker
speeds	இயலாதது
zip	ஜிப்
zip	அஞ்சல்
zip	சுருக்கு
updates	புதுப்பிப்புகள்
updates	புதுப்பித்தல்கள்
lin	லின்
siblings	உடன்பிறப்புகள்
measurements	அளவியல்
uttar	உத்தரப்
tide	டைட்
laps	சுற்றுக்கள்
dynamo	டைனமோ
predicted	கணித்த
poker	போக்கர்
kane	கேன்
trevor	டிரெவர்
reprinted	reprinted
attractive	கவர்ச்சிகரமான
holidays	விடுமுறை
holidays	விடுமுறைகள்
comfortable	வசதியாக
comfortable	வசதி
fletcher	பிளெட்சர்
airways	ஏர்வேஸ்
floyd	ஃபிலாய்ட்
snail	நத்தை
genocide	இனப்படுகொலை
saga	சாகா
kingdoms	பேரரசுகள்
archdiocese	archdiocese
buying	வாங்குதல்
commissioners	commissioners
smoking	புகை
leather	தோல்
leather	லெதர்
porto	போர்டோ
valencia	வலென்சியா
subfamily	subfamily
tracy	ட்ரேசி
subspecies	subspecies
andhra	ஆந்திரா
andhra	ஆந்திர
mercy	கருணை
mercy	ரஹ்மத்
ore	தாது
ore	ore
lone	லோன்
bottle	பாட்டில்
bottle	bottle
tunisia	துனீசியா
angola	அங்கோலா
humanitarian	மனிதாபிமான
decorations	அலங்காரங்கள்
slide	படவில்லை
invalid	தவறானது
invalid	செல்லாத
rao	ராவ்
guru	குரு
telescope	தொலைநோக்கி
dense	அடர்ந்த
satisfied	திருப்தி
satisfied	திருப்திகரமாக
coral	பவளம்
coral	பவள
coral	கோரல்
xavier	சேவியர்
helena	ஹெலெனா
anatomy	உடற்கூறு
binary	இருநிலை
wound	புண்
wound	காயத்தை
wound	காயம்
dixon	டிக்சன்
kuwait	குவைத்
ridiculous	அபத்தமானது
nsw	nsw
caves	குகைகள்
shane	ஷேன்
fitzgerald	ஃபிட்ஸ்கெரால்ட்
payments	கட்டணங்கள்
lópez	லோபஸ்
joyce	ஜாய்ஸ்
belle	பெல்லி
davidson	டேவிட்சன்
rouge	ரூச்
rockets	ராக்கெட்டுகள்
cure	குணப்படுத்த
manning	மானிங்
boyd	boyd
organisms	உயிரினங்கள்
paraguay	பராகுவே
preview	முன்னோட்டம்
preview	முன்தோற்றம்
qatar	கத்தார்
import	இறக்குமதி
import	உள்வாங்கு
buddy	நண்பா
iucn	iucn
dock	டாக்
penguin	பெங்குயின்
cologne	கொலோன்
providers	வழங்குவோர்
challenging	சவால்
challenging	சவாலான
anthem	கீதம்
investigator	துப்பறிவாளர்
ming	மிங்
lease	குத்தகை
cecil	செசில்
toys	பொம்மைகள்
conrad	கொன்ராட்
buck	பக்
italia	இத்தாலியா
portable	போர்ட்டபிள்
dell	டெல்
irving	இர்விங்
bells	பெல்ஸ்
tibet	திபெத்
salary	சம்பளம்
enhance	மேம்படுத்து
staying	தங்கி
objectives	குறிக்கோள்கள்
objectives	நோக்கங்கள்
caesar	சீசர்
unesco	யுனெஸ்கோ
cameroon	கேமரூன்
carson	கார்சன்
slot	அடுக்கு
sophie	சோபி
granite	கிரானைட்
granite	கருங்கல்
jenny	ஜென்னி
deciding	தீர்மானிக்கும்
comparative	ஒப்பீட்டு
seasonal	பருவகால
portfolio	போர்ட்ஃபோலியோ
machinery	யந்திரம்
embedded	உட்பொதிந்த
keen	குறியாக
gandhi	காந்தி
testimony	சாட்சியம்
testimony	சான்று
reflection	பிரதிபலிப்பு
middlesex	மிடில்செக்ஸ்
booth	பூத்
booth	பூத்து
rudolf	ருடோல்ப்
león	லியொன்
userpage	userpage
courage	தைரியம்
riots	கலவரங்கள்
riots	கலவரம்
formatting	வடிவமைத்தல்
auction	ஏலம்
cbc	cbc
specifications	வரையறைகள்
secrets	ரகசியங்கள்
secrets	இரகசியங்கள்
ups	ups
repairs	பழுது
phantom	phantom
hartford	hartford
alps	ஆல்ப்ஸ்
liner	லைனர்
investments	முதலீடுகள்
auburn	ஆபர்ன்
flame	சுடர்
din	din
rent	வாடகை
crane	கொக்கு
simulation	பாவனை
latitude	அட்சரேகை
lance	லான்ஸ்
networking	நெட்வொர்க்கிங்
wanderers	wanderers
fixing	பொறுத்தல்
asset	சொத்து
prospect	prospect
prospect	வாழ்த்துகிறோம்
prejudice	பாரபட்சம்
stance	பரிணாமத்தை
gloria	குளோரியா
yemen	ஏமன்
riot	கலகம்
riot	கலவரம்
renovation	சீரமைப்பு
excluded	சேர்க்கப்படாத
elena	எலினா
anger	கோபம்
decoration	அலங்காரம்
nerve	நரம்பு
disability	இயலாமை
giuseppe	ஜூசெப்பே
boot	பூட்
scan	வருடு
scan	ஸ்கேன்
rca	rca
canberra	கான்பரா
flowing	பாய்கிறது
sensors	உணரிகள்
reservation	இடஒதுக்கீடு
elderly	வயதான
pbs	pbs
mapping	மேப்பிங்
mongolia	மங்கோலியா
nash	நாஷ்
sharks	சுறாக்கள்
ricky	ரிக்கி
shirley	ஷிர்லி
stopping	நிறுத்துதல்
stopping	நிறுத்துகிறது
exercises	பயிற்சிகள்
ribbon	ரிப்பன்
infant	குழந்தை
vikings	வைக்கிங்
reproduction	இனப்பெருக்கம்
sings	பாடுகிறார்
mercedes	மெர்சிடிஸ்
compliance	இணக்கம்
bombay	பாம்பே
bombay	பம்பாய்
barack	பராக்
transactions	பரிமாற்றம்
transactions	பரிவர்த்தனை
transactions	பரிமாற்றங்கள்
statute	statute
jerome	ஜெரோம்
shark	சுறா
referencing	referencing
stoke	ஸ்டோக்
bride	மணமகள்
bride	மணப்பெண்
criminals	குற்றவாளிகள்
lindsay	லின்ட்சே
automotive	தானியங்கி
automotive	வண்டி
automotive	வாகனம்
worry	கவலை
vacuum	வெற்றிடம்
johan	ஜொஹான்
inactive	செயல்படாத
celebrities	பிரபலங்கள்
meta	மெட்டா
estadio	estadio
corp	corp
leone	லியோன்
sailor	மாலுமி
racism	இனவாதம்
negro	நீக்ரோ
tears	கண்ணீர்
tears	கண்ணீரை
ancestors	முன்னோர்கள்
honda	ஹோண்டா
singular	ஒருமை
burden	சுமையை
burden	சுமை
fruits	கனி
fruits	பழங்கள்
ruby	மாணிக்கம்
ruby	ரூபி
nationalism	தேசியம்
classroom	வகுப்பறை
forums	அவ்வமைப்பு
forums	மன்றங்கள்
cups	cups
challenger	மீட்டரில்
recommendation	பரிந்துரையை
recommendation	பரிந்துரை
shi	ஷி
instant	உடனடி
falcon	falcon
planted	நடப்பட்ட
nordic	நோர்டிக்
hannah	ஹன்னா
dances	நடனங்கள்
saves	சேமிப்புகள்
bucharest	புக்கரெஸ்ட்
ranger	ரேஞ்சர்
lily	லில்லி
peterson	பீட்டர்சன்
wicket	விக்கெட்
calm	அமைதி
schmidt	ஸ்கிமிட்
contacts	தொடர்புகள்
deserves	தகுதியானவர்
hyderabad	ஐதராபாத்
hyderabad	ஹைதராபாத்
visa	விசா
pregnancy	கர்ப்பம்
expectations	எதிர்பார்ப்பு
expectations	எதிர்பார்ப்புகள்
carmen	கார்மென்
harvest	அறுவடை
flies	ஈக்கள்
flies	பறக்கிறது
kashmir	காஷ்மீர்
theft	திருட்டு
wesley	வெஸ்லி
pga	pga
beats	தாளங்கள்
beats	துடிக்கிறது
sterling	ஸ்டெர்லிங்
chances	வாய்ப்புகளை
chances	வாய்ப்புக்கள்
donna	டோனா
sonic	சோனிக்
transparent	ஊடு
transparent	ஊடுருவல்
dedication	அர்ப்பணிப்பு
nervous	நரம்பு
nervous	நரம்புத்
nervous	நரம்பியல்
excluding	தவிர்த்து
everywhere	எங்கும்
anthropology	மானிடவியல்
minds	மனங்கள்
reward	வெகுமதி
reward	கூலி
ally	ஆலி
ally	ally
primitive	primitive
gateway	நுழைவாயில்
lopez	லோபஸ்
chronic	தீராத
donations	நன்கொடைகளை
donations	நன்கொடைகள்
imaging	இமேஜிங்
duet	டூயட்
intel	இன்டெல்
winchester	வின்செஸ்டர்
buddha	புத்தரின்
buddha	புத்தர்
pig	பன்றி
pig	பன்னி
whale	திமிங்கலம்
beaches	கடற்கரைகள்
approaching	நெருங்கி
archipelago	தீவுக்கூட்டம்
attributes	குணங்கள்
attributes	பண்புகள்
minerals	கனிமங்கள்
minerals	தாதுக்கள்
frozen	உறைந்த
inherently	இயல்பாகவே
fischer	பிஷர்
dee	டீ
participant	பங்கேற்பாளர்
peaceful	அமைதியான
typhoon	சூறாவளி
hank	ஹாங்க்
manually	கைமுறையாக
verlag	verlag
shortened	சுருக்கப்பட்ட
arabian	அரேபிய
arabian	அரபிக்
ivory	ஐவரி
hastings	ஹேஸ்டிங்ஸ்
taxa	taxa
holly	ஹோலி
healing	குணப்படுத்தும்
frames	சட்டங்கள்
lorenzo	லாரென்சோ
risks	அபாயங்கள்
professors	பேராசிரியர்கள்
viking	வைக்கிங்
utc+	utc+
eden	ஈடன்
nielsen	nielsen
peruvian	பெருவிய
coloured	நிறமுள்ள
relevance	தொடர்புடையது
interference	குறுக்கீடு
candy	மிட்டாய்
bitter	கசப்பான
bitter	கசப்பு
flown	பறந்து
trends	போக்குகள்
funk	ஃபங்க்
bangalore	பெங்களூரு
bangalore	பெங்களூர்
pot	பானை
paths	பாதைகள்
var	var
guarantee	உத்தரவாதம்
raj	ராஜ்
aus	aus
patriarch	patriarch
blessed	பாக்கியம்
servers	சேவையகங்கள்
rabbit	முயல்
phi	ஃபை
phi	phi
sectors	sectors
corners	மூலைகள்
powder	பொடி
powder	பவுடர்
mega	மெகா
conservatives	பழமைவாதிகள்
wives	மனைவிகள்
vic	விக்
detect	கண்டறியும்
precision	துல்லியம்
precision	தவறு
precision	துல்லியமான
motivated	உந்துதல்
diaspora	diaspora
linguistics	மொழியியல்
savings	சேமிப்பு
underwater	நீருக்கடியில்
toxic	நச்சு
georgetown	ஜார்ஜ்டவுன்
screening	திரையிடல்
inaugurated	துவங்கப்பட்டது
rolls	ரோல்ஸ்
liver	கல்லீரல்
benedict	பெனடிக்ட்
mob	மாப்
dawson	டாசன்
emi	எமி
emi	emi
brett	பிரெட்
alert	எச்சரிக்கை
alert	நினைவூட்டல்
seventeen	பதினேழு
insisted	வலியுறுத்தினார்
loyalty	விசுவாசம்
reunion	ரீயூனியன்
patterson	patterson
collision	மோதல்
lighter	மென்மை
linnaeus	லின்னேயஸ்
filling	நிரப்புதல்
filling	நிரப்பும்
willis	வில்லிஸ்
secretly	ரகசியமாக
secretly	இரகசியமாக
vowel	உயிர்
encouraging	ஊக்குவிக்கும்
drainage	வடிகால்
seth	சேத்
kai	காய்
bermuda	பெர்முடா
wow	வாவ்
wow	ஆஹா
wow	ஆச்சர்யம்
factories	தொழிற்சாலைகள்
valentine	வேலண்டைன்
plasma	பிளாஸ்மா
virtue	நல்லொழுக்கம்
bryant	பிரையன்ட்
carnival	திருவிழா
bates	பேட்ஸ்
ballad	fry
insight	insight
kolkata	கொல்கத்தா
trafficking	கடத்தல்
ricardo	ரிக்கார்டோ
pearson	பியர்சன்
gaza	காசா
teachings	போதனைகள்
convent	கான்வென்ட்
neal	நீல்
frost	ஃப்ரோஸ்ட்
bugs	பிழைகள்
consistency	நிலைத்தன்மை
demanding	கோரி
fuller	ஃபுல்லர்
specially	குறிப்பாக
hansen	ஹான்சன்
lanes	லேன்ஸ்
whitney	விட்னி
adequately	adequately
limitations	வரம்புகள்
lateral	lateral
lovers	காதலர்கள்
intentions	நோக்கங்களை
prohibition	மதுவிலக்கு
acute	கடிய
container	கொள்கலன்
container	பெட்டகம்
upgrade	மேம்படுத்தவும்
upgrade	மேம்படுத்து
omar	உமர்
taipei	தாய்பெய்
torres	டோரஸ்
dining	சாப்பாட்டு
nicole	நிக்கோல்
locals	உள்ளூர்வாசிகள்
dishes	பாத்திரங்கள்
cove	கோவ்
pour	ஊற்றி
loud	சத்தம்
loud	சத்தமாக
loud	உரத்த
suspicious	சந்தேகத்திற்கிடமான
suspicious	சந்தேகத்திற்குரிய
noah	நோவா
eternal	நித்திய
terrestrial	புவிப்புறத்
tender	டெண்டர்
reflecting	பிரதிபலிக்கிறது
reflecting	பிரதிபலிக்கும்
yearly	வருடாந்திர
dudley	டட்லி
barrett	பாரெட்
fathers	தந்தையர்
fathers	மூதாதையர்கள்
pas	pas
denomination	denomination
feminine	பெண்மை
compression	நெருக்கம்
compression	இறுக்கம்
compression	அழுத்தம்
micro	மைக்ரோ
reef	பாறை
brady	ப்ராடி
walked	தவிக்க
walked	நடந்தார்
scenic	scenic
shadows	நிழல்
shadows	நிழல்கள்
monasteries	மடாலயங்கள்
rope	கயிறு
spare	உதிரி
cache	தற்காலிக
practitioners	practitioners
duplicate	பிரதி
duplicate	நகல்
ronnie	ரோனி
andre	ஆண்ட்ரே
mos	mos
transmitter	அனுப்புனர்
steal	திருட
tertiary	tertiary
pension	ஓய்வூதியம்
dolphins	டால்பின்கள்
metals	உலோகம்
metals	மெட்டல்
metals	உலோகங்கள்
teaches	போதிக்கிறது
oceania	ஓசியானியா
processor	ஆக்கி
prints	அச்சிட்டு
somalia	சோமாலியா
unblock	அனுமதி
switching	மாறுதல்
phillip	பிலிப்
pyramid	பிரமிட்
emeritus	emeritus
nina	நினா
val	வால்
gill	கில்
hiv	hiv
dash	dash
rita	ரீட்டா
nam	nam
peters	பீட்டர்ஸ்
tribunal	tribunal
stalin	ஸ்டாலின்
stadion	stadion
memoirs	memoirs
mayer	மேயர்
beaver	பீவர்
gonna	போகிறேன்
gustav	குஸ்டாவ்
spike	ஸ்பைக்
apps	பயன்பாடுகள்
carlton	கார்ல்டன்
hassan	ஹஸன்
hassan	ஹாசன்
hassan	ஹசன்
translate	மொழிபெயர்ப்பு
translate	மொழிபெயர்க்க
translate	முக்கோணம்
clayton	கிளேடன்
pistol	துப்பாக்கி
expired	காலாவதியான
benson	பென்சன்
acids	அமிலங்கள்
travis	டிராவிஸ்
distances	தூரங்களை
cow	மாடு
cow	பசு
accommodation	தங்குமிடம்
warwick	வார்விக்
textile	ஜவுளி
textile	துணி
sanders	சாண்டர்ஸ்
deadly	கொடியது
deadly	கொடிய
qualities	குணங்களை
marx	மார்க்ஸ்
chassis	chassis
usd	usd
phones	ஃபோன்கள்
phones	போன்கள்
weber	வெபர்
diane	டயான்
operative	operative
gazette	வர்த்தமானி
specify	குறிப்பிடு
specify	குறிப்பிடவும்
fritz	பிரிட்ஸ்
cloth	துணி
statues	சிலைகள்
qing	குயிங்
sheikh	ஷேக்
sheikh	சேக்
cafe	கஃபே
cafe	அருந்தகம்
breeds	இனங்கள்
orphan	அநாதை
orphan	அனாதை
monaco	மொனாக்கோ
meaningful	அர்த்தமுள்ள
invaded	படையெடுத்து
sen	சென்
berkshire	பெர்க்சையர்
illustrator	illustrator
celebrations	கொண்டாட்டங்கள்
beverly	பெவர்லி
macmillan	macmillan
strain	திரிபு
constitutes	constitutes
williamson	வில்லியம்சன்
pronunciation	உச்சரிப்பு
disco	டிஸ்கோ
talented	திறமையான
talented	திறமை
forestry	காடுகள்
exam	பரீட்சை
struggling	போராடிக்
struggling	போராடி
mood	மூட்
mood	மனநிலையை
mood	மனநிலை
wheeler	வீலர்
karachi	கராச்சி
karachi	கராச்சியில்
blackburn	பிளாக்பர்ன்
educators	கல்வியாளர்கள்
beth	பெத்
subpages	subpages
tunnels	சுரங்கங்கள்
wagon	வேகன்
offshore	container
darren	டேரன்
gerard	gerard
excuse	மன்னியுங்கள்
mohamed	முகம்மது
mohamed	mohamed
salon	சலூன்
checks	வட்டில்
trigger	விசைகள்
enabling	இயக்குகிறது
shoots	படப்பிடிப்பு
pipes	குழாய்கள்
invisible	கண்ணுக்குத்
ibrahim	இப்ராஹிம்
ibrahim	இப்ராஹீம்
ibrahim	இப்ராகிம்
coronation	முடிசூட்டு
tobago	டொபாகோ
werner	வெர்னர்
gifts	பரிசுகள்
confirmation	உறுதிப்பாடு
confirmation	உறுதிப்படுத்தல்
confirmation	உறுதிப்படுத்துதல்
jupiter	ஜூபிடர்
jupiter	வியாழன்
jupiter	செவ்வாய்
prophet	தீர்க்கதரிசி
prophet	நபி
prophet	நபியின்
taxi	டாக்ஸி
taxi	டாக்சி
refuse	மறுக்க
deserve	தகுதி
detention	தடுத்து
detention	தடுப்பு
persistent	விடாப்பிடியாக
diagnosed	கண்டறியப்பட்டது
iris	ஐரிஸ்
dad	அப்பாவும்
dad	அப்பா
abbot	abbot
elvis	எல்விஸ்
mel	மெல்
laboratories	ஆய்வகங்கள்
fabric	துணி
seas	ஒன்றோடொன்று
seas	கடல்கள்
shin	ஷின்
clip	கிளிப்
villain	வில்லன்
chemicals	இரசாயனங்கள்
replaceable	replaceable
astronomer	வானியலாளர்
immune	நோயெதிர்ப்பு
flexible	நெகிழ்வான
samoa	சமோவா
tai	தாய்
gamma	காமா
triumph	வெற்றியாகும்
prefix	முன்னொட்டு
communism	பொதுவுடைமை
communism	கம்யூனிசம்
stark	ஸ்டார்க்
greeks	கிரேக்கர்கள்
souls	ஆன்மாக்கள்
souls	மனம்
renewable	புதுப்பிக்கத்தக்க
cameo	கௌரவ
unemployment	வேலைவாய்ப்பின்மை
racist	இனவெறி
racist	இனவாத
torn	கிழிந்து
baghdad	பாக்தாத்
malay	மலாய்
dana	தனா
dana	டானா
clarinet	கிளாரினெட்
sodium	சோடியம்
moldova	மால்டோவா
crow	காகம்
interrupted	தடங்கல்
arise	எழுந்தருளும்
pseudonym	புனைபெயர்
eclipse	கிரகணம்
philharmonic	philharmonic
christie	கிறிஸ்டி
christie	கிரிஸ்டி
christina	கிறிஸ்டினா
countryside	கிராமப்புறங்களில்
angelo	ஆஞ்சலோ
lincolnshire	lincolnshire
regina	ரெஜினா
rectangular	நீள்சதுர
algorithms	algorithms
constituent	constituent
sánchez	sánchez
genius	மேதை
punch	குத்து
clash	மோதல்கள்
charities	தர்மங்களை
abdullah	அப்துல்லா
abdullah	அப்துல்லாஹ்
remedy	பரிகாரம்
comfort	ஆறுதல்
comfort	வசதி
helicopters	ஹெலிகாப்டர்கள்
shooter	சுடுதல்
shooter	சுடும்
lotus	தாமரைப்
lotus	தாமரை
dwarf	குள்ள
affecting	பாதிக்கிறது
antwerp	antwerp
fold	மடி
knox	நாக்ஸ்
tri	திரி
socialism	சோசலிசம்
sandstone	மணற்கல்
renault	ரெனால்ட்
fleming	ஃபிளெமிங்
judy	ஜூடி
infected	பாதிக்கப்பட்ட
happiness	மகிழ்ச்சி
happiness	மகிழ்ச்சியை
happiness	சந்தோசம்
warehouse	கிடங்கு
miracle	அதிசயம்
kindergarten	மழலையர்
synthetic	செயற்கை
waterloo	வாட்டர்லூ
sage	முனிவர்
accepts	அனுமதிகள்
irregular	வழக்கத்தில்
atom	அணு
normandy	நார்மாண்டி
shiva	சிவா
shiva	சிவன்
tudor	டியூடர்
alfonso	அல்போன்சோ
alfonso	அல்போன்சா
badminton	பூப்பந்து
fiber	இழை
fiber	நார்
mice	எலிகள்
tired	சோர்வு
tired	சோர்வாக
wage	கூலி
fingers	விரல்கள்
fingers	விரல்களால்
fingers	விரல்களை
cest	cest
loving	அன்பான
worried	கவலை
worried	கவலையாக
gambling	சூதாட்டம்
gambling	சூது
mothers	தாய்மார்கள்
auditorium	அரங்கம்
poison	நஞ்சு
poison	விஷம்
gujarat	குஜராத்
royals	ராயல்ஸ்
yan	யான்
parsons	பார்சன்ஸ்
mafia	மாபியா
deny	மறு
shapes	கூர்மை
shapes	வடிவங்கள்
madras	மதராஸ்
madras	மெட்ராஸ்
professionally	தொழில்முறையில்
essence	சாரம்
emotions	உணர்ச்சிகளை
paperback	பேப்பர்பேக்
domains	டொமைன்கள்
domains	தளங்கள்
mets	mets
pike	pike
pike	பைக்
cellular	செல்லுலார்
examine	ஊதியங்கள்
unexpected	எதிர்பாராத
dab	dab
bmw	bmw
realistic	யதார்த்தமான
barton	தொழுவம்
miranda	மிராண்டா
plug	அடைப்பை
spreading	பரப்புகிறது
puzzle	புதிர்
diamonds	வைரங்கள்
roses	ரோஜாக்கள்
competitor	வாடிக்கையாளர்
midway	மிட்வே
germanic	செருமானிய
urdu	உருது
rides	சவாரிகள்
scratch	கீறல்
scratch	தேய்த்து
lahore	லாகூர்
pipeline	பைப்லைன்
levy	லெவி
rodriguez	ரோட்ரிக்ஸ்
affects	பாதிக்கிறது
pac	pac
jules	ஜூல்ஸ்
archer	ஆர்ச்சர்
promises	சத்தியங்கள்
remake	ரீமேக்
forts	கோட்டைகள்
rendering	தருவிக்கும்
judith	ஜூடித்
salisbury	சாலிஸ்பரி
discoveries	கண்டுபிடிப்புகள்
cope	கோப்
beds	படுக்கைகள்
howe	howe
calcutta	கல்கத்தா
stems	ஸ்டெம்
dubious	தோன்றுகின்றன
desperate	வெறி
lafayette	lafayette
uniforms	சீருடைகள்
tips	குறிப்புகள்
partition	பிரிவினை
sigma	சிக்மா
reporters	நிருபர்கள்
aurora	அரோரா
goodbye	குட்பை
pepper	மிளகு
drunk	குடித்து
drunk	குடித்துவிட்டு
swim	நீந்தி
swim	நீச்சல்
swim	நீந்த
lexington	lexington
persecution	துன்புறுத்தல்
expenses	செலவுகள்
higgins	ஹிக்கின்ஸ்
query	கேள்வி
query	வினவல்
byron	பைரன்
pérez	பெரெஸ்
fool	முட்டாள்
downs	தாழ்வும்
brave	தைரியமாக
brave	அஞ்சா
mozart	மொசார்ட்
noel	நோயல்
inventory	சரக்கு
ethiopian	எத்தியோப்பிய
evaluate	மதிப்பிடு
meanings	அர்த்தங்கள்
rgb	rgb
imagination	கற்பனை
barber	பார்பர்
reich	ரெய்க்
desktop	மேசை
desktop	டெஸ்க்டாப்
demolition	தகர்ப்பு
natives	இனப்படுகொலைகள்
ancestor	மூதாதை
fence	வேலி
retaining	பேணுவதில்
rna	மனிதனிடம்
algerian	அல்ஜீரிய
wii	வீ
cone	கூம்பு
württemberg	வுயர்ட்டம்பெர்கு
continuity	ஓவியங்களுக்கு
clouds	மேகங்கள்
owl	ஆந்தை
struggles	போராட்டங்கள்
namibia	நமிபியா
romeo	ரோமியோ
reduces	குறைக்கிறது
lonely	தனிமையாக
lonely	தனிமையில்
lonely	தனிமை
deaf	செ
deaf	செவிடு
structured	கட்டமைக்கப்பட்ட
newsletter	செய்திமடல்
ink	மை
dwight	dwight
menu	மெனு
menu	பட்டி
paolo	paolo
commercials	வர்த்தகம்
faithful	நம்பிக்கை
faithful	நம்பிக்கையாக
faithful	ஈமான்
knock	நாக்
lamb	லாம்ப்
storms	புயல்
storms	புயல்கள்
logistics	தளவாடங்களை
satellites	செயற்கைக்கோள்கள்
dub	டப்
fin	துடுப்பு
trump	டிரம்ப்
kidnapped	கடத்தப்பட்ட
wounds	காயங்கள்
wounds	காயங்களை
turtle	ஆமை
greenwich	கிரீன்விச்
cake	கேக்
pulse	பல்ஸ்
eaten	சாப்பிட்ட
irrigation	irrigation
kyoto	கியோட்டோ
labrador	லாப்ரடோர்
vera	vera
honestly	நேர்மையாக
validity	validity
validity	முறையான
pays	செலுத்துகிறது
curse	சாபம்
breakthrough	திருப்புமுனை
cycles	சுழல்கள்
node	முடிச்சு
europeans	ஐரோப்பியர்கள்
europeans	ஐரோப்பியர்
habit	பழக்கவழக்கங்கள்
habit	பழக்கம்
viewer	காட்டி
russians	ரஷ்யர்கள்
analyst	ஆய்வாளர்
igor	இகோர்
filing	தாக்கல்
generator	இயற்றி
generator	உருவாக்கி
bahrain	பஹ்ரைன்
twist	திருப்பம்
twist	ட்விஸ்ட்
griffith	கிரிஃபித்
aston	ஆஸ்டன்
bordered	bordered
nicaragua	நிக்கராகுவா
premium	பிரீமியம்
mayo	மாயோ
walton	வால்டன்
stevenson	ஸ்டீவன்சன்
colleague	சக
curves	வளைவுகள்
xii	xii
jacobs	ஜேக்கப்ஸ்
raven	ரேவன்
dig	dig
dig	தோண்ட
patents	patents
usc	usc
searched	தேடப்பட்ட
searched	தேடிய
clifford	கிளிஃபோர்ட்
hemisphere	அரைக்கோளம்
thrust	அழுத்தம்
predators	தோற்றார்
panic	பீதி
panic	திகில்
aaa	aaa
teresa	தெரசா
teresa	தெரேசா
warming	வெப்பமடைதல்
hunger	பசி
ears	காதுகளில்
ears	காதுகள்
laurent	laurent
burnt	நொந்து
burnt	எரிந்த
courtesy	உபயம்
courtesy	courtesy
courtesy	உபசாரம்
rodney	ரோட்னி
encyclopaedia	encyclopaedia
subscription	சந்தா
perspectives	கண்ணோட்டங்கள்
pasha	பாஷா
amber	அம்பர்
rows	வரிகள்
functionality	ஜாதக
ave	ave
ave	மரியே
pts	pts
deity	கடவுள்
shocked	அதிர்ந்து
shocked	அதிர்ச்சியாக
shocked	அதிர்ச்சி
conway	கான்வே
protesters	எதிர்ப்பாளர்கள்
inflation	பணவீக்கம்
academia	academia
hancock	ஹான்கொக்
passport	பாஸ்போர்ட்
passport	கடவுச்சீட்டு
creators	படைப்பாளிகள்
baba	பாபா
viral	வைரல்
clearing	clearing
tab	தாவல்
tab	தத்தல்
tab	தத்து
inscriptions	கல்வெட்டுகள்
shame	வெட்கம்
shame	அவமானம்
genetics	மரபியல்
motivation	ஊக்கம்
yoga	யோகம்
yoga	யோகா
rotterdam	ராட்டர்டாம்
marvin	மார்வின்
laurel	லாரல்
balloon	பலூன்
greenland	கிரீன்லாந்து
rahman	ரஹ்மான்
rahman	ரகுமான்
ivy	ஐவி
screw	முறுக்கு
surprising	ஆச்சரியமான
sandra	சாண்ட்ரா
mali	மாலி
baku	பாலகுமாரன்
baku	பாகு
stranger	அந்நியன்
installations	நிறுவல்கள்
payne	பெய்ன்
ferrari	ஃபெராரி
shoe	ஷூ
gfdl	gfdl
voter	வாக்காளர்
resolutions	தெளிவுத்திறன்
resolutions	தீர்மானங்கள்
silicon	திடமான
silicon	சிலிக்கான்
rage	ஆத்திரம்
brent	பிரண்ட்
aliens	ஏலியன்ஸ்
cao	சாவோ
nucleus	கரு
practically	நடைமுறையில்
simmons	சிம்மன்ஸ்
promotes	ஊக்குவிக்கிறது
tooth	பல்
tooth	டூத்
uranium	யுரேனியம்
clusters	குழுமங்கள்
zambia	சாம்பியா
isabella	இசபெல்லா
marriages	திருமணங்கள்
amino	அமினோ
accent	உச்சரிப்பில்
robots	இயந்திரங்கள்
weston	வெஸ்டன்
parachute	பாராசூட்
lauren	லாரன்
belarusian	பெலருசிய
snails	நத்தைகள்
martínez	martínez
mercer	மெர்சர்
crimson	கிரிம்சன்
meal	சாப்பாடு
pharmaceutical	மருந்து
porn	ஆபாச
vegetables	காய்கறிகள்
laos	லாவோஸ்
wiltshire	wiltshire
tense	tense
ant	எறும்பு
hectares	hectares
fears	பயங்கள்
fits	fits
rotten	அழுகிய
fury	ஆவேசமாக
bihar	பீகார்
kraków	கிராக்கோவ்
confident	தன்னம்பிக்கை
confident	தன்னம்பிக்கையை
suzuki	suzuki
fascist	பாசிச
registry	பதிவேடு
olivier	olivier
polytechnic	பாலிடெக்னிக்
polytechnic	polytechnic
randall	ராண்டல்
aligned	ஒத்திருக்கின்றன
leased	குத்தகைத்
chandler	சாண்ட்லர்
sophisticated	அதிநவீன
acknowledge	ஒப்புக்
arabs	அரபியர்கள்
rewritten	rewritten
curved	வளைந்த
reilly	ரெய்லி
approximate	மேலோட்டம்
inheritance	பரம்பரை
cease	நோயுற்று
ugly	அசிங்கமாக
ugly	அசிங்கமான
fraction	பின்னம்
transaction	பரிவர்த்தனை
decay	சிதைவு
substances	கன்வென்ஷன்
guam	குவாம்
ensuring	பத்திரங்கள்
zhou	சவு
zhou	சோ
mir	மிர்
electrons	electrons
turbine	சுழலி
install	நிறுவவும்
eduardo	eduardo
bizarre	வினோதமான
bizarre	வினோத
announces	அறிவிக்கிறது
refusing	மறுக்கின்றனர்
slip	slip
shri	ஸ்ரீ
gore	கோர்
herb	மூலிகை
stripped	stripped
possibilities	சாத்தியங்கள்
syntax	நெறி
syntax	தொடரியல்
hale	ஹேல்
jonas	ஜோனாஸ்
hawkins	ஹாக்கின்ஸ்
sheets	தாள்கள்
sheets	தாள்
preferences	முன்னுரிமைகள்
preferences	விருப்பங்கள்
preferences	விருப்பத்தேர்வுகள்
tricks	தந்திரங்கள்
burlington	burlington
salvation	சாபவிமோசனம்
guaranteed	உத்தரவாதம்
swamp	சதுப்பு
hanna	ஹன்னா
dove	புறா
jennings	ஜென்னிங்ஸ்
gym	ஜிம்
patriotic	நாட்டுப்பற்று
ads	விளம்பரம்
ads	விளம்பரங்கள்
staffordshire	staffordshire
müller	முல்லர்
licenses	உரிமங்கள்
seventy	எழுபது
cultivation	சாகுபடிக்கு
benny	பென்னி
stafford	ஸ்டாஃபோர்ட்
stephens	ஸ்டீபன்ஸ்
racer	ரேசர்
translators	translators
beef	மாட்டிறைச்சி
password	கடவுச்சொல்
precious	விலைமதிப்பற்ற
precious	பொன்னான
dei	dei
apologize	மன்னிப்பு
garrett	காரெட்
dinosaur	டைனோசர்
wan	வான்
pie	பை
spiral	சுழற்சி
spiral	சுழல்
marcos	மார்கோஸ்
cement	சிமெண்ட்
refugee	அகதி
luigi	luigi
ieee	ஐஇஇஇ
donation	நன்கொடை
café	கபே
hare	ஹரே
jensen	ஜென்சன்
talbot	talbot
brooke	புரூக்
cube	கியூப்
goa	கோவா
vacation	விடுமுறை
maggie	மேகி
boots	பூட்ஸ்
ambulance	ஆம்புலன்ஸ்
tyne	tyne
byrne	பைர்ன்
luna	லூனா
skeleton	எலும்புக்கூடு
burmese	பர்மிய
lawn	புல்வெளி
école	இக்கோல்
weaver	நெசவாளர்கள்
mai	mai
einstein	ஐன்ஸ்டீன்
forgot	மறந்துவிட்டேன்
forgot	மறந்து
forgot	நினைவில்லை
niagara	நயாகரா
demons	பேய்கள்
treatments	சிகிச்சைகள்
capt	கேப்டன்
vintage	விண்டேஜ்
perkins	பெர்கின்ஸ்
gdp	gdp
pius	பயஸ்
stereo	ஸ்டீரியோ
tina	டினா
resume	துவங்கு
unlimited	வரம்
unlimited	அளவில்லா
unlimited	அளவில்லாத
unlimited	எண்ணிலடங்கா
molly	மோலி
robbie	ராபி
boost	விளம்பரம்
boost	மேம்படுத்து
boost	பூஸ்ட்
boost	விளம்பரப்படுத்துதல்
norse	நோர்சு
neighbors	அண்டை
restoring	மீட்கப்படுகிறது
rim	ரிம்
assam	அஸ்ஸாம்
assam	அசாம்
wendy	வெண்டி
gran	கிரான்
feud	கொள்ளும்
breathing	மூச்சு
alison	அலிசன்
niger	நிகர்
emmanuel	இம்மானுவேல்
doll	பொம்மையை
doll	பொம்மை
oaks	ஓக்ஸ்
umbrella	குடை
edith	எடித்
campuses	வளாகங்கள்
rotating	ஈர்ப்பை
angles	கோணங்கள்
tolerance	சகிப்புத்தன்மை
insignia	insignia
berg	பெர்க்
paula	பவுலா
memorable	மறக்கமுடியாத
traders	வர்த்தகர்கள்
traders	வணிகர்
sink	பூசிக்
concentrate	வனத்தை
rama	ராமர்
rama	ராமா
rama	ராம
paved	வகுத்தது
afb	afb
airplane	விமானம்
demonstrating	demonstrating
violet	ஊதா
wordpress	wordpress
globally	உலகளவில்
constable	கான்ஸ்டபிள்
abbreviation	சுருக்க
