cannes	kanuose
willow	willow
hbo	hbo
starr	starr
winged	dailioji
shtml	shtml
pagan	pagonių
defendant	atsakovas
defendant	atsakovo
pizza	pica
mls	mls
thornton	thornton
ghosts	vaiduokliai
colt	colt
pulitzer	pulicerio
supervised	prižiūrima
flooded	užliejo
mistress	meilužė
mortar	skiedinio
activation	įjungimo
activation	įjungimas
assumptions	prielaidos
methodology	metodologija
methodology	metodika
ios	ios
gale	neteisingą
bud	bud
melissa	melisa
hapoel	hapoel
martinez	martinez
debris	nuolaužos
frustrated	nusivylę
infinity	begalybės
bite	bite
bavarian	bavarijos
marilyn	marilyn
rumors	gandai
neighbor	kaimynas
ordering	likusiam
fuselage	fiuzeliažo
capitalism	kapitalizmas
harlem	harlem
pigs	kiaulės
pigs	kiaulėms
centennial	šimtametė
rituals	ritualai
joão	joão
wakefield	wakefield
infamous	liūdnai
damascus	damaskas
listeners	klausytojai
dried	džiovintas
dried	išdžiovinti
dried	džiovinta
hai	hai
porch	veranda
hymn	giesmė
vhs	vhs
convenience	patogumo
chu	chu
abs	abs
watt	vatas
kite	aitvaras
frigate	fregata
dramas	dramas
shade	šešėlis
trades	prekiauja
lamp	lempa
lamp	žibintas
lamp	lempos
camping	stovyklos
chips	traškučių
bloom	žydi
emil	emilis
prayers	maldos
prayers	maldas
res	res
cliffs	uolų
bordeaux	bordo
teddy	tedis
omega	omega
denial	neigimas
sunni	sunitų
neville	nevilis
brush	teptuku
alain	alain
mama	mama
ein	ein
turbo	turbo
pietro	pietro
hydraulic	hidrauliniai
addiction	priklausomybė
anders	anders
solidarity	solidarumo
solidarity	solidarumas
maid	kambarinė
physiology	fiziologija
algebraic	algebrinė
brake	stabdys
brake	stabdžiai
brake	stabdžių
brake	stabdymas
loire	loire
jacket	švarkas
spinning	verpimo
brendan	brendan
scarlet	skaisčiai
dante	dantė
granada	granada
royalty	autoriniai
ins	ins
spears	spears
borneo	borneo
coordinated	koordinuoti
explanations	paaiškinimus
explanations	paaiškinimai
transformers	transformatoriai
evelyn	evelina
profiles	profiliai
beethoven	bethoveno
usgs	usgs
constraints	apribojimai
constraints	apribojimus
notification	pranešimo
notification	pranešimas
frankie	frenki
economists	ekonomistai
terra	terra
potato	bulvės
potato	bulvių
acc	acc
kathleen	karin
endless	begalines
absurd	absurdiška
absurd	absurdas
evacuation	evakuacija
lil	lil
mortgage	hipoteka
mortgage	hipotekos
suits	tinka
pilgrimage	piligrimų
truman	truman
ashton	ashton
taliban	talibano
olga	olga
prostitution	prostitucija
prestige	prestige
contractor	rangovas
xiv	xiv
bubble	burbulas
incoming	gauta
incoming	ateinantys
panzer	panzerkampfwagen
antiquity	antiquity
directorate	direktoratas
approve	patvirtinti
kerman	kermanas
hatch	liukas
unfortunate	gaila
immunity	imunitetą
immunity	imuniteto
immunity	imunitetas
snakes	gyvatės
snakes	gyvates
snakes	gyvačių
nile	nilo
duel	dvikova
assessments	vertinimus
daisy	deizė
authentic	autentiškas
authentic	autentiški
mccartney	makartnis
relativity	reliatyvumo
emotion	emocija
emotion	emocijos
cobra	kobra
sensitivity	jautrumas
sensitivity	jautris
soils	dirvos
plots	sklypų
holstein	holstein
investor	senėjimas
investor	investuotojų
investor	investuotojai
investor	investuotojas
neighbours	kaimynų
neighbours	kaimynai
neighbours	kaimynės
psychologist	psichologas
kaiser	kaiser
darling	brangioji
judiciary	teismai
vicente	vicente
replies	atsakymai
klaus	klaus
anarchist	anarchistų
removes	šalinamas
removes	šalinami
removes	pašalina
stella	stela
dose	dozė
zombie	zombių
canadians	kanadiečiai
dwelling	būsto
dwelling	būstas
blackpool	blackpool
norris	norisas
serbs	serbai
harp	arfa
rental	nuoma
rental	nuomos
botanist	botanikas
guilt	kaltė
guilt	kaltę
fried	kepti
alexandre	alexandre
verdict	nuosprendis
cyril	cyril
discovering	nustatęs
spiders	vorai
bonnie	boni
liam	liam
positively	teigiamai
quincy	quincy
firmly	tvirtai
rode	rode
utrecht	utrechte
britannica	britannica
amendments	pakeitimai
threads	gijos
humphrey	humphrey
discrete	atskiros
peterborough	peterborough
deliveries	pristatymas
deliveries	pristatymai
unfinished	nebaigti
drill	pratybos
exotic	egzotinių
sauce	padažas
sauce	padažu
archie	arčis
javier	javier
exports	eksportuojami
exports	eksportas
cartridge	užtaisas
clifton	kliftonas
deportivo	deportivo
feeds	maitina
optimal	optimali
optimal	optimalus
kernel	branduolių
kernel	branduolys
tragic	tragiška
tragic	tragiškas
credibility	patikimumas
resurrection	prisikėlimo
prosperity	klestėjimas
prosperity	gerovės
prosperity	gerovė
pools	baseinai
kenyan	kenijos
archibald	archibald
lava	lava
promo	promo
beloved	mylima
beloved	mylimas
esther	estera
objected	neprieštaravo
peel	žievelės
heidelberg	heidelbergo
groove	griovelio
facial	veido
ladder	kopėčios
ladder	kils
bohemia	bohemija
thief	vagis
vanessa	vanesa
halloween	halloween
rodgers	rodgers
dinosaurs	dinozaurai
dominance	dominavimo
laugh	juoktis
financed	finansuojama
sandwich	sumuštinis
apparatus	prietaisas
apparatus	aparatas
apparatus	prietaisai
apparatus	aparatūra
apparatus	aparatai
pornography	pornografija
pornography	pornografijos
toulouse	tulūzos
tap	tap
rover	rover
granddaughter	anūkė
shelley	shelley
induction	indukcijos
privilege	privilegija
trombone	trombonas
airplay	airplay
magnet	magnetas
martyrs	kankinių
captive	nelaisvėje
captive	uždarasis
codex	codex
wool	vilnos
wool	vata
wool	vatos
wool	vilna
exciting	įdomiai
exciting	įdomi
surprisingly	stebėtinai
vowels	balses
seller	pardavėjo
seller	pardavėjas
platoon	būrys
dia	tiu
dia	dia
cornish	cornish
triangular	trikampiai
yuri	jurijus
hiroshima	hirosima
wash	nuplauti
wash	plauti
freddie	fredi
treason	išdavystę
babies	kūdikiai
babies	vaikučių
persia	persija
recognise	pripažinti
turret	bokštelis
reginald	reginald
doubts	abejonės
doubts	abejonių
zhu	zhu
veterinary	veterinarijos
guggenheim	gugenheimo
hector	hektoras
lounge	lounge
tara	tara
jumped	pasitiko
curry	kario
goat	ožkų
goat	ožys
nightmare	košmaras
yokohama	jokohama
scorea	scorea
secretariat	sekretoriatas
secretariat	sekretoriato
illusion	iliuzija
electro	electro
teens	paaugliai
elias	elias
pseudo	pseudo
rogue	rogue
feathers	plunksnos
marathi	marathų
habits	įpročiai
habits	įpročius
extraction	gavyba
courtyard	kieme
desirable	pageidautina
expo	expo
guerrilla	partizanų
esp	esp
bon	bon
exchanges	mainų
farewell	atsisveikinimo
cardiac	širdies
replica	kopija
smiles	šypsenos
cousins	pusbroliai
terrorists	teroristai
heinz	heinz
lizard	driežas
zen	zen
remixes	remixes
negotiate	derėtis
axe	kirvis
flour	miltus
flour	miltų
flour	miltai
goose	žąsų
goose	žąsys
scientology	scientologų
dom	domas
pact	paktas
pact	pakto
garbage	šiukšlių
regency	regencija
mom	mama
accompany	lydėti
hasan	hasan
mosaic	mozaikos
icc	tbt
subcategories	subkategorijos
joachim	joachim
bahn	bahn
rutgers	rutgers
crude	žalios
crude	žali
crude	žalia
taxonomy	taksonomija
alcoholic	alkoholinių
rom	rom
caucasus	kaukazas
caucasus	kaukazo
villains	piktadariai
bodyclass	bodyclass
superhero	superherojus
baptiste	baptiste
loads	apkrovos
lime	kalkių
lime	kalkės
crossover	kryžminiai
karate	karate
dickinson	dickinson
drought	sausra
maccabi	maccabi
ajax	ajax
chargers	rinkėjai
rejection	atmetimas
rejection	atmetimo
thor	toras
amnesty	amnestija
tracked	sporte
thirteenth	tryliktoji
failures	gedimų
failures	gedimai
soviets	sovietai
lottery	loterija
grateful	dėkingas
grateful	dėkinga
turtles	vėžliai
meadow	pieva
electromagnetic	elektromagnetinių
electromagnetic	elektromagnetinis
conan	conan
likelihood	tikimybė
patriot	patriotas
infrared	spindulių
specialists	specialistai
julio	julio
kang	kang
bourbon	burbono
surgeons	chirurgai
greco	greco
thatcher	thatcher
librarian	bibliotekininkas
chairs	kėdės
chairs	kėdžių
stressed	pabrėžė
watches	laikrodžiai
tablet	tabletės
palatinate	pfalcas
descriptive	aprašomoji
nursery	darželio
synod	sinodas
disclosure	atskleidimas
disclosure	atskleidimo
visually	vizualiai
correlation	koreliacija
correlation	koreliacijos
ideals	idealus
disappearance	dingimo
gong	gong
sammy	semis
tong	tong
adobe	adobe
deficit	deficito
deficit	deficitas
avon	avon
leap	šuolis
everton	everton
malawi	malavio
noon	vidurdienį
inequality	nelygybė
strauss	strauss
confession	išpažinties
stunt	triukas
monopoly	monopolijos
monopoly	monopolija
monopoly	monopolis
niece	dukterėčia
surf	surf
nationalists	nacionalistai
gentle	švelnios
gentle	švelnus
gentle	švelni
patronage	mecenatas
penguins	pingvinai
transgender	transseksualų
opus	opus
chatham	čatamo
communion	komunija
jewelry	papuošalas
gases	dujos
russo	russo
laguna	laguna
discs	diskai
lenin	leninas
breton	breton
patience	kantrybės
verbs	veiksmažodžių
catching	žūklės
orchid	orchidėja
calculate	apskaičiuoti
manned	pilotuojami
libyan	libijos
mentally	protiškai
liang	liang
oxfordshire	oksfordšyras
tear	ašara
heroic	didvyriška
shine	švyti
recreate	atkurti
peasant	valstiečių
infections	infekcijos
violinist	smuikininkas
murderer	žudikas
deborah	debora
killings	žudynių
gymnasts	gimnastai
balkan	balkanų
vocabulary	žodyno
vocabulary	žodynas
cum	cum
judo	dziudo
cane	cukranendrių
innocence	nekaltumo
calculation	apskaičiavimas
calculation	skaičiavimas
innovations	naujovės
croix	croix
abundance	gausa
cyber	kibernetinio
pauline	paulina
ego	ego
hooks	kabliai
motives	motyvai
mia	mia
meridian	meridian
examinations	egzaminai
bayern	bayern
wrapped	suvynioti
harriet	harieta
audition	nusifilmuoti
brackets	skliaustuose
hubbard	hubbard
merry	linksmų
backgrounds	biografijos
fragment	fragmentas
magnificent	nuostabi
lethal	mirtina
banana	bananų
usaf	usaf
friction	trinties
madness	beprotybė
routledge	routledge
mutations	mutacijos
mutations	mutacijų
daddy	tėti
daddy	tėtis
guinness	gineso
adler	adler
felipe	felipe
unhappy	nelaiminga
byrd	byrd
hulk	halkas
grandchildren	anūkų
mae	mae
antony	antonijus
unix	unix
chandra	chandra
beard	barzda
coca	coca
maltese	maltos
maltese	maltiečių
tottenham	tottenham
bel	bel
danube	dunojaus
danube	dunojus
garland	garland
builders	statybininkų
cooled	aušinamas
bas	bas
temporal	laiko
misunderstanding	nesusipratimas
boyle	boyle
beacon	švyturys
baja	baja
blah	bla
nobles	didikų
arches	arkų
hazard	pavojus
titan	titan
cables	kabeliai
cables	laidai
qaeda	qaeda
forrest	forestas
obligations	įsipareigojimai
somali	somalio
mma	mma
recruitment	įdarbinimas
flats	butų
flats	butai
obligation	pareiga
obligation	įsipareigojimas
obligation	įpareigojimas
wembley	wembley
debts	skolos
flores	flores
sect	sekta
focal	židinio
citadel	citadelė
secretaries	sekretoriai
noir	noir
myths	mitai
zinc	cinko
zinc	cinkas
beans	pupos
beans	pupelių
beans	pupelės
mclean	mclean
shrewsbury	shrewsbury
turbines	turbinos
ang	ang
tractor	traktorius
tractor	traktoriaus
tractor	vilkikas
tractor	traktoriai
cents	centų
excited	susijaudinęs
scandinavian	skandinavijos
atari	atari
satisfaction	pasitenkinimo
satisfaction	pasitenkinimas
butter	sviesto
butter	sviestas
persuade	įtikinti
cyrus	cyrus
spartak	spartak
derry	derry
rhetoric	retorika
enthusiasm	entuziazmo
enthusiasm	entuziazmas
repository	saugyklos
repository	saugykla
propeller	propelerio
morse	morzės
stadiums	stadionuose
maturity	terminas
outfit	apranga
habsburg	habsburg
schwartz	schwartz
lemon	citrinų
lemon	citrinos
bullying	patyčias
graveyard	graveyard
mortal	įrengti
visions	vizijas
poisoning	apsinuodijimo
combustion	deginimas
combustion	degimo
clans	klanai
tuberculosis	tuberkuliozė
tuberculosis	tuberkuliozės
eddy	edi
eco	eco
bentley	bentley
physicists	fizikai
ankara	ankaros
organism	organizmas
gorge	tarpeklis
mcgill	makgilio
nolan	nolan
procession	procesija
weir	weir
panther	pantera
jaw	žandikaulio
baritone	baritonas
kilkenny	kilkenny
ceramic	keramika
cornelius	kornelijus
moor	atsiremti
abbas	abbas
tidal	potvynių
hui	hujų
calculations	skaičiavimus
calculations	skaičiavimai
congregations	kongregacijų
unification	susivienijimo
cartoonist	karikatūristas
hatred	neapykanta
productivity	našumas
productivity	produktyvumas
soundtracks	soundtrack
anaheim	anaheimo
spends	praleidžia
economically	ekonomiškai
brakes	stabdžiai
predecessors	pirmtakai
versa	versa
landings	iškrovimo
wholesale	didmeninės
asphalt	asfalto
blockade	blokada
blockade	blokadą
middleton	middleton
flynn	flinas
mole	kurmis
nicholson	nicholson
otters	ūdros
sparks	kibirkščių
berger	berger
jain	jain
smell	kvapas
moreno	moreno
bamboo	bambuko
lockheed	lockheed
meals	valgius
dal	dal
metallic	metalo
metallic	metalas
navbox	navbox
sweep	fei
nissan	nissan
steals	vagia
babylon	babilonas
huddersfield	huddersfield
rabbis	rabinai
donor	donorų
donor	donoras
smash	sunaikins
drowned	nuskendo
hut	marš
pressures	spaudimu
pressures	slėgis
rented	nuomojamas
musée	musée
veronica	veronika
brock	brokas
tiles	kaladėlės
tiles	plytelės
drift	drift
canary	kanarų
humour	humoras
radial	radialinė
córdoba	kordobos
nude	nude
currents	srovių
feminism	feminizmas
divers	narai
shia	šiitų
famine	badas
willy	willy
ramsey	ramsey
honoured	pagerbtas
metacritic	metacritic
ling	ling
reflections	atspindžiai
manifesto	manifesto
shan	shan
cadets	kadetai
utilities	komunalinių
explosives	sėdynė
paradox	paradoksas
minsk	minsko
chrome	chromas
tramway	tramvajaus
solicitor	solisitorius
niche	nišą
lifting	kėlimo
doncaster	doncaster
regulate	reguliuoti
shirts	marškiniai
wax	vaškas
hutchinson	hutchinson
mont	mont
pigeon	karvelis
fertile	derlingos
stairs	laiptai
stairs	laiptų
updating	atnaujina
updating	atnaujinimas
updating	atnaujinama
botany	botanika
dignity	orumą
dignity	orumo
dignity	orumas
ideological	ideologinių
grip	gniaužtuose
shortage	stygius
shortage	trūkumas
clone	klonas
ravens	varnai
foreigners	užsieniečių
foreigners	užsieniečiai
takeover	perėmimo
takeover	perėmimas
traction	traukos
humboldt	humbolto
alternating	kintamoji
alternating	saulėtos
lenses	lęšiai
pulp	minkštimas
pulp	plaušienos
pulp	plaušiena
salle	salle
decks	denių
worms	kirmėlių
lagoon	lagūna
soo	soo
allocation	paskirstymas
affordable	prieinamas
presley	presley
timor	timoras
tire	padanga
chestnut	kaštonų
accumulated	sukauptas
diagnostic	diagnostiniai
diagnostic	diagnostika
diagnostic	diagnostikos
choreographer	choreografas
simone	simona
bernie	bernis
düsseldorf	diuseldorfo
musicals	miuziklus
complexes	kompleksų
hydroelectric	hidroelektrinių
carrie	kerė
ignorance	nežinojimo
conductors	laidininkai
burgess	burgess
tavern	smuklė
wmf	wmf
jong	jong
kitty	katytė
benz	benz
cha	cha
motorcycles	motociklai
weimar	weimar
conditioning	balzamas
ella	ella
investigators	tyrėjai
glasses	akiniai
bowen	bowen
amphibians	varliagyviai
wishing	norinčios
wishing	norintiems
imaginary	įsivaizduojamą
imam	imam
radioactive	radioaktyviųjų
consultation	konsultacijos
consultation	konsultacijų
consultation	konsultavimas
consultation	konsultacija
tonga	tonga
lovely	gražios
lovely	miela
erotic	erotinio
manipulation	manipuliavimo
farrell	farrell
thickness	storis
thickness	storio
lois	luis
ramos	ramos
filters	filtrai
damon	deimonas
preacher	pamokslininko
katrina	katrina
etymology	etimologija
ambient	aplinka
ambient	aplinkos
feudal	feodalinė
antagonist	antagonistas
dare	dare
insult	įžeidimas
diplomacy	diplomatijos
diplomacy	diplomatija
claudia	claudia
neglected	apleistas
seniors	abiturientai
brunei	brunėjus
dots	taškai
postponed	atidėtas
postponed	atidėta
vegetable	augalinis
siberia	sibirą
crowds	minios
scholarships	stipendijos
scholarships	stipendiją
scholarships	stipendijas
polite	mandagus
wired	laidinio
theresa	terese
tissues	audinių
tissues	audiniai
benton	benton
commemorative	atminimo
tuition	mokslą
lsu	lsu
gao	gao
sundays	sekmadieniais
lac	lac
passionate	aistringas
waterfall	krioklys
genealogy	genealogija
psychiatry	psichiatrijos
educate	šviesti
fairfax	fairfax
testified	liudijo
rails	bėgiai
westphalia	vestfalijos
routing	maršrutą
twisted	iškreipta
vitamin	vitamino
vitamin	vitaminai
vitamin	vitaminas
chromosome	chromosomų
nippon	nippon
jealous	pavydžiu
jealous	pavydi
brutal	žiauri
brutal	žiaurus
absorption	absorbcija
absorption	rezorbcija
absorption	sugertis
absorption	absorbcijos
worm	sliekas
viruses	virusų
viruses	virusai
lim	lim
andersen	andersen
eligibility	tinkamumas
kara	kara
wien	wien
unrest	neramumai
specials	patiekalai
elegant	elegantiška
mast	stiebo
crystals	kristalai
resting	poilsio
abel	abel
colonists	kolonistų
enthusiastic	entuziastingai
cromwell	cromwell
annoying	erzina
frustration	nusivylimas
frustration	nusivylimą
kidnapping	pagrobimas
exported	eksportuota
exported	eksportuojami
exported	eksportuotas
texture	tekstūra
tor	tor
wikisource	vikišaltiniai
digging	iškasti
rites	apeigomis
erich	erich
spinal	stuburo
socialists	socialistai
semester	semestrą
che	che
prediction	prognozė
prediction	prognozuoja
samsung	samsung
albuquerque	albuquerque
reconciliation	susitaikymo
reconciliation	susitaikymas
reconciliation	suderinimas
reconciliation	derinimas
topology	topologijos
neurons	neuronų
retention	susilaikymas
retention	išlaikymo
graphs	diagramos
grange	grange
lip	lūpų
sadly	liūdna
sadly	deja
colchester	colchester
gallagher	gallagher
generates	sukuria
cooked	virti
cooked	virtos
aggression	agresijos
aggression	agresija
dressing	kambariniai
contingent	kontingento
sympathy	užuojautą
juliet	džiuljeta
emperors	imperatoriai
staging	sustojimo
schleswig	schleswig
fresno	fresno
clever	protinga
clever	protingas
clever	protingi
assyrian	asirų
gravitational	gravitacinė
accession	stojimo
darlington	darlington
tar	deguto
execute	vykdyti
morales	morales
disappear	dingsta
surplus	perteklius
furious	furious
ghetto	geto
satire	satyra
velvet	velvet
astronaut	astronautas
gaps	spragų
concacaf	concacaf
archaeologists	archeologai
irwin	irvinas
yukon	jukonas
rockefeller	rokfeleris
interception	perėmimas
toilet	do
orchard	sodą
rutherford	rutherford
kramer	kramer
nas	nas
pueblo	pueblo
hypothetical	hipotetinis
grammatical	gramatinių
knots	mazgų
remotely	nuotoliniu
invest	investuoti
jumps	šokinėja
bacterial	bakterijų
théâtre	théâtre
shy	drovus
sai	sai
sino	sino
continents	žemynų
refined	rafinuotas
hiring	nuomą
phosphate	fosfato
phosphate	fosfatas
phosphate	fosfatų
bombed	bombardavo
imprint	įspaudas
caledonia	kaledonija
exploded	sprogo
portals	portalų
animalia	animalia
cancellation	panaikinimo
cancellation	panaikinimas
cancellation	atšaukimas
autism	autizmo
syllable	skiemuo
michele	michele
sleeve	mova
quo	quo
theologians	teologų
andrei	andrejus
saddle	balnas
disturbed	sutrikęs
blessing	palaima
inevitable	neišvengiama
iaaf	iaaf
jasper	jaspers
eaton	eaton
robbins	robbins
sparta	spartos
sparta	spartą
sparta	sparta
poznań	poznanėje
clown	klounas
troupe	trupės
yankee	jankių
boiler	katilas
belly	pilvo
belly	pilvas
iphone	iphone
symposium	simpoziumas
jewel	pupa
generous	dosnus
entertaining	linksmas
cockpit	kabina
cockpit	kabinos
nets	tinklai
tremendous	milžiniškas
tremendous	didžiulį
fiat	fiat
alec	alekas
stretches	lipa
stretches	siekiu
clashes	susirėmimų
leiden	leideno
damn	velnias
aristotle	aristotelis
nouns	daiktavardžiai
atkinson	atkinson
mig	mig
nuns	vienuolės
rotary	sukamasis
rotary	rotary
angular	kampinis
slaughter	skerdimo
switches	jungikliai
corpse	lavonas
accelerated	akceleracijos
prasad	prasadas
conscience	sąžinės
daytona	daytona
accountability	atskaitomybės
novi	novi
coconut	kokosų
giorgio	giorgio
drilling	gręžimo
travelers	keliautojams
dominate	dominuoti
cody	kodi
gómez	gómez
crete	kreta
bravery	drąsa
theorists	teoretikai
novgorod	naugardo
analytical	analizės
inventions	išradimų
extracted	išgauti
metabolism	metabolizmas
metabolism	metabolizmo
bella	bella
countless	begalę
amir	amir
morality	dėsnis
papa	tėti
oceans	vandenynų
oceans	vandenynai
ismail	ismail
intercontinental	tarpžemyninis
ahl	ahl
profitable	pelninga
profitable	pelningas
gmt	gmt
blonde	blondinė
sultanate	sultonatas
curtain	užuolaidų
royce	royce
dispatched	išsiųstos
vita	vita
mirza	mirza
fra	fra
liquor	gėrimus
flexibility	lankstumas
flexibility	lankstumo
adjective	būdvardis
boer	boer
hewitt	hewitt
bleeding	kraujavimas
vilnius	vilniaus
vilnius	vilnius
loser	nevykėlis
bottles	butelius
bottles	buteliukai
bottles	buteliai
sheila	šeila
exchanged	keičiamasi
participates	dalyvauja
invites	kvietimai
invites	kviečia
bureaucrat	biurokratas
washed	plauti
washed	išplauti
olsen	olsen
sims	sims
skinner	skineris
elm	guobų
resonance	rezonanso
faso	fasas
kurdistan	kurdistano
coffin	karstas
italians	italai
recipe	receptas
elephants	drambliai
automation	automatizavimo
cascade	kaskada
forge	smi
aquarium	akvariumas
cerambycidae	cerambycidae
romero	romero
tsar	caras
specialised	specializuotų
scream	rėkti
approx	maždaug
activate	aktyvuoti
activate	suaktyvinti
activate	aktyvinti
andes	andai
shareholders	akcininkai
evergreen	evergreen
meteorological	meteorologijos
digest	virškinti
handles	apdoroti
subscribers	abonentams
sparrow	sperou
marin	marin
dynasties	dinastijų
shankar	shankar
grapes	vynuogės
crusaders	kryžiuočiai
underworld	požemių
ravi	ravi
cheltenham	cheltenham
melodies	melodies
tuning	derinimu
insulting	žeidžia
creed	creed
accessories	reikmenys
accessories	priedai
torpedoes	torpedos
epidemic	epidemija
mustafa	mustafa
germain	germain
française	française
crossroads	kryžkelėje
consolidation	konsolidacija
calcio	calcio
telecom	telecom
goldman	goldman
alonso	alonso
kapoor	kapoor
boycott	boikotuoti
forks	šakių
forks	šakės
consulate	konsulatas
frogs	varles
pork	kiaulienos
pork	kiauliena
kazan	kazanė
colonization	kolonizacija
eruption	išsiveržimas
leftarm	leftarm
friedman	friedman
ideally	geriausia
exits	išėjimai
keller	keller
nad	nad
fiddle	smuikas
horrible	siaubinga
horrible	siaubingas
fungus	grybas
usda	usda
graffiti	graffiti
obstacles	kliūtis
fda	fda
reddish	rausvai
lent	paskolinti
doe	doe
entertainer	kurorto
soloist	solistas
repetition	pasikartojimo
verona	verona
attracts	traukia
armenians	armėnai
coupe	coupe
chrysler	chrysler
hobby	hobis
jaime	džeimis
sindh	sindo
wight	wight
lama	lama
mccain	mccain
magician	magas
wizards	burtininkų
burger	burger
bernardino	bernardino
catalyst	katalizatorius
glacial	ledinė
rhodesia	rodezijos
tbilisi	tbilisio
beatrice	beatrice
authoritative	autoritetingas
díaz	díaz
juventus	juventus
xxx	xxx
disciplinary	disciplinos
disciplinary	drausmės
occupations	profesijų
sami	samių
aba	aba
allah	allah
rancho	rancho
dump	išmesti
humble	kuklus
javascript	javascript
presentations	pristatymai
versailles	versalis
generators	generatoriai
happily	laimingai
dungeons	požemiai
seville	sevilijos
daly	daly
haitian	haičio
patented	patentuota
med	med
strengthening	stiprinimas
strengthening	stiprinti
porsche	porsche
skyscrapers	dangoraižius
diaries	dienoraščiai
arrests	areštai
wilde	wilde
rot	puvinio
hungry	alkanas
hungry	alkani
tna	tna
sgt	sgt
levine	levine
nicola	nicola
minh	minh
playback	grojimą
hee	hee
bind	sieti
needle	adatos
needle	adatą
needle	adata
needle	adatų
courier	kurjeris
spurs	spurs
quad	quad
potassium	kalis
potassium	kalio
volkswagen	volkswagen
reprint	reprint
lattice	ažūriniai
unicode	unikodo
rossi	rossi
gonzalez	gonzalez
prospects	perspektyvas
prospects	perspektyvos
hymns	giesmių
admired	žavėjosi
monitors	integravimo
academies	akademijų
vishnu	višnaus
fest	fest
cynthia	sintija
degradation	skilimo
degradation	skilimas
degradation	skaidymas
bracket	sija
abe	eigai
appalachian	apalačų
leopard	leopardas
sensory	jutiminio
bunker	bunkeris
spherical	sferinių
ulrich	ulrich
malone	malone
weights	svarstyklės
weights	svoriai
elders	senoliai
corey	corey
charm	žavesio
petrol	benzino
petrol	benzinas
blanc	blanc
melting	lydymosi
sensation	pojūtis
subcommittee	pakomitečio
finances	finansai
finances	finansus
caracas	karakaso
psychic	psichinės
gundam	gundam
burgundy	bourgogne
exemption	atleidimas
unite	suvienyti
rothschild	rothschild
hint	užuomina
punished	nubausti
crying	verkia
antioch	antiochas
gangs	gaujų
castillo	castillo
palestinians	palestiniečiai
palestinians	palestiniečių
cyrillic	kirilica
shoulders	pečius
dealers	prekybininkai
dealers	prekiautojai
dealers	pardavėjai
diminished	sulėtėjo
ret	ret
surge	antplūdį
reservations	išlygų
bald	plikas
seminars	seminarai
rudolph	rudolph
wagons	vagonai
wagons	vagonų
devastating	gilią
tallinn	talino
pants	kelnes
pants	kelnės
apocalypse	žlugimo
archaeologist	archeologas
dispersed	pasklidus
staircase	laiptai
bernstein	bernstein
textual	tekstinė
knot	mazgas
tsunami	cunamio
valves	vožtuvai
ruiz	ruiz
hillary	hillary
balkans	balkanai
balkans	balkanų
ville	ville
yiddish	jidiš
entrepreneurs	verslininkai
crimean	krymo
mushroom	grybai
mosques	mečetes
humidity	drėgnumas
humidity	drėgnis
humidity	drėgmė
alicia	alicija
emilio	emilio
len	len
ponds	tvenkiniai
midi	midi
convex	išgaubtos
rejects	atmeta
seminar	seminaras
russ	rasai
larsen	larsen
orchestras	orkestrai
seize	teisiniu
plato	plato
interfere	kištis
respects	gerbia
philips	philips
megan	megan
guardians	sergėtojai
surround	apsupti
surround	erdvinis
hospitality	svetingumą
intellectuals	intelektualai
cod	menkės
discount	nuolaida
discount	nuolaidos
axle	ašis
axle	ašies
willingness	pasiryžimas
willingness	noras
willingness	norą
neoclassical	klasicizmo
painful	skausmingas
painful	skausminga
amelia	amelija
hussain	hussain
exhausted	išnaudojama
provost	provost
indiscriminate	chaotišką
behave	elgtis
jakob	jakob
lao	laoso
eliza	elzė
julien	julien
spill	išsiliejimo
semantic	semantinis
chloride	chloridas
chloride	chlorido
vanguard	avangardas
vendors	pardavėjai
planting	sodinimo
planting	sodinti
valle	valle
claus	klausas
mono	mono
lips	lūpų
lips	lūpos
uploading	išsiunčiama
alfredo	alfredo
policeman	policininkas
policeman	faras
ceramics	keramika
wonders	stebuklus
playhouse	namelį
guadalajara	guadalajara
archaic	archajišką
immortal	apleista
immortal	nemirtingas
suppress	akcentas
cambridgeshire	kembridžšyras
intentional	sugebėjimą
malmö	malmė
lan	lan
contractors	rangovai
spine	srautų
maximilian	maximilian
gala	gala
glucose	gliukozė
awesome	nuostabios
awesome	nuostabu
awesome	nuostabūs
awesome	nuostabus
migrants	migrantų
migrants	migrantai
zionist	sionistų
doping	dopingas
ramsay	ramsay
blanche	blanche
crab	krabas
hanged	pakartas
conflicting	prieštaringų
herd	banda
collier	collier
sherwood	šervudas
archery	lankininkų
cyclones	ciklonai
captures	fotografuoja
blanket	danga
nora	nora
connie	kone
hayden	hayden
wehrmacht	vermachto
warbler	pečialinda
ditch	griovį
polymer	polimeras
yorker	yorker
thanksgiving	padėkos
transverse	skersinės
transverse	skersinis
neutron	neutronų
morphology	morfologija
cho	cho
locke	lokas
modelling	modeliavimo
modelling	modeliavimas
façade	fasadu
fulham	fulham
superstar	superstar
mechanic	mechanikas
franciscan	pranciškonai
detector	detektoriaus
wires	vielų
bethlehem	betliejaus
infants	kūdikiai
auguste	auguste
bali	balio
rift	plyšiu
mitsubishi	mitsubishi
leak	nuotėkio
leak	nutekėjimas
nme	nme
c++	c++
bisexual	biseksualus
sincerely	nuoširdžiai
bricks	plytų
bricks	plytos
kendall	kendall
supplier	tiekėjas
fined	nubaustų
analysts	analitikai
kits	rinkiniai
lamps	žibintai
lamps	šviestuvai
lamps	lempoms
lviv	lvovo
boyer	boyer
preserves	konservai
expulsion	išsiuntimas
favourable	palankios
stephenson	stephenson
tanker	tanklaiviai
tanker	tanklaivis
domination	dominavimo
skate	raja
herring	silkių
herring	silkės
jacqueline	jacqueline
watford	watford
restructuring	pertvarka
restructuring	restruktūrizavimo
restructuring	restruktūrizavimas
diver	narų
philipp	philipp
disguised	užmaskuotas
accuse	griežčiau
convergence	konvergencija
convergence	konvergencijos
sanitation	sanitarijos
tortured	kankinami
ankle	kulkšnį
coil	ritė
demos	demos
tops	vamzdžiai
livery	apipavidalinimas
coefficient	koeficientas
recalls	primena
vogue	vogue
middlesbrough	midlsbro
soyuz	soyuz
shades	atspalvių
freud	freud
rodrigo	rodrigo
jstor	jstor
spear	ietis
zoe	zoja
graf	graf
dev	dev
fertility	vaisingumo
ventura	ventura
sins	nuodėmes
expectation	lūkesčių
serpent	gyvatės
serpent	gyvatė
viaduct	viadukas
christoph	christoph
dunedin	danidinas
grenade	granata
satan	šėtonas
français	français
folding	lankstymo
earls	earls
invaders	okupantus
nail	nagų
modular	modulinis
squirrel	voverė
boilers	katilai
liturgical	liturginiai
vida	vida
martins	martins
neon	neonas
trader	prekiautojas
trader	prekybininkas
trader	verslininkas
trader	pardavėjas
tails	uodegos
dictatorship	diktatūra
dictatorship	diktatūros
sperm	sperma
melville	melvilio
kris	kristina
kris	kris
mating	poravimosi
decreases	sumažėja
polk	polk
nikki	nike
proton	protonų
clarkson	clarkson
awakening	pabudimas
tyson	tyson
vengeance	kerštas
vengeance	keršto
pont	pont
comune	comune
sack	sak
elk	elk
nobleman	didiko
hamas	hamas
disagreements	nesutarimų
mounting	montavimo
mounting	montavimas
quintet	kvintetas
khmer	khmerų
fascism	fašizmas
reproduce	atgaminti
andrés	andrés
gerhard	gerhard
executions	egzekucijų
foil	folija
foil	folijos
jammu	džamu
urgent	skubus
urgent	skubiai
colorful	spalvinga
crimea	krymo
crimea	kryme
neolithic	neolitas
fia	fia
awful	siaubingai
awful	siaubinga
awful	baisiai
coke	kokso
coke	koksas
introductory	įvadinė
introductory	įvadinis
hume	hume
scrap	laužas
docks	dokai
shale	skalūnų
imagesize	imagesize
sms	sms
jaguar	jaguar
sellers	pardavėjai
tenant	nuomininkas
ransom	išpirkos
curiosity	smalsumo
disqualified	diskvalifikuota
emerald	emerald
nokia	nokia
interfaces	jungtys
interfaces	sąsajos
chalk	kreida
pest	kenkėjų
illegally	neteisėtai
guillaume	guillaume
decimal	dešimtainis
ascension	žengimo
technician	technikas
wasted	veltui
melanie	milda
openings	angų
donetsk	donecko
ching	jing
motifs	fragmentais
defects	defektai
capsule	kapsulė
capsule	kapsulės
gomez	gomez
astronomers	astronomai
clues	pėdsakus
apostle	apaštalo
jackets	liemenės
jackets	striukės
jackets	švarkai
jackets	striukes
acquitted	išteisintas
rté	rté
dracula	drakula
mandolin	mandolina
snooker	snukeris
lena	lena
annexation	aneksija
yen	jenų
concession	koncesijos
concession	koncesija
amiga	amiga
donors	donorų
donors	donorai
algae	dumblių
algae	dumbliai
sinatra	sinatra
disastrous	pražūtinga
pathology	patologijos
containers	konteineriai
jpeg	jpeg
blanco	blanco
handsome	gražuolis
handsome	gražus
dvds	dvd
kabul	kabulo
ginger	imbiero
bangor	bangor
diagrams	schemos
disappointment	nusivylimas
disappointment	nusivylimą
champ	čempione
indy	indy
uncomfortable	nepatogi
