paša	pasha
eksperimentus	eksperimento
pasėlių	crop
technikai	technicians
sekretoriatas	secretariat
pašalinamas	ekskresyon
dir	dir
saba	saba
kaupimo	ibinabahagi
kaupimo	pagbabahagi
slepia	nagtatago
slepia	pagtago
linijinis	guhit
linijinis	diretso
žvejys	mangingisda
niger	niger
omega	omega
genomo	genome
jet	jet
tolo	kalayuan
pjovimo	pagputol
atlyginimas	sahod
atlyginimas	suweldo
atlyginimas	companya
atlyginimas	salaries
soma	soma
sutrikimą	pagkalito
patarimų	advice
patarimų	payo
brangus	dear
būgnas	tambol
būgnas	drum
morena	morena
puškinas	pushkin
skyrybos	diborsiyo
nuovargis	nakakapagod
bethoveno	beethoven
genas	gene
vaikšto	naglalakad
vaikšto	lumalakad
vittorio	vittorio
gipso	plaster
cenzūra	censorship
urdu	urdu
šengeno	schengen
mega	mega
vožtuvų	valve
ūkininkavimo	pagsasaka
diplomatinis	diplomatic
lira	lira
minios	madla
taros	tare
šaudo	shoots
gru	gro
guma	gum
skydliaukės	thyroid
manas	mane
katy	katy
junano	yunnan
tamsa	kadiliman
taičio	tahiti
hani	hani
vargas	vargas
toma	toma
martínez	martínez
chloridas	chloride
išlaikymo	pagpapanatili
pažintis	kumokonekta
pažintis	pagkonekta
pažintis	kinokonekta
parodija	patawa
android	android
puošnioji	harlekin
virvės	tali
virvės	lubid
dsc	dsc
gleivių	uhog
šamanizmas	shamanismo
sil	sil
matricos	matrix
matricos	matris
septintoji	ikapitong
trąšos	fertilizer
trąšos	pataba
skaičiavimai	kalkulasyon
mangrovių	mangrove
pagalbininkas	helper
vhs	vhs
graf	graf
barzda	balbas
stabdžių	preno
hahn	hahn
specializuota	espesyal
blanco	blanco
vielos	wire
vielos	kawad
franciskas	francisco
hinduizmas	hinduismo
atsakymai	sumagot
atsakymai	reply
panaikinimas	pagkansela
muitinė	kaugalian
muitinė	customs
pranašumas	bentahe
pranašumas	samantalahin
pranašumas	advantage
pranašumas	kalamangan
drake	drake
giulio	giulio
sugriuvo	collapsed
mielės	norman
mielės	lebadura
salotos	letsugas
salotos	salad
fašistų	fascist
fanai	fans
fanai	tagahanga
dovanos	blessings
dovanos	biyaya
pipirų	paminta
cementas	semento
epic	epic
epic	epiko
prekė	kalakal
taro	taro
kreiseris	cruiser
kirgizija	kyrgyzstan
gėlų	gaelic
reitingus	grades
reitingus	grado
hughes	hughes
kiurasao	curaçao
įsigijimo	pagkuha
bartolomeo	bartolomeo
sietlo	seattle
thomson	thomson
sutrumpintas	pinaikli
rūkyti	jenny
pasakotojas	narrator
atidėtas	deferred
aitvaras	kite
aitvaras	saranggola
jautri	sensitibong
jautri	sensitive
jautri	sensitibo
res	res
res	mes
bas	bas
pareigūnams	officials
kepenys	atay
magnum	magnum
kaltę	kasalanan
kaltę	pagkakasala
atsparumą	paglaban
atsparumą	pagtutol
patogus	komportable
patogus	kumportable
karla	karla
riaušės	stonewall
dažniausi	popular
dažniausi	sikat
stan	stan
svajonė	dream
svajonė	pinapangarap
svajonė	panaginip
svajonė	pangarap
toros	toros
minkštimas	pulp
lipai	gilagid
lėtinis	talamak
kaltinimų	paratang
maestro	maestro
eden	eden
aiškinimo	interpretation
galapagų	galapagos
dub	dub
epitelio	epithelial
vaškas	waks
vaškas	wax
arp	arp
užsiėmimai	sesyon
užsiėmimai	session
užsiėmimai	sessions
komplektas	kit
išmintis	karunungan
nuotėkio	leak
nuotėkio	makalabas
migruoti	ilipat
nascar	nascar
dniepropetrovsko	dnipropetrovsk
ultra	ultra
siuzana	susan
ost	ost
bambuko	bamboo
bambuko	kawayan
medėja	medea
goa	goa
apribojimus	limitasyon
luhansko	luhansk
miami	miami
vištos	chicken
vištos	manok
žmoniją	sangkatauhan
pasiūlymai	panukala
pasiūlymai	malambot
gabonas	gabon
liejimo	casting
bobo	bobo
bilietai	tiket
adm	adm
darfūro	darfur
įrengimas	installation
įrengimas	pagluklok
pažįstamas	familiar
pažįstamas	pamilyar
melas	kasinungalingan
melas	magsinungaling
melas	lie
greiti	mabilis
greiti	kabilis
greiti	fast
jens	jens
platinimas	pamamahagi
streikas	strike
streikas	welga
yehuda	yehuda
neoficiali	unofficial
aria	aria
krakmolas	gawgaw
dinas	dinas
kanye	kanye
lan	lan
bristolio	bristol
flores	flores
grafinis	maliwanag
grafinis	graphic
panašumo	pagkakatulad
babilonas	babilonya
babilonas	babylon
atsiųsti	download
jautienos	beef
korėjiečiai	koreanong
benzino	petrol
benzino	pump
jungti	conjugate
dvikova	duel
vaistininkas	parmasyutiko
timothy	timothy
giant	giant
giant	higante
fontana	fontana
wembley	wembley
romų	roma
hieroglifai	ehipsiyo
rao	rao
aloe	aloe
careerprizemoney	careerprizemoney
kiaušinis	itlog
koši	cauchy
blauzdos	hita
nojus	noe
nojus	noah
karma	karma
furjė	fourier
aso	aso
instrumentinis	instrumental
ficus	ficus
aura	aura
dieter	dieter
mango	mango
mango	mangga
tolerancijos	tolerance
tolerancijos	pinahihintulutan
kopros	copra
veidai	wade
žūklės	magkasakit
žūklės	habol
wang	wang
pacientas	pasyente
kepti	piniritong
kepti	pritong
derinimo	debug
linkolnas	lincoln
hun	hun
normanai	norman
mana	mana
akimirkos	moments
akimirkos	sandali
ilgumos	longitude
dario	dario
kartagina	kartago
išdėstymo	layout
ashley	ashley
nigeris	niger
negalia	disabilities
negalia	kapansanan
meditacija	meditation
meditacija	bulay
tan	tan
unicef	unicef
naujovės	innovations
naujovės	inobasyon
naujovės	innovation
išmatuotas	nasusukat
išmatuotas	sinukat
jensen	jensen
skersinės	transverse
simbolinę	symbolic
ave	ave
mariano	mariano
primatas	primate
liberalizmo	liberalismo
dviračiai	bisikleta
dviračiai	bisikleta
salvatore	salvatore
oyama	oyama
priemiesčių	suburban
akimirką	sandali
akimirką	moment
titlestyle	titlestyle
transplantacijos	transplant
suprojektuoti	pagkakagawa
suprojektuoti	dinisenyo
suprojektuoti	idinisenyo
ling	ling
agata	agatha
filippo	filippo
jodo	iodine
margo	margo
senatoriai	senators
torre	torre
leideno	leiden
rodrigo	roderick
rodrigo	rodrigo
trombocitų	platelet
dialogas	dialogue
franklinas	franklin
ūminis	malalang
ūminis	matinding
maršrutą	routing
uoga	berry
ajutajos	ayutthaya
plunksna	feather
myliu	nagmahal
myliu	love
myliu	nagmamahal
gfdl	gfdl
marcelo	marcelo
vale	vale
mic	mic
kepimo	baking
wrexham	wrexham
padangas	gulong
švente	pagdiriwang
švente	selebrasyon
investuotojas	mamumuhunan
eile	lane
epitelis	epithelium
highestsinglesranking	highestsinglesranking
karikatūristas	cartoonist
bulių	bulls
herodotas	herodotus
ego	ego
krūtų	dibdib
krūtų	suso
krūtų	suso
niutonas	newton
biotechnologijos	biotechnology
gražios	lovely
diplomatija	diplomasya
draugiškas	friendly
fin	fin
indukcijos	induction
agentūrų	kasu
sima	sima
gulbė	swan
antverpene	amberes
eksportuoti	export
mėgstamiausia	paborito
mėgstamiausia	favorite
misūrio	missouri
kane	kane
adeno	aden
farm	bukid
sutikimas	pahintulot
naujagimių	panganak
francesca	francesca
tigrai	tigers
išskirtinės	natatanging
burtininkas	wizard
albino	albino
demokratinis	democratic
demokratinis	demokratikong
paneigti	negro
bakterijas	bacteria
kriketo	cricket
kriketo	kuliglig
javascript	javascript
nepakankamumas	pagkabigo
sabina	sabina
tiger	tiger
tiger	tigre
verneris	werner
vestminsterio	westminster
telugų	telugu
gimines	relatives
gimines	kamaganak
maldonado	maldonado
džimas	jim
dialogo	dialogue
ropliai	reptiles
iššūkis	hamunin
iššūkis	challenge
iššūkis	hamon
fidžis	fiji
timoras	timor
samara	samara
deimantas	diamond
deimantas	brilyante
bahija	bahía
braga	braga
giancarlo	giancarlo
doublesrecord	doublesrecord
barenco	barents
jamato	yamato
lambert	lambert
išpuolių	umaatake
konfederatų	confederate
transliavimo	pagsasahimpapawid
transliavimo	broadcasting
trumpalaikis	maikli
trumpalaikis	maikling
midi	midi
claudia	claudia
investuotojai	mamumuhunan
indėlių	deposito
indėlių	deposit
blokai	blocks
lil	lil
tapatybė	pagkakakilanlan
tapatybė	pagkakilanlan
tapatybė	katauhan
surinamas	suriname
gogo	gogh
malaga	malaga
omanas	oman
garavimo	evaporation
puatjė	poitiers
parc	parc
aušinimo	pampalamig
susirinkimai	pagpupulong
kichotas	quixote
diskriminacija	diskriminasyon
tikslumo	kawastuhan
korteles	baraha
singlesrecord	singlesrecord
neutralus	neutral
balai	scores
įmontuotas	embedded
konkurentai	kaagaw
excelsior	excelsior
dai	dai
alexandre	alexandre
ivanovo	ivanovo
potraukį	humina
americana	americana
gore	madugong
gore	gore
msv	msv
diafragmos	diaphragm
padavimo	filing
ankstesnė	dating
ankstesnė	nakaraang
alicija	alicia
nobunaga	nobunaga
lockheed	lockheed
highestdoublesranking	highestdoublesranking
teismus	courts
drąsa	katapangan
drąsa	tapang
huangdi	huangdi
žydėjimo	halamang
dubajaus	dubai
kryžkelėje	crossroads
miegas	matulog
miegas	tulog
miegas	sleep
miegas	natulog
miegas	natutulog
citrinų	limon
citrinų	lemon
citrinų	lemons
dinaras	dinar
tunelį	tunnel
marciano	marciano
evakuoti	nilisan
evakuoti	lumikas
įsigyta	binili
konsultacijos	pagsangguni
konsultacijos	konsultasyon
egzoplaneta	exoplanet
sujungimo	maker
kirmėlių	bulate
būstas	pabahay
būstas	tirahan
būstas	accommodation
ipairs	ipairs
imtuvas	pinadalhan
imtuvas	tatanggap
imtuvas	receiver
nuoma	hire
nuoma	upa
nuoma	paupahan
nuoma	upahan
nuoma	umupa
nuoma	umupa
nuoma	upahan
nuoma	rent
nuoma	upa
nuoma	rental
nuoma	lease
kaimynas	kapwa
kaimynas	kapitbahay
kaimynas	neighbor
pirštas	daliri
pirštas	finger
jacqueline	jacqueline
ortega	ortega
ide	ide
mandela	mandela
kiribačio	kiribati
morrison	morrison
français	français
spartą	isparta
seule	seoul
tuberkuliozė	tuberculosis
grafinio	maliwanag
grafinio	graphic
džimis	jimmy
swansea	swansea
horizontas	horizon
miškininkystė	forestry
patogi	komportable
patogi	kumportable
uždirbti	kumita
subpage	subpage
stebėtojai	observers
abdullah	abdullah
išgyvenimo	matira
granata	grenade
jin	jin
sidney	sydney
minia	madla
kalbotyra	lingguwistika
mans	mans
teisėta	lehitimong
gražūs	ganda
gražūs	sarap
gražūs	nice
sinensis	sinensis
kontūrai	plot
kontūrai	outline
togas	togo
reputacija	reputasyon
derva	gum
mira	mira
choleros	kolera
madeiros	madeira
krokodilai	buwaya
joninių	midsummer
auxerre	auxerre
įrašymas	pagtatala
įrašymas	recording
devi	devi
betty	betty
gibson	gibson
šonkaulių	tadyang
#ffcc	#ffcc
panda	panda
stebuklas	himala
stebuklas	milagro
stebuklas	miracle
neigimas	maiksing
spalvoti	colored
spalvoti	kulay
mėgstamiausias	favourite
mėgstamiausias	paborito
mėgstamiausias	favorite
švarus	malinis
rowland	rowland
sankirtos	kanto
arno	arno
rojų	paraiso
rojų	paradise
coffea	coffea
neapykanta	hate
lyja	ulan
lyja	umuulan
elitas	pili
elitas	elite
diržas	sinturon
diržas	belt
brien	brien
australianopenresult	australianopenresult
sms	sms
knowles	knowles
metano	methane
massimo	massimo
kirk	kirk
clinton	clinton
donato	donato
biurų	opisina
matavimas	pagsukat
heraldika	heraldry
vairuotojų	driver
pomidorų	kamatis
romo	rum
gliese	gliese
aleutų	aleutian
gura	góra
išimtys	eksepsiyon
pateikimas	isinumite
pateikimas	pagsusumite
flavijus	flavius
mmorpg	mmorpg
spinduliuotė	radiation
leopardas	leopardo
dokumentacijos	dokumentasyon
dviračiu	pagbibisikleta
dviračiu	cycling
monografijos	monographs
usopenresult	usopenresult
romanovas	romanov
triušiai	kuneho
triušiai	rabbit
rembrantas	rembrandt
klonų	clones
hab	hab
konfigūracija	configuration
konfigūracija	pagsasaayos
shannon	shannon
naga	naga
degtinė	vodka
imunitetas	kalayaan
wells	wells
horst	horst
laurence	laurence
atspindys	reflection
fotografė	photographer
brassicaceae	brassicaceae
aklas	bulag
díaz	díaz
akušerijos	midwifery
transplantacija	transplant
priesaika	panunumpa
guillaume	guillaume
sunaikinimas	destruction
gaktos	singit
kapiliarų	kapilaryo
džamu	jammu
continental	kalapagang
fosfatų	phosphate
plakatai	poster
jura	jura
karel	karel
metodologija	pamamaraan
džiuljeta	juliet
respublikose	republics
aug	aug
zoran	zoran
routledge	routledge
andersen	andersen
twitter	twitter
banginis	balyena
patarėjai	tagapayo
stela	stella
paleologas	palaiologos
karvė	baka
mandatas	kautusan
frenchopenresult	frenchopenresult
ribojimas	pagbabawal
likusiam	oorder
džiaugsmo	joy
adobe	adobe
failas	tipunan
failas	magsampa
failas	talaksan
failas	file
mer	mer
meškutė	moth
elgėsi	pagkilos
neteisingas	mali
philipp	philipp
kvadratas	division
kvadratas	dibisyon
turkmėnija	turkmenistan
dharma	dharma
alvaro	alvaro
tenesio	tennessee
ginčytinas	contentious
mesa	mesa
kinematografija	cinematography
bruklino	brooklyn
gent	gent
varlė	palaka
klounas	payaso
klounas	pusong
neutralumo	neutrality
liucernos	lucerne
uniformas	uniporme
obi	obi
vip	vip
wimbledonresult	wimbledonresult
pomidorai	kamatis
pomidorai	kamatis
pasisekė	swerte
pasisekė	suwerte
pasisekė	lucky
žiaurus	hangad
žiaurus	brutal
paramore	paramore
įspūdinga	kahindik
buena	buena
samurajus	samurai
adalbertas	adalberto
antikūnų	antibody
emmanuel	emmanuel
eksportuojami	exports
gre	gre
bim	bim
labas	oy
netinkama	magsinungaling
atstatymas	pagpapanumbalik
vanagai	hawks
demokratinėje	democratic
demokratinėje	demokratikong
kabeliai	cable
rapsų	panggagahasa
ligūrijos	liguria
adaptacijos	adaptations
katarina	katarina
ruošos	log
kamuoliukas	baseball
lūžių	bali
maliarija	malaria
advokatai	abogado
agripa	agripa
kapitonai	masters
kapitonai	admins
hansen	hansen
stanfordo	stanford
whitney	whitney
pojūčius	sensations
gugenheimo	guggenheim
nustebino	namangha
fermentas	enzyme
adatos	needle
gabriele	gabriele
forbes	forbes
preparatas	paghahanda
nusipelnė	nararapat
nusipelnė	marapat
suplanuotas	hoax
rubens	rubens
šešėliai	anino
timeaxis	timeaxis
žmogžudysčių	murders
bara	bara
pradešas	pradesh
sraigtasparnio	helicopter
abejonės	pagdududa
abejonės	duda
abejonės	doubt
abejonės	alinlangan
stumia	nagtutulak
stumia	tinutulak
tolerancija	tolerance
tolerancija	pinahihintulutan
pasodinti	nagtanim
pasodinti	nakatanim
burtininkų	wizards
nykštukas	bansot
raja	skate
didvyriai	heroes
soli	soli
étienne	étienne
gebėjimai	kakayahan
bernardino	bernardino
tara	tara
kiauliena	pork
kiauliena	baboy
trieste	trieste
xxv	xxv
ontarijas	ontario
luizianos	louisiana
bosch	bosch
švieži	fresh
švieži	sariwa
delegatai	delegates
matteo	matteo
protingas	matalino
protingas	talino
undef	undef
imuniteto	kalayaan
maui	maui
teisėtai	legal
meilužė	kabit
delis	delhi
kriaušių	pear
karbonatas	carbonate
žiburiai	ilaw
pranciškonai	franciscan
walther	walther
naujovė	novelty
naujovė	inobasyon
naujovė	innovation
ava	ava
atveria	binubuksan
atveria	bumukas
grove	grove
jung	jung
cartier	cartier
mhnt	mhnt
padažu	sarsa
padažu	sauce
troškimas	pagnanais
troškimas	desire
troškimas	nais
perlai	pearls
paruošimas	paghahanda
triumfas	pagtatagumpay
ursula	ursula
andersson	andersson
baba	baba
testcases	testcases
sikstas	sixto
gianni	gianni
pojūtis	sensation
premjerą	premier
importuoti	import
importuoti	imported
chloro	chlorine
nicholson	nicholson
guobų	elm
saudas	saud
tobulas	perfect
tobulas	perpekto
konkurentas	karibal
konkurentas	kaagaw
vikšras	higad
utar	uttar
nuestra	nuestra
aimarų	aymara
lervų	larvae
cdu	cdu
yamaha	yamaha
vinci	vinci
pečius	balikat
rezonanso	resonance
graužikai	rodentia
andai	andes
pagalvės	unan
kauliukai	dice
trinties	kiskisan
ščecino	szczecin
tikslūs	tumpak
tikslūs	tama
naudingumo	utilidad
naudingumo	utility
christine	christine
butelis	bote
milton	milton
deutsch	deutsch
pasitiko	tumalon
trokšta	hinahangad
trento	trento
kriauklė	kabibe
prefektas	prefect
shah	shah
šviežias	fresh
šviežias	sariwa
arte	arte
monde	monde
alabama	alabama
clash	clash
bray	bray
ateiviai	alien
deutscher	deutscher
trs	fms
persėjas	perseus
aleksijus	alexios
višta	chicken
višta	manok
jubiliejus	anibersaryo
kalkių	lime
slanksteliai	vertebrae
bombardavimo	pambobomba
bombardavimo	pagbomba
gros	gros
vat	basa
ačiū	salamat
vidurnakčio	midnight
vidurnakčio	hatinggabi
beselio	bessel
maitinimas	nakatakda
ketverto	quartet
lynch	lynch
nelygybė	inequality
stygas	string
stygas	strings
nero	nero
semantika	semantika
lempa	bulb
lempa	ilawan
lempa	lampara
viskis	whisky
skauda	sugat
skauda	masakit
solis	solis
bukų	haya
astra	astra
pašalina	inaalis
remixes	remixes
mechelen	mechelen
atidėta	deferred
majos	maysky
goja	goya
kosmonautas	cosmonaut
altvar	altvar
mozaikos	mosaics
sheryl	sheryl
stemma	stemma
sepc	sepc
andamanų	andaman
mineralinis	mineral
paulus	paulus
rezoliucijos	resolution
egzaminas	exam
dviračio	bisikleta
šaukia	sigaw
žolelių	herbal
žolelių	damo
mindanao	mindanao
abatas	abbot
abatas	abad
katmandu	kathmandu
velvet	velvet
kat	kat
vin	vin
morkų	carrot
ketinimus	hangarin
hewitt	hewitt
pianino	piano
fasas	faso
pirkėjas	bibili
pirkėjas	bumibili
pirkėjas	pagsisisi
pirkėjas	mamimili
derinimas	bati
derinimas	configuration
derinimas	pagsasaayos
humbolto	humboldt
martenas	maarten
kosmologija	kosmolohiya
mylėti	mapagmahal
mylėti	loving
kabina	sabungan
kabina	cab
norwich	norwich
musée	musée
geresnė	better
judaizmas	hudaismo
elis	ellis
ultima	ultima
strauss	strauss
blade	blade
domina	interesado
ginčytina	nasuri
ginčytina	tumutol
frans	frans
arturo	arturo
drobė	canvas
blužnies	spleen
lova	kama
pitsburgo	pittsburgh
hardy	hardy
talentingas	talentadong
jautrios	sensitibong
jautrios	sensitive
jautrios	sensitibo
atskyrimo	paghihiwalay
krokodilas	buwaya
varuna	varuna
ieee	ieee
biurai	opisina
mūza	muse
flamenko	flamenco
liststyle	liststyle
kama	kama
celta	celta
justinianas	justiniano
gomurio	palate
įtaisytas	embedded
auglys	tumor
auglys	bukol
factbook	factbook
daniela	daniela
blogiau	malala
berg	berg
zagrebas	zagreb
papuošalas	alahas
lyra	lyra
kabinos	sabungan
baseinai	pool
procesija	prusisyon
būgno	tambol
būgno	drum
sutuoktiniai	divorce
atmesta	tinanggihan
paliečia	nararating
sprogo	sumabog
alla	alla
segmentai	segments
pramoga	libangan
pramoga	entertainment
manipuliuoti	mamanipula
kampinis	angular
donata	donata
imagesize	imagesize
carrera	carrera
cunamio	tsunami
wes	wes
puccini	puccini
nippon	nippon
kalabrijos	calabria
gómez	gómez
lemiamas	decisive
eugen	eugen
kobra	cobra
bella	bella
sato	sato
vagonai	vans
marksas	marx
nesėkmė	pagkabigo
valerius	valerius
kingston	kingston
diaz	diaz
wesley	wesley
plotarea	plotarea
užblokuotas	hinarangan
kalis	potassium
mirtina	aswang
mylios	milyang
mylios	mile
mylios	milya
džonatanas	jonathan
santrumpos	daglat
scalemajor	scalemajor
ankaros	ankara
geria	inuman
geria	inom
geria	inumin
geria	umiinom
toto	toto
metras	metro
saugus	gym
inka	inca
parazitų	parasite
valenciennes	valenciennes
dio	dio
išsaugojimas	pagaalaga
išsaugojimas	pangangalaga
willis	willis
medici	medici
malibu	malibu
christoph	christoph
montpellier	montpellier
himalajinis	himalayan
geoffrey	geoffrey
wikitable	wikitable
soto	soto
bilietus	tiket
castillo	castillo
liam	liam
granatas	garnet
pont	pont
prizų	prizes
prizų	premyo
sullivan	sullivan
pamiršti	kalimutang
pamiršti	kalimutan
pamiršti	makakalimutan
klausas	claus
phantom	phantom
silpną	malamlam
sabbath	sabbath
aldo	aldo
kooperatyvas	matulungin
kooperatyvas	kooperatiba
slėpti	itago
motyvacija	pagganyak
motyvacija	motibasyon
serge	serge
atlaidus	mapagpatawad
kedrų	cedar
posėdžiai	pagpupulong
posėdžiai	sesyon
posėdžiai	session
posėdžiai	sessions
vergas	alipin
musmirė	caesarea
privalomi	sapilitan
umaras	umar
deimantai	oros
deimantai	diamonds
aliuminis	aluminium
aliuminis	aluminum
darbdavys	employer
testai	pagsusulit
barbuda	barbuda
tektoninių	tectonic
aviečių	prambuwesas
paskola	pautang
demi	demi
įnašas	kontribusyon
drakula	dracula
džinas	genie
ramón	ramón
sengoku	sengoku
lolita	lolita
hasanas	hassan
afrikanų	afrikaans
elias	elias
verpimo	spinning
šalmą	helmet
loginis	lohika
loginis	logic
įtarimai	paratang
įžymybių	celebrity
įžymybių	celebrities
blogiausia	pinakamasama
blogiausia	worst
pelkę	marsh
pelkę	lumubog
olympiacos	olympiacos
abs	abs
español	español
sulaužė	damayan
sulaužė	winasak
apklausa	botohan
apklausa	poll
nelaimė	sakuna
nelaimė	kalamidad
autobuso	bus
nie	nie
rūkymo	naninigarilyo
rūkymo	paninigarilyo
grynasis	net
chanty	khanty
gustaf	gustaf
muntjakas	muntjac
absolventų	nagtapos
absolventų	graduates
skalės	scales
alignbars	alignbars
soundtrack	soundtracks
pueblo	pueblo
apmokyti	hubog
apmokyti	bihasa
deir	deir
gerinimo	pagpapabuti
dialogai	dialogues
teodosijus	theodosius
meluoja	nakahiga
sudėtingumas	nahirapan
svajonės	dreams
svajonės	pangarap
sidi	sidi
rupija	rupi
išbandytas	tested
išbandytas	nasubok
konsultavimas	pagsangguni
konsultavimas	konsultasyon
grįžimas	bumalik
grįžimas	pagbabalik
grįžimas	bumabalik
dokumentacija	dokumentasyon
trauka	gravity
shuttle	shuttle
chara	chara
erasmus	erasmus
marcos	marcos
manijokai	cassava
noel	noel
cern	cern
kodavimo	coding
žmogžudystė	homicide
nata	nata
svyravimų	kaibahan
bam	bam
psichinės	psychic
krevetės	alamang
sofoklis	sophocles
intervencija	pamamagitan
nagus	kuko
damos	lady
asbesto	asbestos
coventry	coventry
sandėlio	warehouse
sandėlio	bodega
diabetu	diabetes
nuostabus	pambihira
nuostabus	galing
nuostabus	amazing
nuostabus	nakakatuwa
nuostabus	adorable
fabricius	fabricius
subaru	subaru
shelley	shelley
vitaminai	bitamina
vitaminai	bitamina
vitaminai	vitamin
osbourne	osbourne
iliuzija	ilusyon
barjerą	hadlang
barjerą	harang
poilsis	paglilibang
poilsis	libangan
poilsis	pahinga
poilsis	pagpapahinga
makaronų	pansit
makaronų	pancit
midus	mead
cilindras	cylinder
kabulo	kabul
sąžinės	budhi
vasco	vasco
jackie	jackie
vagis	magnanakaw
abba	abba
nuoga	hubad
manu	manu
sinatra	sinatra
kon	kon
įterpti	insert
grobis	manghuli
andronikas	andronikos
origami	origami
dima	madilim
hoffmann	hoffmann
lippi	lippi
fidi	chateau
apelsinų	orange
apelsinų	kahel
revolveris	revolver
medūzos	dikya
dvynys	kambal
dvynys	twin
ambicijų	ambisyon
amžina	eternal
suvereniteto	soberanya
gaila	naawa
gaila	awa
gaila	patawad
gaila	paumanhin
gaila	kapus
gaila	malas
setas	seth
batus	bota
batus	boots
suvirinimo	hinang
akordeonas	accordion
aromato	aroma
pilvą	puson
tiesiogine	literal
tech	tech
pykčio	rage
diablo	diablo
paradas	parada
paradas	parade
kopūstai	cabbage
porta	porta
gaidukas	ruff
crest	crest
loa	loa
mora	mora
madre	madre
ateistas	atheist
alvaras	alvar
kandži	kanji
javiečių	javanese
dviratis	bike
dviratis	bisikleta
alyva	langis
alyva	oil
kaskada	cascade
klijai	adhesive
franšizės	franchise
kmi	bmi
rodriguez	rodriguez
komplikacijos	komplikasyon
bilietas	ticket
bilietas	tiket
ldp	ldp
akcentas	suppress
akcentas	accent
cosmos	cosmos
hart	hart
gomes	gomes
mergedrow	mergedrow
chiesa	chiesa
baitų	byte
elegans	elegans
vilkikas	trak
sprogdinimo	mapanira
maiden	pagkadalaga
maiden	maiden
sunkumai	challenges
sunkumai	nahirapan
algos	companya
algos	salaries
muller	muller
išmokyti	turuan
išmokyti	magturo
roc	roc
rytais	umaga
atspindžiai	reflections
gavėjas	tatanggap
gavėjas	pinadalhan
gavėjas	tatanggap
gavėjas	receiver
frida	frida
šarvuotas	pagsakay
šarvuotas	armored
narsą	valor
blanc	blanc
kendo	kendo
trajanas	trajan
hegemonija	hegemoniya
apribojimas	pagbabawal
feraros	ferrara
sąjungininkas	ally
sužadėtinė	fiancée
azul	azul
malo	malo
gora	gora
groupstyle	groupstyle
hagen	hagen
kvepalai	pabango
klijų	adhesive
quo	quo
stojimo	accession
durklai	punyal
vladivostoko	vladivostok
raštingumo	mangmang
raštingumo	literacy
lemūras	lemur
požemių	underworld
sodinti	planting
įkaitų	hostage
brunėjus	brunei
duisburg	duisburg
bursa	bursa
karnavalas	karnabal
karnavalas	carnival
kvepalų	bango
fierro	fierro
karina	karin
karina	karina
ūkininkus	bagsak
atspindžio	reflection
karpiai	karpa
ira	ira
gilmour	gilmour
lengvesnis	lighter
dateformat	dateformat
robotai	robot
ekstraktas	extract
ekstraktas	kunin
gaja	gaia
atgailos	pagsisisi
interaktyvus	interactive
laz	laz
motu	motu
jautiena	beef
apsauginis	protective
kupolu	dome
purana	purana
sugalvotas	imbento
išvykimo	alis
mantra	mantra
birmos	burma
kia	kia
rymano	riemann
pyragas	cake
pyragas	pie
drenažo	kanal
vandalizmo	bandalismo
įgimta	sapul
gansu	gansu
rikis	ricky
rūpi	pinahahalagahan
rūpi	cares
panašumas	pagkakatulad
ištvermės	tiyaga
ištvermės	pagtitiyaga
skitai	eskito
cox	cox
chang	chang
moi	moi
driežas	butiki
driežas	butiking
anarchija	anarkiya
bėgikė	runner
thornton	thornton
pašaras	feed
žirnių	peas
stiprinimas	paglakas
frédéric	frédéric
amazon	amazon
justo	justo
spurs	spurs
concordia	concordia
zoo	zoo
izoliacijos	pagkakabukod
izoliacijos	paghihiwalay
rada	rada
kpv	oga
satyras	satiro
hubert	hubert
saugojimas	imbakan
saugojimas	storage
spin	spin
fuji	fuji
vargo	misery
esteban	esteban
meldėsi	nagdasal
gerovė	kasaganaan
gerovė	ikauunlad
tulūzos	toulouse
grietinėlės	cream
angelica	angelica
blokadą	blockade
occidentalis	occidentalis
piemenys	pastol
dervos	sumira
dervos	hash
marškiniai	shirt
marškiniai	shirts
mariner	mariner
nov	nobyembre
emeritas	emeritus
kelionėms	bumiyahe
kelionėms	travel
kelionėms	paglalakbay
wilder	wilder
sales	bulwagan
vaiduoklis	ghost
vaiduoklis	multo
diagramos	diagram
baja	baja
magelanas	magellan
avivas	aviv
berkeley	berkeley
hofmanas	hoffman
saulėlydžio	twilight
našumas	produktibo
bai	bai
tiranos	tirana
klientui	customer
klientui	kustomer
suahilių	swahili
įgijimas	pagkuha
harbour	harbour
dietos	diyeta
dietos	diet
kadagių	juniper
emo	emo
morton	morton
lightblue	lightblue
bretanės	brittany
tnt	tnt
nardymo	diving
nardymo	sisid
gaudija	gaudiya
amon	amon
rahman	rahman
rush	rush
royale	royale
pastabas	obserbasyon
pastabas	comments
tora	tora
pamoka	lesson
pamoka	aral
fantazija	pantasya
fantazija	fantasy
sindziango	xinjiang
garantijos	garantiya
demetra	demeter
keltu	ferry
fredas	peace
fredas	kapayapaan
vonios	paliguan
vonios	paliguan
vonios	naliligo
aptikimo	detection
aptikimo	pagtuklas
dramas	dramas
eugène	eugène
holland	holland
breton	breton
bolivaras	bolívar
tesla	tesla
saro	saarland
iglesias	iglesias
eskizai	sketches
įsitikinimus	paniniwala
damiano	damiano
profilaktika	prophylaxis
klausytojai	tagapakinig
sibiu	sibiu
sforza	sforza
karlsonas	carlson
polinezija	polynesia
kasitų	kassite
pavlovas	pavlov
hendrix	hendrix
borough	boro
persona	persona
grasino	threatened
grasino	nanganganib
grasino	binantaan
gem	perlas
zee	zee
močiutė	lola
močiutė	lola
jefferson	jefferson
represijos	repression
bantu	bantu
mintimis	thoughts
mintimis	saloobin
adata	needle
moduliai	modules
erdvėlaivių	spacecraft
saugi	ligtas
saugi	safe
rūgštingumas	acidity
kelnes	pantalon
akvedukas	aqueduct
karstas	kabaong
lavigne	lavigne
nic	nic
pirkėjai	bibili
pirkėjai	bumibili
pirkėjai	pagsisisi
pirkėjai	mamimili
orientalis	orientalis
tiesiosios	tumbong
insulino	insulin
paskirstyti	mamahagi
paskirstyti	ipamahagi
benevento	benevento
chomsky	chomsky
hopkins	hopkins
kasyba	pagmimina
kasyba	mining
agustín	agustin
salo	salo
laboratorijų	laboratories
cfa	cfa
feodalinė	feudal
kay	kay
pasauliai	daigdig
grampus	grampus
impulso	pulso
impulso	tibok
pridėtinės	naidagdag
pridėtinės	idinagdag
suderinama	compatible
suderinama	katugma
oblivion	limot
tokugava	tokugawa
ari	ari
kiaulienos	pork
kiaulienos	baboy
bhakti	bhakti
femme	femme
lana	lana
rosita	rosita
nagasakio	nagasaki
eksperimentinių	ekonomiks
žiniatinklio	web
morales	morales
galutiniai	pinal
galutiniai	pangwakas
galutiniai	final
galutiniai	panghuling
galutiniai	depinitibo
aliaska	alaska
horizontalus	pahigang
horizontalus	pahalang
mvp	mvp
akacijų	acacia
garda	garda
savižudybė	magpakamatay
savižudybė	pagpapakamatay
prometėjas	prometheus
našta	pasakit
pajėgumas	kapasidad
pajėgumas	makayanan
pajėgumas	kakayahan
stebuklingas	magical
brodvėjaus	broadway
vynuogynų	ubasan
volgogrado	volgograd
lėja	leah
pikselių	pixel
biokuro	biofuel
tojotomi	toyotomi
fleming	fleming
dinozauras	dinosaur
cigarečių	sigarilyo
cigarečių	sigarilyo
sudomino	janet
breslau	breslau
selo	selo
telekomunikacijos	telekomunikasyon
šilta	maiinit
šilta	mainit
petri	petri
rowell	rowell
vairuotojai	driver
duncan	duncan
atverti	buksan
atverti	bukas
atverti	open
olmekų	olmek
pralaimėjimus	daig
pralaimėjimus	pagkatalo
gerd	gerd
aguonų	poppy
ipswich	ipswich
buhalteris	accountant
besivystančių	umuusbong
karteris	carter
ekologinio	organic
guerra	guerra
išilginės	longitudinal
bronchus	bronchi
izoliacija	pagkakabukod
izoliacija	paghihiwalay
srb	srb
paprašyti	hilingin
paprašyti	ask
paprašyti	magtanong
paprašyti	tanungin
paprašyti	itanong
guillermo	guillermo
šiltinės	typhus
sekimo	pagsubaybay
vertigo	vertigo
mussolini	mussolini
kler	claire
lankstus	flexible
lankstus	nababaluktot
elite	pili
elite	elite
festivalius	festivals
royce	royce
veiksmingumas	husay
veiksmingumas	kahusayan
veiksmingumas	birtud
clamp	clamp
izotopų	isotopo
maurai	moro
malone	malone
išvestinė	deribatibo
drąsos	katapangan
drąsos	tapang
palaima	pagpapala
bikini	bikini
mikrobangų	microwave
negalią	kapansanan
kėdžių	upuan
kėdžių	silya
barų	bars
šriftas	font
timas	tim
karščiavimas	lagnat
karščiavimas	fever
užterštas	nilason
užterštas	nahawahan
blackmore	blackmore
dienoraščiai	diaries
hamletas	hamlet
šiandienos	ngayon
nukleotidų	nucleotide
gamecube	gamecube
beit	beit
trapi	marupok
marcello	marcello
kubizmo	kubismo
freiburg	freiburg
valentin	valentin
balionas	lobo
blogiausias	pinakamasama
blogiausias	worst
harisonas	harrison
tamplierių	templar
kazanė	kazan
apsinuodijimo	poison
chinensis	chinensis
apeigomis	rites
magas	salamangkero
lydėti	samahan
reo	reo
terorizmu	terorismo
ingres	ingres
berlusconi	berlusconi
atkuriama	ibinalik
kalugos	kaluga
ergo	ergo
huang	huang
sulaikymo	detention
orgazmas	sukdulan
angus	angus
leigh	leigh
pupos	beans
pupos	munggo
rui	rui
įdiegtas	installed
įdiegtas	install
įdiegtas	nakaluklok
nasdaq	nasdaq
synthpop	synthpop
abbr	abbr
kaltė	kasalanan
kaltė	kasalanan
kaltė	pagkakasala
amadeus	amadeus
zoologija	soolohiya
homme	homme
įvardis	panghalip
kėdė	upuan
rimti	seryoso
stein	stein
kelionei	bumiyahe
kelionei	travel
kelionei	paglalakbay
lęšiai	lens
lęšiai	lente
lęšiai	lente
lęšiai	lenses
tunisą	tunisia
memfio	memphis
šėtonas	demonyo
charger	charger
narkotikai	drugs
narkotikai	droga
narkotikai	gamot
lozanoje	lausanne
dina	dina
kaltina	inakusahan
rinkodara	pamimili
rinkodara	marketing
romantizmas	romantisismo
amelija	amelia
sakramentas	sacramento
imunitetą	kalayaan
cro	cro
bakas	tank
bakas	tangke
def	def
apiaceae	apiaceae
esminius	mahalaga
esminius	mahahalagang
helis	helyo
teroristai	terorista
andhra	andhra
miltus	harina
tripolis	tripoli
kit	kit
transilvanijoje	transylvania
geometrinės	geometric
glam	glam
deginti	nasusunog
figaro	figaro
pirkimas	bilhin
pirkimas	pagbili
pirkimas	bumili
pirkimas	paghanap
ateizmas	ateismo
žąsys	goose
traktorius	millie
paaugliai	kabataan
paaugliai	tinedyer
pld	pld
erfurt	erfurt
kylie	kylie
žudo	kills
žudo	pagpatay
barbarosa	barbarossa
graužikas	eater
tvenkinyje	pond
tvenkinyje	lawa
lancer	lancer
meilužis	lover
stream	batis
stream	daloy
adriana	adriana
diuseldorfo	düsseldorf
sausgyslės	tendon
humanitarinė	humanitarian
bučas	butch
narkotinių	barometro
ištirpsta	natutunaw
kiaulė	baboy
heian	heian
carey	carey
bausti	punish
žydėti	blossom
žydėti	pamumulaklak
žydėti	namumulaklak
pratybos	drill
ikrai	bihud
gazelė	gazelle
scaleminor	scaleminor
kala	kala
haus	haus
patikslintas	revised
patikslintas	iniba
studentė	studyante
studentė	student
studentė	estudyante
sandūra	junction
srt	srt
plaučiai	baga
plaučiai	baga
kompensacija	compensation
kompensacija	sweldo
juostelių	dawa
belgorodo	belgorod
vargšas	mahirap
vargšas	kawawang
dantė	dante
stepė	steppe
pyktis	galit
pyktis	poot
silkės	tamban
spyruoklės	springs
rouge	rouge
seksualumo	sexuality
stiprintuvas	tagasunod
stiprintuvas	booster
indeksai	indices
