lietuvos	lithuanian
apie	about
kaip	how
kaip	like
kad	that
taip	yep
taip	yes
taip	yeah
taip	yup
savo	your
pat	pat
vieta	venue
vieta	locations
kaimas	village
šiaurės	nordic
tik	only
tik	just
vilniaus	vilnius
mirties	death
bet	but
lietuvių	lithuanian
miesto	urban
turi	must
dar	still
dalis	part
kauno	kaunas
vilnius	vilnius
kalba	language
karo	war
kultūros	culture
labai	very
birželio	june
jie	they
kurie	who
kur	where
daug	many
daug	much
rytų	east
rytų	eastern
mokykla	schools
mokykla	school
čia	here
kuri	kuri
vakarų	west
vakarų	western
muzikos	musical
nors	though
futbolo	soccer
futbolo	football
pietų	lunch
daugiau	more
kaimo	village
jau	already
and	duck
dirbo	worked
jonas	jonas
dalyvavo	implicated
dalyvavo	participated
kalbos	languages
kalbos	language
universiteto	psychological
mokyklos	school
šeimos	family
upės	river
upės	rivers
šiaulių	šiauliai
xix	xix
dabar	now
rajonas	district
gyveno	resided
gyveno	lived
dainų	songs
darbo	working
isbn	isbn
vandens	aquatic
vaikai	children
oro	air
tekstas	text
anglų	english
meno	arts
meno	artistic
svetainė	website
administracinis	administrative
istorijos	story
istorijos	history
bažnyčios	churches
jūros	sea
kas	what
kas	who
gyvena	lives
universitetas	university
kaunas	kaunas
apskritis	county
įkurta	founded
šio	this
ežeras	lake
romos	roman
palenkės	gmina
beveik	nearly
mokslo	science
vytautas	vytautas
pasaulyje	worldwide
antanas	anthony
antanas	antanas
kartais	sometimes
kartais	occasionally
juozas	juozas
kaime	village
šių	these
herbas	herb
herbas	emblem
tūkst	thousand
tėvas	father
sporto	sport
sporto	sporting
gavo	got
karalius	king
juos	them
muziejus	museum
šeima	family
kaune	kaunas
laimėjo	won
provincija	province
salos	island
upė	river
istorija	story
istorija	history
com	com
sūnus	son
tsrs	ussr
tsrs	soviet
kelio	road
amerikos	american
amerikos	america
klubas	club
klubas	hip
piliakalnis	mound
teatro	theatrical
teatro	theater
teatro	theatre
giminės	relatives
laiko	temporal
laiko	time
pedagogas	pedagogue
sudarė	represented
teka	flowing
veikia	works
rūšis	species
gyvenimo	living
gyvenimo	life
kelias	road
panevėžio	panevėžys
būtų	would
pietus	lunch
žmogaus	human
netoli	near
užsienio	foreign
apibūdinimas	characterisation
apibūdinimas	description
moterų	female
literatūros	literary
žmona	wife
amžiaus	age
amžiaus	ages
auga	growing
auga	grow
klubo	hip
lietuva	lithuania
dvaro	strut
inžinierius	engineer
balstogės	białystok
prūsijos	prussian
rudenį	autumn
provincijos	provinces
aktorius	actor
futbolininkas	footballer
veikė	acted
rūšių	species
institutas	institute
raj	raj
išrinktas	elected
pavasarį	underground
senovės	ancient
xiv	xiv
direktorius	director
britų	british
kartus	times
motina	mothers
motina	mother
xiii	xiii
ilgis	length
filmas	movie
filmas	film
didysis	big
augalų	plant
parkas	park
daina	song
išleistas	released
katalikų	catholic
tada	then
šachmatų	chess
bgcolor	bgcolor
miestai	towns
miestai	cities
petras	petras
kelių	road
kalnų	mountain
sala	island
profesorius	professor
apsaugos	protection
dalies	part
komanda	team
kūno	body
bus	will
radijo	radio
komandos	teams
afrikos	african
colspan	colspan
jaunimo	youth
žydų	jewish
vyksta	happening
prekybos	marketing
aleksandras	aleksandr
aleksandras	alexander
žinoma	course
maždaug	approx
kol	pending
rūšys	species
televizijos	television
jūrų	marine
premija	bonus
premija	prize
politikas	politician
grigaliaus	gregorian
statybos	build
choro	choir
japonijos	japan
japonijos	japanese
didžiausias	maximum
graikų	greek
pareigas	duties
dvaras	manor
čempionatas	championship
jai	she
paskirtas	appointed
aukso	gold
gydytojas	physician
gydytojas	doctor
taurė	cup
būdu	way
uab	uab
vasaros	summer
poetas	poet
verslo	business
dainos	song
dainos	songs
trakų	trakai
spalvos	colours
spalvos	colour
ispanijos	spain
ispanijos	spanish
xvii	xvii
reikia	need
sienos	wall
karinis	military
katedros	cathedral
žurnalistas	journalist
imperija	empire
parašė	wrote
tsr	tsr
marijos	mystery
armijos	army
turnyras	tournament
kultūra	culture
geriausias	best
vokietija	germany
švietimo	educational
gitara	guitar
gerai	good
kunigaikštystės	principality
gana	ghana
gana	pretty
paveldo	heritage
visiškai	fully
kunigas	priest
aktorė	actor
aktorė	actress
moteris	woman
moteris	female
liublino	lublin
čempionato	championship
viii	viii
pro	pro
krepšinio	basketball
kinijos	chinese
vyr	senior
jiems	them
eina	goes
utenos	utena
kaimai	villages
žmogus	human
žmogus	man
namai	homes
namai	houses
žaidėjas	player
automobilių	automobile
automobilių	automotive
teatras	theater
teatras	theatre
stotis	station
sutuoktinis	spouse
paminklų	monuments
lygos	league
filmų	films
keletą	few
kapinės	cemetery
spaudos	press
taikos	peace
gamybos	production
kompozitorius	composer
vietų	seats
aukštis	elevation
daugiausiai	max
karas	war
darbai	works
anglijos	england
persikėlė	swept
knyga	book
parapija	parish
vidaus	internal
intakas	tributary
nepriklausomybės	independence
indijos	indian
indijos	india
greitai	quick
greitai	soon
greitai	fast
greitai	quickly
sovietų	soviet
technologijos	technologies
technologijos	technology
departamentas	department
algirdas	algirdas
palaidotas	buried
biblioteka	library
kazimieras	kazimierz
jas	them
teisininkas	lawyer
paminklas	monument
abu	both
abu	abu
klasės	class
pilis	castle
čempionas	champion
informacija	information
mūsų	ours
architektūros	architectural
įmonės	undertakings
garbės	honour
garbės	honor
miško	woods
architektas	architect
stovi	parked
uefa	uefa
tampa	becoming
upių	rivers
medžiagų	materials
koplyčia	chapel
organizacija	organisation
galerija	gallery
valstiečių	peasant
imperatorius	emperor
sudėtis	composition
savivaldybė	municipality
knygą	book
#aaa	#aaa
tomas	tomas
tomas	tom
kunigaikštis	duke
elektros	electricity
km²	km²
knygos	books
ministerijos	ministries
tautos	nations
medžiagos	materials
kranto	shore
kompanija	company
dramos	drama
azijos	asian
departamento	departmental
roko	rocco
min	min
treneris	trainer
treneris	coach
filosofijos	philosophy
amerikoje	america
ataskaita	report
mykolas	michał
britanijos	british
rinkimų	electoral
rinkimų	election
ukrainos	ukrainian
istorikas	historian
rašė	wrote
laikoma	considered
apdovanojimai	prizes
studentų	student
miškai	forests
vii	vii
finalas	final
fakulteto	faculty
kalnas	mountain
linija	line
aplinkos	ambient
nuolat	continuous
policijos	police
augalas	plant
dainininkė	singer
medžiaga	material
medžiaga	substance
gedimino	gediminas
mano	mine
katedra	cathedral
akademija	academy
unesco	unesco
apima	covers
sekretorius	registrar
ispanų	spanish
kurti	curtis
didžiausia	peak
dalys	chunks
dalys	shares
žaidynėse	olympics
akmuo	rock
romanas	novel
kariuomenė	army
gyvūnų	animals
gyvūnų	animal
vaivadija	voivodeship
brolis	brother
dalyvauja	participates
temperatūra	temperature
temperatūra	temperatures
asociacijos	associations
asociacijos	association
fizikos	physics
pajėgų	retreat
popiežius	pope
didelis	big
didelis	large
greta	greta
pajėgos	forces
žiemos	winter
lyga	league
federacijos	federation
išleista	spent
varžybose	competitions
lauko	outdoor
amžius	age
gamyba	manufacture
gamyba	production
gamyba	manufacturing
žurnalo	logbook
klaipėda	klaipeda
arabų	arab
kraštas	frame
gimnazija	gymnasium
vengrijos	hungarian
argentinos	argentina
galiausiai	eventually
baigęs	expired
mokymo	teaching
mokymo	training
dolerių	dollars
dolerių	dollar
atsisakė	refused
japonų	japanese
žaidimų	games
kilmė	origin
leftarm	leftarm
įmonė	company
įmonė	business
aktyviai	active
liberalų	liberal
tiltas	bridge
popiežiaus	papal
bendrovė	company
save	self
dinastija	dynasty
šakių	forks
darbas	job
darbas	work
metalo	metallic
gyvenimas	life
slavų	slavic
žaidžia	playing
bendrovės	corporate
bendrovės	company
bendrovės	companies
tiesiog	simply
tiesiog	just
žaidimas	game
medžio	tree
akmens	stone
kaliningrado	kaliningrad
pilies	castle
pilies	palace
kaimų	villages
paliko	left
modelis	model
naftos	oil
karinės	military
bendras	common
naujai	newly
ligos	illness
ligos	sickness
teisėjas	judge
teisėjas	referee
dievas	god
david	david
lapai	foliage
pulkininkas	symbol
pulkininkas	col
žurnalas	logbook
žurnalas	magazine
didelės	big
vyras	male
vyras	husband
vyras	man
armija	army
jūra	sea
finansų	finance
jungtinės	united
pinigų	cash
stanislovas	stanisław
darbuotojas	employee
darbuotojas	worker
projektas	project
andrius	andrius
mokytoja	teacher
krikščionių	christians
kinų	chinese
ištekėjusi	married
mergelės	virgo
sen	sen
motinos	mothers
linijos	lines
linijos	loop
humanitarinių	humanities
vietose	locations
judėjimo	movements
teorija	theory
filosofas	philosopher
kūnas	body
politechnikos	polytechnic
atlikėjas	performer
atlikėjas	artist
gyventi	residence
gyventi	live
gyventi	living
egipto	egypt
egipto	egyptian
galvos	head
partijų	batches
dalyvavimas	attendance
dalyvavimas	involvement
dalyvavimas	participation
atvyko	arrived
spalva	color
spalva	colour
sėkmingai	successful
sėkmingai	successfully
pedagogė	educator
laikas	timing
laikas	time
henrikas	heinrich
grand	grand
kalnuose	mountains
projekto	project
aviacijos	aviation
tapti	become
tvenkinys	reservoir
visada	always
moterys	female
moterys	women
šiauliai	šiauliai
gynėjas	defender
formulės	formula
formulės	formulae
kanados	canada
žuvų	fish
teorijos	theory
turėtų	should
pareigos	responsibilities
terminas	maturity
saugas	midfielder
kūriniai	works
ežerų	lakes
google	google
šviesos	luminous
šviesos	lights
pėstininkų	infantry
puolėjas	quarterback
demokratų	democrats
demokratų	democrat
emblema	emblem
surengė	hosted
kęstutis	kęstutis
archeologijos	archaeological
tyrimai	studies
tyrimai	investigations
kalnai	mountains
danijos	denmark
psl	psi
juozapas	józef
tarnavo	served
širdies	cardiac
širdies	heart
ekonomistas	economist
viktoras	victor
funkcija	function
liga	sickness
geriausia	ideally
geriausia	best
pagalba	aid
darbininkų	workers
ona	ona
duktė	daughter
kiekis	quantity
vidutinis	moderate
žaisti	play
objektų	objects
enciklopedija	encyclopedia
teatre	theatres
teatre	theater
teatre	theatre
simbolis	symbol
patys	themselves
šventės	celebrations
šventės	holidays
metrų	meters
metrų	metres
dalyvis	peer
dalyvis	participant
medinė	wooden
vertė	value
biomedicinos	biomedical
gynybos	defense
gynybos	defence
karui	war
elementų	items
serijos	series
turto	asset
reicho	reich
vincas	vincas
interneto	web
interneto	internet
stoties	station
tauta	nation
tikslas	objective
tikslas	purpose
statusą	status
lietuviai	lithuanians
augalai	crops
studijos	studio
tom	tom
klasė	class
būtent	precisely
būtent	exactly
leonas	leon
gaminti	cook
estijos	estonia
šiauliuose	šiauliai
žodžiai	word
žodžiai	words
mokslas	science
medienos	wood
žaidėjai	players
aukščiausia	best
padeda	helping
pašto	postal
akmenų	stones
akmenų	rocks
japonija	japan
stadionas	stadium
odos	leather
odos	skin
savininkas	owner
žiedai	rings
pasiekti	achieving
genčių	tribal
geležies	iron
vyrai	men
vyrai	male
karaliaučiaus	königsberg
žvaigždės	star
gediminas	gediminas
meto	dash
ginklų	weapon
ginklų	guns
ginklų	arms
bankas	bank
dėmesio	attention
rinkimai	elections
rinkimai	election
latvija	latvia
mokymosi	learning
greitis	velocity
greitis	speed
miškas	woods
miškas	forest
osmanų	ottoman
sezonas	season
biografija	biography
abi	both
abi	abbey
abi	abi
veterinarijos	veterinary
žiemą	winter
tekstilės	textile
tekstilės	textiles
rūdos	ore
rūdos	ores
pasienio	border
kunigaikštystė	duchy
eurovizijos	eurovision
tėvai	fathers
variantas	variant
kandidatas	candidate
viduramžių	medieval
komunistų	communist
žvaigždžių	stars
nuotraukos	photographs
nuotraukos	photo
prisidėjo	complicit
aleksandro	alexander
fondo	fund
paroda	exhibition
mindaugas	mindaugas
foto	photo
mokinių	pupil
mokinių	pupils
ispanija	spain
geriau	better
saulius	saul
futbolas	soccer
futbolas	football
airijos	irish
asociacija	association
korėjos	korean
skulptorius	sculptor
radvila	radziwiłł
nba	nba
video	video
laivyno	fleet
laivyno	naval
peterburgo	petersburg
administracijos	administrations
tiesa	true
tiesa	truth
mokiniai	pupils
pagalbos	aid
menų	arts
vyro	husband
lengvai	easily
lengvai	easy
siena	wall
partizanų	guerrilla
julius	julius
klimatas	climate
gatvė	street
viduje	inside
baleto	ballet
paukščiai	avian
paukščiai	birds
ląstelių	cell
ląstelių	cellular
gatvės	street
gatvės	streets
draudimo	insurance
vienuolynas	monastery
izraelio	israel
irena	irena
irena	irene
generalinis	executive
wikimedia	wikimedia
sostą	throne
james	james
mokesčių	treasure
šveicarijos	swiss
ana	ana
ana	anna
geležinkelis	railroad
geležinkelis	rail
geležinkelis	railway
keliai	roads
spalvų	colours
spalvų	colour
kijevo	kiev
roma	roma
alfonsas	alphonse
pavyko	managed
pavyko	succeeded
galios	power
mintis	idea
aktoriai	actors
pakeisti	modify
būdas	way
upelio	creek
kolonija	kolonia
kolonija	colony
pieno	dairy
nuorodos	links
įpėdinis	successor
teigė	claimed
šakos	branches
ford	ford
ilgai	long
konstantinas	constantine
paulius	paul
atr	atr
laimėtojas	winner
choras	choir
kūrybos	creative
revoliucijos	revolution
revoliucijos	revolutions
ryšius	ties
žiūrovų	viewers
kunigų	leviticus
laikyti	store
kapitonas	captain
kapitonas	master
kapitonas	skipper
eilėraščiai	poems
technologijų	technologies
technologijų	technology
federacija	federation
atitinka	matches
nieko	nothing
disertaciją	thesis
tarnyba	office
ligų	diseases
festivalis	festival
jėga	cool
turkijos	turkey
turkijos	turkish
judėjimas	movement
gyvenviečių	settlements
fizikas	physicist
fondas	fund
gerokai	significantly
įvykiai	events
juosta	strap
vladimiras	wladimir
vladimiras	vladimir
masė	masses
elena	elena
elena	ellen
elena	helen
robertas	roberto
laivas	vessel
kritulių	rainfall
kritulių	precipitation
uosto	harbour
klebonas	parson
turizmo	tourism
turizmo	tourist
rock	rock
artilerijos	artillery
įkūrėjas	founder
saugomų	protected
broliai	brothers
finale	finale
bendra	general
balsų	votes
balsų	voices
tikriausiai	probably
serija	series
vykdyti	execute
vykdyti	run
vykdyti	drive
praktiškai	practically
regionų	regional
kovojo	struggled
val	val
jūroje	offshore
žvaigždė	star
mikalojus	mikołaj
dėmesį	attention
gruzijos	georgian
gruzijos	georgia
milijonų	millions
chorų	choral
gamyklos	factories
šventė	holiday
šventė	feast
šventė	celebration
galia	power
žaidėjų	players
kanadoje	canada
dangaus	heaven
dangaus	sky
greičiausiai	probably
jėgos	powers
sostinės	capitals
vyresnysis	elder
vyresnysis	senior
pranciškus	francis
gintaras	amber
karalienė	queen
istorinis	historic
istorinis	historical
bizantijos	byzantine
dideli	large
dideli	big
agronomas	agronomist
filmai	films
filmai	movies
filmai	movie
anglies	carbon
ministrų	ministers
šiandien	today
klimato	climatic
klimato	climate
praleido	spent
energija	energy
varžybų	competitions
gaminami	manufactured
bokštas	tower
bokštas	rook
gauna	receives
coa	coa
drama	drama
institucija	institution
institucija	authority
stilius	style
įtaka	influence
dukra	daughter
vedęs	married
studija	studio
slėnis	valley
didelių	large
įrengti	mortals
įrengti	mortal
atrodo	looks
gamykla	plant
gamykla	factory
atrado	discovered
dinamo	dinamo
kariai	warriors
kariai	troops
kariai	soldiers
lenktynių	racing
problemų	trouble
augo	relatives
namas	house
įranga	machine
įranga	equipment
menas	arts
šaka	branch
kanalas	canal
mini	mini
laidų	wiring
krymo	crimea
krymo	crimean
dainas	songs
vokiečiai	germans
martynas	marcin
garsus	sounds
valdo	runs
valdo	manages
tamsiai	dark
filmuose	films
ferrari	ferrari
renesanso	renaissance
ligoninės	hospital
ligoninės	hospitals
ankstesnis	previous
norėjo	wished
mokytis	learning
mokytis	learn
mokslininkas	scientist
kompleksas	complex
unikalus	unique
krikščionys	christians
bangos	waves
bangos	wave
jais	them
šokio	dance
įsigijo	acquired
statyba	construction
liuteronų	lutheran
lauke	outdoor
technika	technique
park	park
namus	homes
lėktuvas	aircraft
lėktuvas	plane
lėktuvas	airplane
lėktuvas	aeroplane
užsiėmimas	occupation
vienuolyno	monastery
ukrainoje	ukraine
ramiojo	pacific
live	live
york	york
vedėja	presenter
karinė	military
raudona	red
reformos	reform
turnyro	tournament
sodyba	mansion
rašyti	write
medžiai	trees
škotijos	scottish
kerta	crosses
veiksmas	action
religijos	religions
gylis	depth
tyrimus	inquiries
tyrimus	investigations
arvydas	arvydas
kolegijos	college
airių	irish
įlanka	bay
verslininkas	businessman
verslininkas	trader
verslininkas	entrepreneur
riba	threshold
festivalio	festival
anglija	england
meilės	love
pusiasalio	peninsula
fide	fide
ryšiai	telecommunications
elementai	elements
jungtinė	united
spėjama	guessing
spėjama	supposedly
baseinas	basin
adolfas	adolf
tilto	bridge
išrinkta	elected
pora	pair
pora	couple
regina	regina
egzistavo	existed
wien	wien
dalia	dalia
žydai	jews
darius	darius
musulmonų	muslim
demokratinės	democratic
miestus	towns
artūras	arthur
kova	struggle
gautas	received
kūryba	creation
skulptūra	sculpture
žodynas	glossary
žodynas	dictionary
žodynas	vocabulary
biuro	office
augimo	growth
monetos	coins
monetos	coin
skol	skol
liekanos	residue
liekanos	residues
savybės	features
įvykių	events
smegenų	brain
žvejyba	fishing
boleslovas	bolesław
tikras	real
tikras	sure
pasirodo	memories
statistikos	statistical
zona	zone
būrys	squad
būrys	platoon
vietovės	terrain
vietovės	locations
atitinkamai	respectively
kūrėjų	creators
ima	ima
atminimo	commemorative
atminimo	memorial
ričardas	richard
muziejų	museum
don	don
klubai	clubs
klubai	hips
advokatas	attorney
advokatas	lawyer
ežerai	lakes
masės	masses
sąvoka	notion
gyvūnai	animals
gyvūnai	livestock
gyvūnai	animal
mažoji	lesser
ukraina	ukraine
ukraina	ukrainian
matematikas	mathematician
archeologas	archaeologist
kursus	courses
turkų	turkish
viršuje	upstairs
sesuo	sister
instrumentai	instruments
karjeros	career
karjeros	careers
supa	supa
karjera	career
karjera	careers
kalvos	hill
taškai	dots
galbūt	perhaps
galbūt	maybe
pobūdžio	nature
ekonomika	economics
ekonomika	economy
vartai	gates
vartai	gateway
vartai	gate
primena	memories
primena	recalls
kraštovaizdžio	landscape
vaisiai	fruits
vaisiai	fruit
gynyba	defense
gynyba	defence
baigiasi	ends
stalo	desk
kojos	legs
kojos	leg
mėgėjų	amateur
registro	registry
monetų	coin
klubų	hips
priežiūros	supervision
užimti	occupy
vadina	call
žuvis	fish
muzikantas	musician
argentinoje	argentina
paviršių	surfaces
dvd	dvd
dvd	dvds
ugnies	fire
laikinai	temporary
versijos	versions
ali	ali
tinka	fit
tinka	suits
tėvų	parental
įrangos	equipment
lapų	leaf
albumai	albums
argentina	argentina
kristina	christina
kristina	kristina
kristina	christine
kristina	kris
įstaiga	organization
įstaiga	institution
žydi	bloom
skulptūros	sculptures
vaikas	kid
vaikas	child
bibliotekos	libraries
bibliotekos	library
indų	dish
vaidmenys	roles
apsauga	protection
michailas	mikhail
prekės	bag
prekės	goods
juostos	straps
juostos	tape
minimi	schizophrenia
parduota	sold
fotografijos	photographs
fotografijos	photography
fotografijos	photographic
smėlio	sand
smėlio	sandy
islamo	islamic
parodos	exhibition
parodos	exhibitions
kaulų	bone
būgnai	drums
mokslininkai	researchers
mokslininkai	scientists
čilės	chilean
krokuvos	kraków
turizmas	tourism
caro	caro
gamina	manufactures
svoris	weight
šilumos	heat
ligoninė	hospital
vaisių	fruity
vaisių	fruits
demokratijos	democracy
architektūra	architecture
lankėsi	visited
vietovė	locality
rokas	rock
santuokos	marriage
drauge	comrade
drauge	friend
sibiro	siberian
karlas	karl
kelionės	travel
kelionės	travelling
tvirtovė	fortress
sosto	throne
mokslininkų	researchers
patarėjas	adviser
specialiai	specially
automobiliai	automotive
siekiama	aim
ženklai	marks
komedija	comedy
vadovai	managers
simonas	simon
išsilavinimas	education
filosofija	philosophy
laisvai	freely
laisvai	casual
laisvai	dismissed
senas	old
socialistų	socialist
sekmadienį	sunday
demokratai	democrats
alaus	beer
alaus	beers
aptarimas	discussion
mėnulio	lunar
kristupas	krzysztof
enciklopedinis	encyclopedic
arena	arena
istorinė	historic
istorinė	historical
idėja	idea
vykdė	served
armėnijos	armenia
skydo	shield
pulko	flock
šeimų	families
elementas	element
požymiai	attributes
litų	litas
žaidimai	gaming
žaidimai	games
trumpai	briefly
trumpai	short
valign	valign
pasiekia	reaches
paveldas	heritage
jėzuitų	jesuit
dainavo	sang
minsko	minsk
kanada	canada
archyvas	archives
baroko	baroque
konservatorijos	conservatory
įstaigų	bodies
fotografas	photographer
sėkmės	success
nori	wanting
nori	want
konstitucija	constitution
jaunųjų	explored
išsiskyrė	divorced
civilinės	civil
studijoje	studio
totorių	tatar
frankų	francs
frankų	franc
fifa	fifa
aktyvus	active
tel	tel
keliavo	travelled
keliavo	traveling
stačiakampio	rectangular
šveicarija	swiss
galimybė	chance
serbų	serbian
tikrai	truly
tikrai	surely
tikrai	really
sportininkas	athlete
išvengti	avoid
joseph	joseph
sinagoga	synagogue
reikėjo	needed
auksinis	golden
auksinis	gold
niekas	nobody
vladislovas	władysław
sodas	garden
vykdo	drives
mechanikas	mechanic
kaina	price
kritikas	critic
stiklo	glass
veikėjai	actors
opera	opera
akis	eyes
akis	eye
darbuotojai	workers
bažnyčių	churches
vartininkas	goalkeeper
tiksliai	exactly
kolumbijos	columbia
modeliai	models
eugenijus	eugene
australija	australia
leidybos	publishing
use	tse
mėgsta	likes
mėgsta	loves
makedonijos	macedonian
tradicijos	tradition
tradicijos	traditions
kolonijos	colonies
santykis	ratio
nacių	nazi
galimybės	opportunities
baseino	pool
sukilėlių	rebel
ilgas	long
bendradarbiavimo	cooperation
demokratinė	democratic
cukraus	sugar
akių	eye
akių	wind
ivanas	ivan
deivė	goddess
sūnūs	sons
jugoslavijos	yugoslavia
jugoslavijos	yugoslav
trasa	circuit
vartų	gate
puikiai	great
puikiai	good
puikiai	excellent
skaityti	scan
aukštumos	highlands
idėjos	ideas
augusto	augusto
grįžti	return
konferencijos	conferences
kompozitorių	composers
mirtis	death
turistų	tourists
ranka	handwritten
ranka	hand
metodas	method
geografija	geography
ibn	ibn
žurnalistų	reporters
justinas	justin
nuotrauka	photograph
nuotrauka	photo
čikagos	chicago
gyvybės	life
metro	metro
viskas	everything
patelės	females
patelės	female
rūta	ruta
rūta	ruth
storio	thickness
tskp	cpsu
sirijos	syrian
išteklių	resources
smolensko	smolensk
vartotojų	consumer
dviračių	bicycle
salė	hall
prefektūra	prefecture
džiazo	jazz
konkursas	tender
konkursas	giveaway
tonų	tonnes
punktas	clause
inžinerijos	engineering
laukas	field
ratas	wheel
civilizacijos	civilisation
civilizacijos	civilizations
bangų	weaving
bangų	wave
savybes	qualities
youtube	youtube
himnas	anthem
populiacijos	populations
sportas	sport
panašios	analogue
transportas	transport
įtraukti	bring
keliautojas	traveller
žymi	famous
žalia	crude
žalia	green
amerika	america
atėjo	came
altlink	altlink
pakviestas	invited
gal	maybe
šiuolaikinio	contemporary
indija	india
atkurta	restored
andų	andean
atskirai	individually
romas	rum
skirtumas	difference
skirtumas	differential
viską	everything
sukilimas	uprising
priešingai	contrary
genitive	genitive
ginklai	weapons
ginklai	weapon
ginklai	guns
ginklai	arms
kaukazo	caucasus
kaukazo	caucasian
asmeninis	personal
faktiškai	withdrawal
milano	milan
botanikos	botanical
matavimo	measuring
matavimo	measurement
seka	sequence
teamb	teamb
dvasios	spirit
konstrukcijos	structures
pavasario	spring
tibeto	tibet
mergina	girlfriend
mergina	girl
egipte	egypt
dujos	gas
dujos	gases
kultūrų	intercultural
kultūrų	cultures
organizuoti	organize
organizuoja	organizes
raumenų	muscle
maroko	moroccan
debiutas	debut
kalifornijos	california
ralio	rally
mūro	masonry
gif	gif
jaunesnysis	junior
nuteistas	convicted
rebounds	rebounds
išsaugoti	preserve
išsaugoti	save
maltos	maltese
aplinka	ambient
kovoti	fighting
banga	wave
atkūrimo	restoration
rasa	dew
rasa	rasa
statybų	built
ginklas	weapons
ginklas	weapon
ginklas	gun
janina	janina
grafikos	graphic
policija	cops
policija	police
malūnas	windmill
tradicijas	traditions
mama	mama
mama	mum
mama	mom
mama	mother
tikėjimo	belief
asmenybės	personalities
asmenybės	personality
ansamblis	ensemble
aidas	echo
krūtinės	chest
organizatorius	organizer
organizatorius	organisers
organizatorius	organiser
monografija	monograph
danija	denmark
konfederacijos	confederation
didikų	nobles
kilę	tribes
apsaugoti	protect
tikra	true
tikra	genuine
lee	lee
graikija	greece
trumpas	short
trumpas	brief
draugas	comrade
draugas	friend
juoda	black
joms	them
vietovėje	locality
ištremtas	banished
soccerway	soccerway
ciklas	cycle
romano	romano
profesionalus	professional
aušros	dawn
karaliai	kings
alma	alma
suaugusiųjų	adult
maro	maro
skyriai	divisions
medaliu	medal
teismų	judicial
paveldėjo	inherited
sapiega	sapieha
adresas	address
glasgow	glasgow
padėjėjas	assistant
padėjėjas	helper
pulkas	flock
pulkas	regiment
senato	senate
rolandas	roland
benediktas	benedict
kuro	fuels
mečetė	mosque
valiuta	currency
žalgiris	žalgiris
linas	linas
nužudyti	kill
slovakijos	slovakia
slovakijos	slovak
skatina	encourages
nužudytas	murdered
pilnai	fully
sniego	snow
vėžio	cancers
vėžio	cancer
lenkai	poles
religinių	religious
aušra	dawn
reino	rhine
pianistas	pianist
autobusų	bus
autobusų	arrivals
albanijos	albanian
pilnas	full
geležinkelių	rail
nilo	nile
britai	british
kolegija	college
karai	wars
estija	estonia
kovų	fights
tvora	fence
šeštadienį	saturday
pasiekimai	achievements
daniel	daniel
apskritys	counties
kun	kun
lėktuvai	aeroplanes
poilsio	resting
poilsio	rest
užkariavo	conquered
disko	disc
raketų	rocket
raketų	missile
dalelių	particle
įmanoma	possible
atmosferos	atmospheric
universitetų	universities
asistentas	assistant
krantas	shore
viktorija	viktorija
viktorija	victoria
josé	jose
turkija	turkey
turkija	turkish
eros	eros
feliksas	felix
dizaino	designs
dizaino	design
doc	doc
penktadienį	friday
pareigūnai	officials
smulkių	petty
gubernatorius	governor
bosnijos	bosnian
karl	karl
leonardas	leonard
louis	louis
aiškiai	expressly
rytas	morning
etninės	ethnic
gan	pretty
gamta	nature
nuotraukų	photographs
technologija	technology
skaičiavimo	counting
napoleonas	napoleon
kapas	tomb
praha	prague
plaučių	lung
haris	harris
haris	harry
ang	ang
kapitalo	capital
metodai	methods
baltymų	protein
baltymų	proteins
durų	door
durų	doors
siaubo	horror
aukų	victims
ferdinandas	ferdinand
motiejus	maciej
kim	kim
nkvd	nkvd
žvalgybos	reconnaissance
žvalgybos	exploration
šaudymo	shooting
meilė	love
leidžiama	permitted
leidžiama	allowed
valdoma	managed
borisas	boris
mtv	miu
mtv	mtv
atskiros	discrete
nesėkmingai	unsuccessfully
takas	tak
neįmanoma	impossible
lapuočių	deciduous
teodoras	theodore
kareiviai	soldiers
kilometrų	kilometers
baltieji	whites
vartus	gates
mediena	wood
mediena	timber
skonio	flavour
armėnų	armenian
tradicija	tradition
sėklos	seed
sėklos	seeds
oras	weather
oras	air
poveikio	impact
misijos	missions
natūraliai	inherently
natūraliai	naturally
alfredas	alfred
trenerio	coach
įrašas	recording
sedlcų	siedlce
įstatymai	legislation
įstatymai	laws
keltų	ferry
atlikėjai	performers
atlikėjai	artists
slidinėjimo	ski
pripažinti	recognise
geras	good
ambasadorius	ambassador
žurnalistikos	journalism
oda	leather
oda	skin
super	super
tikros	genuine
islandijos	island
kryžių	clover
spygliuočių	coniferous
audinių	tissues
audinių	mink
legendos	legends
juodas	black
andrea	andrea
plytų	bricks
plytų	brick
mašinos	machinery
mašinos	machines
laidojimo	burial
truko	lasted
truko	searched
filmus	movies
ukrainiečių	ukrainians
ukrainiečių	ukrainian
kovas	struggles
vitebsko	vitebsk
žinduolių	mammalian
šarūnas	šarūnas
musulmonai	muslims
brolių	brothers
uždaryta	closed
verlag	verlag
ketvirtadienį	thursday
rektorius	rector
fabrikas	factory
finalo	finals
televizija	television
lygį	brett
korėja	korea
leono	leon
vertimas	translation
raimondas	raymond
variantai	variants
variantai	variant
ūkininkas	farmer
pirmadienį	monday
atkurti	recreate
atkurti	restoring
arti	near
žodžiu	oral
bavarijos	bavarian
laimėti	winning
džeimsas	james
aikštės	squares
greičio	speed
lyg	like
antradienį	tuesday
rankos	arms
rankos	arm
auksas	gold
gėrimas	drink
gėrimas	beverage
žiedų	floral
filialas	branch
žuvys	fishes
žuvys	fish
tilžės	tilsit
prizas	prize
portugalija	europol
ritulio	hockey
ekspedicija	expedition
susirinkimas	assembly
stade	stade
veislės	breed
veislės	varieties
veislės	breeds
mazgas	assembly
mazgas	knot
kritikos	criticism
įgulos	crew
chemikas	chemist
maldos	prayer
maldos	worship
maldos	prayers
ryto	morning
griuvėsiai	ruins
riebalų	fats
riebalų	fatty
riebalų	fat
kubos	santiago
kubos	cuban
vaidmenis	roles
gintaro	amber
medžioklės	hunting
rita	rita
aliejus	oil
aliejus	oils
molio	molar
molio	clay
analizė	analysis
anime	anime
kvalifikacijos	qualification
amatų	craft
euro	euro
sparnai	wings
groti	play
germanų	germanic
den	den
idėjų	ideas
užduotis	assignment
užduotis	task
hugo	hugo
dykumos	desert
pelno	profit
gamykloje	factory
bbc	bbc
lewis	lewis
fernando	fernando
bakalauro	bachelor
žolės	grass
žolės	weed
remix	remix
būdais	ways
billboard	billboard
surinkti	assemble
surinkti	assembled
surinkti	collected
dokumentus	documentation
maistas	food
sportininkai	athletes
žiedas	ring
marso	martian
garsas	sound
lina	lina
mario	mario
užpuolė	assaulted
užpuolė	attacked
druskos	salt
druskos	hydrochloric
druskos	salts
visuomenė	society
paveikslai	paintings
kelionė	voyage
kelionė	travel
kelionė	journey
kelionė	trip
tekstai	texts
tekstai	lyrics
premjera	premiere
dėstytoja	lecturer
scorea	scorea
sveria	weighs
arklių	horses
organai	bodies
mokymas	teaching
mokymas	training
mokymas	instruction
izraelis	israel
rūgštis	acid
frank	frank
akys	eyes
galerijoje	gallery
ieva	eve
ieva	eva
nuotykių	adventure
nuotykių	adventures
koncertas	concert
dokumentai	documentation
bendrovių	companies
aut	aut
formulė	formula
kgb	kgb
krovinių	freight
sutampa	overlap
slovėnijos	slovene
slovėnijos	slovenian
laboratorijos	laboratory
laboratorijos	laboratories
vienetai	units
moneta	coin
pajamos	revenue
sibirą	siberia
praeina	passes
dantų	dental
dantų	tooth
laivynas	fleet
ginklus	guns
tankis	density
krioklys	waterfall
chevrolet	chevrolet
sparta	sparta
deja	sadly
deja	unfortunately
rovers	rovers
laura	laura
augti	grow
kūrėjai	developers
kūrėjai	creators
elektronikos	electronics
stebėti	observe
graikai	greeks
patalpose	premises
sukuria	generates
vabzdžių	insects
vabzdžių	insect
turtas	property
turtas	asset
turtas	assets
įveikti	overcoming
bėgimo	jogging
vida	vida
vatikano	vatican
juventus	juventus
akmenys	stones
akmenys	rocks
operacija	operation
dnr	dna
karta	generation
kalifornijoje	california
afrika	african
griežtai	strictly
bene	bene
mercedes	mercedes
gydymas	therapy
gydymas	treatment
auginamos	grown
auginamos	cultivated
roberto	roberto
lygumų	plains
modelių	models
rinkti	gathering
kantonas	canton
ekonomiką	healthy
giovanni	giovanni
spindulių	infrared
lanko	bow
ginti	defend
ginti	defending
hans	hans
žvejybos	fishing
korpusas	wing
korpusas	corps
palaidoti	bury
britannica	britannica
dizainas	design
kalbėjo	spoken
kalbėjo	talked
kalbėjo	spoke
alkoholio	alcohol
vilkas	wolf
konferencija	conference
konferencija	conferences
saugos	safety
mitologija	mythology
dunojaus	danube
kavos	coffee
rengimo	compilation
stiprus	strong
kelionių	tour
migracijos	migratory
migracijos	migration
drabužių	clothing
aplinkinių	surrounding
kuršo	courland
pakvietė	invited
cher	cher
katalikai	catholics
velso	welsh
pabėgėlių	refugee
geltona	yellow
milijonus	millions
patinai	males
star	star
anna	anna
hapoel	hapoel
dykuma	desert
vėjas	wind
dvasia	spirit
kalcio	calcium
dievai	gods
serbija	serbia
vaizdai	videos
revoliucija	revolution
esė	essays
programavimo	programming
kurtis	curt
kurtis	curtis
klasifikacija	classification
maccabi	maccabi
renault	renault
kostas	kostas
biuras	office
vasara	summer
taika	peace
junginiai	preparation
junginiai	compounds
ore	airborne
kainos	price
joe	ola
mig	mig
narės	states
ministrai	ministers
balkanų	balkan
balkanų	balkans
hetitų	hittite
etikos	ethical
etikos	ethics
kancleris	chancellor
kancleris	registrar
tikėjimą	faith
vaikystės	childhood
malajų	malay
turkijoje	turkish
tūkstančiai	thousands
diana	diana
diana	diane
uolų	cliffs
klasėje	classroom
rato	wheel
gyvenamųjų	residential
trumpa	short
šri	sri
žalios	crude
parduotuvės	shops
parduotuvės	stores
vardai	names
wanderers	wanderers
pramogų	amusement
pramogų	entertainment
mušamieji	percussion
danijoje	denmark
nedideli	minor
nedideli	slight
čempionai	champions
auto	auto
klemensas	klemens
konfliktas	mile
konfliktas	conflict
copa	copa
geriausi	best
administratorius	admin
administratorius	administrator
reikalavo	insisted
reikalavo	demanded
tradicijų	tradition
tradicijų	traditions
globos	custody
globos	schedule
grūdų	grain
grūdų	cereals
grūdų	cereal
kalio	potassium
chrysler	chrysler
mix	mix
lervos	larvae
stengiasi	tries
stengiasi	endeavour
juodkalnijos	montenegro
juodkalnijos	montenegrin
spartak	spartak
tradicinė	traditional
vienuolis	monk
irako	iraqi
specialistų	specialist
boeing	boeing
stovyklos	camp
stovyklos	camping
stovyklos	camps
aptikta	discovered
aptikta	detectable
glaudžiai	close
lrt	lrt
pinigai	cash
įrašai	posts
įrašai	entries
žlugimo	apocalypse
veislė	breed
veislė	varieties
veislė	variety
sutinka	agrees
rinkėjų	electorate
naktis	dwarves
istoriniai	historical
šaknis	roots
galutinė	final
matas	bear
sąjungininkų	allies
julija	julia
bulgarija	bulgaria
stotys	stations
draudimas	insurance
draudimas	prohibition
kalifornija	california
aleksandra	alexandra
alexander	alexander
profesinės	professional
bazilika	basilica
tikslų	goals
remonto	repair
panaikinti	abolish
salėje	hall
ąžuolo	oak
jomis	them
dalelės	particles
dalelės	particle
šventėje	marquee
kapo	grave
mediniai	wooden
šlovės	glory
lenktynes	races
gelsvai	yellowish
konsultantas	consultant
skydas	shield
tradicinės	traditional
milijonai	millions
jonava	village
luis	lois
žmonijos	human
gydytojo	physician
gydytojo	doctor
dan	dan
realybės	reality
skrydžio	flight
išradėjas	inventor
kelia	posing
tikėjimas	belief
indo	indo
arkivyskupas	archbishop
globėjas	guardian
globėjas	carer
vadai	commanders
svarbą	importance
volgos	volga
alžyro	algerian
šuo	dog
venesuelos	venezuelan
veido	facial
patalpos	premises
atvyksta	arrives
atvyksta	arrive
egiptas	egypt
egiptas	egyptian
bull	bull
atolas	atoll
ryžių	rice
jones	jones
agentūra	agency
išrinkti	elected
keramika	ceramic
keramika	ceramics
analizės	analytical
sicilijos	sicily
patelė	female
bataliono	battalion
renginiai	events
atnaujinta	upgrade
dukrą	daughter
žemi	bass
aptikti	finn
susivienijimo	unification
altorius	altarpiece
civilizacija	civilization
civilizacija	civilisation
kaklo	neck
paskirtis	purpose
pirmininkai	chairpersons
įtampos	voltage
tiesiai	straight
airija	ireland
biblijos	bible
dideles	huge
apžvalga	overview
pilvo	belly
pilvo	abdomen
vyru	husband
vyru	man
padovanojo	adore
uostai	ports
liepojos	liepāja
kvapo	odour
kazachstano	kazakhstan
gavyba	extraction
lukas	luke
lukas	lukas
chirurgas	surgeon
švyturys	lighthouse
švyturys	beacon
alfa	alfa
kava	coffee
interesus	interests
topo	topo
stogo	roof
sąsiauris	strait
agentas	agent
sustabdyti	stop
kaita	cocktails
kraujas	blood
danga	blanket
danga	coating
danga	rug
merginos	girls
pozicijas	positions
šaknys	roots
encyclopaedia	encyclopædia
facebook	facebook
force	force
raketos	missiles
raketos	rocket
iaaf	iaaf
santuoka	marriage
estadio	estadio
plaukimo	swimming
draudžiama	forbidden
draudžiama	prohibited
urugvajaus	uruguay
azija	asia
žarnos	hoses
žarnos	hose
folkloro	folklore
francisco	francisco
kalvų	hills
atstatyti	restore
zita	zita
škotų	scots
radijas	radio
burnos	mouth
valda	holding
mišinys	mixture
visur	everywhere
simboliai	symbols
oskaras	oscar
kalibro	calibre
parkai	parks
vandenys	waters
ūkių	holdings
vystosi	evolving
vertinamas	appreciated
įvertinti	ranger
starto	starter
skandinavų	norse
deividas	david
athina	athina
geriausios	best
spears	spears
erelis	eagle
architektų	architects
mokslai	sciences
tikslai	objectives
tikslai	goals
metalas	metallic
florencijos	florence
florencijos	firenze
mokinys	pupil
mokinys	apprentice
libano	lebanese
išsiveržimas	eruption
duris	doors
ilga	long
pilka	grey
bolševikų	bolshevik
tavo	your
tavo	yours
nuoroda	indication
walter	walter
diskas	disc
sudegino	burned
perversmo	coup
skrandžio	gastric
bausmė	penalty
bausmė	punishment
atkurtas	restored
laukai	fields
vandenyse	waters
ugnikalnio	volcano
proto	crazy
ūkiai	holdings
ūkiai	farms
della	della
athletic	athletic
apaštalo	apostle
ugnis	fire
pergalių	victories
kampas	angle
dmitrijus	dmitry
atrodė	looked
atliktas	completed
amsterdamo	amsterdam
stebėjimo	observation
taikymo	applicability
rankomis	manually
krizė	crisis
arbata	tea
jūsų	your
statiniai	constructions
libijos	libyan
bulgarų	bulgarian
katės	cats
katės	cat
išmoko	learned
orkestras	orchestra
alus	beer
alus	beers
grandinės	chain
violeta	violet
kolonijų	colonies
galvijų	bovine
galvijų	cattle
platintojas	distributor
draugai	comrades
draugai	friends
lentos	boards
mickevičiaus	mickiewicz
nosies	nasal
meistrų	assassins
jurijus	yuri
indonezijos	indonesia
matyt	apparently
kongresas	congress
daržovių	vegetables
reklamos	advertising
uodegos	tails
muchafaza	governorate
sužeistas	wounded
azoto	nitric
pijus	pius
friedrich	friedrich
būgnininkas	drummer
gera	good
atp	atp
kalbėti	talk
kalbėti	speak
priklausomybė	dependency
priklausomybė	addiction
parduotuvė	shop
parduotuvė	store
keliauja	traveling
sena	senna
rinka	market
gaminamos	designed
valdos	holdings
medvilnės	cotton
ispanai	spaniards
bendradarbiauja	cooperates
bendradarbiauja	cooperate
atskirta	separated
atskirta	decoupling
tikimybė	likelihood
monika	monika
monika	monica
stambūs	chunky
krizės	crisis
psichikos	mental
garo	steam
kardo	sword
duonos	bread
palydovas	moon
pievos	grassland
pievos	meadows
atnaujinti	refresh
sako	saying
sako	says
regbio	rugby
baigti	finish
kailis	fur
dokumentas	document
skatinti	promote
kraujagyslių	vascular
giliai	deeply
giliai	deep
vidutinės	medium
manga	manga
organizmų	organisms
ryžiai	rice
krasnojarsko	krasnoyarsk
katalogas	catalogue
seserys	sisters
kontrolė	control
piotras	pyotr
labdaros	charitable
labdaros	charity
gėlių	flower
karys	warrior
karys	soldier
užimta	occupied
bokštai	towers
tradiciniai	traditional
monetas	monet
miškais	forests
cirko	circus
bon	bon
poteris	potter
duetas	duet
krikščionybė	christianity
diego	diego
skandinavijos	scandinavia
skandinavijos	scandinavian
šilko	silk
saksonijos	saxony
seminarija	seminary
cska	cska
tinklų	networking
tinklų	networks
comune	comune
sumažėja	decreases
kelius	paths
veislių	varieties
veislių	breeds
tinkamai	properly
dirvožemio	soil
geologas	geologist
žali	crude
jogailos	jagiellonian
taivano	taiwan
taivano	taiwanese
berlynas	berlin
lelijos	lilies
staiga	suddenly
staiga	sudden
ąžuolų	oak
nugalėtojai	winners
sąvokos	concepts
sultonas	sultan
prisijungti	join
esančius	archived
auginti	cultivation
bandymai	tests
bandymai	testing
ekspertas	expert
aukos	victims
sodai	gardens
dodge	dodge
skautų	scout
gamintojas	producer
gamintojas	manufacturer
slovakija	slovakia
augalija	vegetation
sveikata	health
jpeg	jpeg
faktai	facts
emilija	emilia
paprašė	asked
rinkiniai	kits
gruzija	georgia
draugų	friends
įgula	crew
miršta	dies
miršta	dying
junginys	compound
olga	olga
vaza	vase
lff	lff
augimas	growth
tokijo	tokyo
tony	tony
lakūnas	aviator
dėsnis	morality
šokis	dancing
arbatos	tea
fizika	physics
talino	tallinn
metalurgijos	metallurgy
metalurgijos	metallurgical
statula	statue
vanda	wanda
gaisro	fire
vykdymo	driving
draugystės	friendship
pėsčiųjų	pedestrians
grammy	grammy
naugardo	novgorod
dominikos	dominican
bin	bin
kampanijos	campaign
šokėja	dancer
gelbėjimo	salvage
gelbėjimo	rescue
gvinėja	guinea
miuncheno	munich
solistas	soloist
prūsija	prussia
albanų	albanian
įtampa	excitement
įtampa	tension
įtampa	voltage
tęsti	continue
fotografija	photography
pažinimo	cognitive
išlaidos	costs
partizanas	partisan
bosas	boss
nuomonės	opinions
ray	ray
afganistano	afghan
gavybos	warned
nusipirko	bought
fragmentai	fragments
prokuroras	prosecutor
muitinės	customs
stovykla	camp
išorės	exterior
komandas	teams
pistoletas	pistol
pistoletas	gun
cheminė	chemical
ceremonija	ceremony
jungtis	connectivity
anatolijus	anatoly
mokslą	tuition
geografas	geographer
pilietinis	civic
torino	torino
įrenginiai	devices
įrenginiai	installations
kryžiuočiai	crusaders
prahos	prague
konfederacija	confederation
tankus	dense
tankus	tanks
bob	bob
andrejus	andrei
playstation	playstation
mit	mit
patvirtinti	approve
jonušas	janusz
gėrimų	beverage
gėrimų	beverages
teniso	tennis
bruno	bruno
dave	dave
pučiamųjų	brass
accusative	accusative
reikalavimai	requirement
reikalavimai	requirements
pagaliau	finally
slovėnų	slovene
slovėnų	slovenian
gyvas	alive
įrenginys	device
įrenginys	installation
astronomijos	astronomy
galaktikos	galactic
kritikai	critics
karolina	caroline
karolina	carolyn
karolina	karolina
karolina	carolina
varikliai	engines
dainuoti	sing
silezijos	silesia
smuikininkas	violinist
panaikinimo	cancellation
dalykas	thing
airlines	airlines
ruduo	autumn
inga	inga
svarų	quid
civilinis	civilian
uolos	rocks
uolos	cliff
akies	eye
gitaros	guitars
trūkumas	shortage
info	info
lvovo	lviv
britney	britney
širdis	heart
kompiuteris	computer
stipri	strong
genčiai	tribe
tako	taco
pažiūrų	persuasion
pažiūrų	conviction
pasiuntinys	envoy
mediawiki	mediawiki
heraldikos	heraldic
sukilo	rebelled
vabalai	bugs
aprašo	inventory
trojos	trojan
trojos	troy
aukštuma	upland
toyota	toyota
stiebo	mast
inkų	incan
bronza	bronze
bandymas	test
serie	serie
islamas	islam
daržovės	vegetables
altajaus	altai
liaukos	glands
caras	tsar
bausmės	penalties
įgaliojimai	mandate
savininkai	owners
savininkai	holders
aliuminio	aluminium
daiktai	things
grybas	fungus
simptomai	symptoms
ratai	wheels
olympique	olympique
chelsea	chelsea
raketa	rocket
raketa	missile
pušų	pine
ivano	ivano
religijų	religions
felipe	felipe
rekordas	record
giesmių	hymns
krūmų	bushes
atsitiktinai	random
actekų	aztec
johann	johann
piramidės	pyramid
universitetai	universities
koncertai	concerts
wikis	wikis
jeruzalės	jerusalem
respublikonų	republican
vandenynas	ocean
jackson	jackson
tvarkymo	handling
klasicizmo	neoclassical
princesė	princess
telšiai	alva
aparatas	apparatus
farmacijos	pharmaceutical
arabai	arabs
cia	here
manau	think
protėviai	ancestors
hamilton	hamilton
kriterijus	criteria
skamba	sounds
giorgio	giorgio
parduotas	sold
parduotas	sales
protestantų	protestant
susitarimas	arrangement
siuvimo	sewing
erewan	yerevan
ekranas	screen
sunkumų	difficulty
sunkumų	difficulties
administracinės	administrative
joana	joana
prizą	prize
kritika	criticism
kritika	criticisms
vietinis	localised
elektrotechnikos	electrotechnical
malaizijos	malaysian
plati	broad
duona	bread
gyvūnas	animal
sielos	soul
sielos	souls
auginimas	cultivation
arsenal	arsenal
tiki	believes
leonidas	leonid
kunigai	priests
lengva	easy
bakterijų	bacterial
bakterijų	bacteria
verslas	cpv
verslas	business
raumenys	muscles
raumenys	muscle
puolimą	assault
filipas	phillip
pamario	pomeranian
konservatorių	conservative
adrijos	adriatic
pilys	castles
pasitraukti	withdraw
ekonomiškai	economically
konfliktų	conflicts
sėkmė	success
atogrąžų	tropical
atsisakyta	surrendered
vesti	marry
lėlių	puppet
dizaineris	designer
mineralinių	mineral
ankstesnių	previous
gyvatės	snake
gyvatės	serpent
gyvatės	snakes
dukros	daughters
prisikėlimo	resurrection
jupiterio	jupiter
žalos	injury
žalos	damage
dalyvavimą	attendance
dalykai	things
grėsmę	threatening
bakterijos	bacteria
švietimas	education
kursuose	courses
kolekcijos	collections
rublių	rubles
priežiūra	oversight
priežiūra	supervision
budistų	buddhist
laimėtojai	winners
liūtas	lion
motyvai	motives
dėdė	uncle
queen	queen
balsai	votes
storis	thickness
grybai	mushrooms
grybai	fungi
grybai	mushroom
lokomotiv	lokomotiv
rausvai	reddish
francesco	francesco
įrodyti	prove
druska	salt
naudos	benefit
antonijus	antony
išgyveno	survived
velnio	devil
atominės	atomic
sprendimai	solutions
sprendimai	judgments
santo	santo
jogaila	jogaila
atnešė	brought
stogas	roof
būsena	status
trūksta	missing
punk	punk
šimtai	hundred
šimtai	hundreds
kažkas	someone
kažkas	somebody
beograd	beograd
fasadas	facade
cheminis	chemical
grandinė	circuit
grandinė	chain
astronomas	astronomer
variantų	hits
variantų	variants
javų	leftovers
buick	buick
čempione	champ
retkarčiais	occasionally
gamintojai	producers
gamintojai	manufacturers
trikampio	triangle
bitų	bit
bitų	bits
licencija	licence
totoriai	tatars
telefono	phone
pasiekimus	achievements
lauką	slot
psichologas	psychologist
didžiulis	huge
didžiulis	massive
tinklai	nets
tinklai	networks
pavasaris	spring
tekstus	lyrics
slėgio	pressure
bendradarbiavimas	cooperation
teisinių	legal
cezario	caesar
vykdomas	treats
šaknų	roots
potvynių	tidal
vaistinė	pharmacy
bayern	bayern
dingo	gone
dingo	disappeared
kukurūzai	maize
platus	wide
platus	broad
salynas	archipelago
galimai	possibly
cžv	cia
cžv	cla
pasaka	tale
būsenos	status
skrydis	flight
kovoja	struggling
arkliai	horses
arkliai	horse
arkliai	equine
specialistai	specialists
balandis	april
toro	toro
lygiagrečiai	parallel
kraštovaizdis	landscapes
kraštovaizdis	landscape
stara	stara
supranta	understands
harry	harry
šlapimo	urine
fia	fia
han	han
nugalėti	beat
nugalėti	defeat
mokestis	fee
mokestis	tax
mokestis	fees
pasibaigė	ended
toronto	toronto
lėktuvą	airplane
juodi	black
vandenynų	oceans
metė	threw
kelly	kelly
leopoldas	leopold
tuniso	tunisia
tuniso	tunisian
galvijai	bovine
galvijai	cattle
mažumų	minorities
cfg	cfg
techninių	technical
litrų	gallons
advokato	lawyer
kokie	what
kipras	cyprus
aprangos	clothing
aprangos	dress
biografijos	backgrounds
elektronų	electron
gvaranių	guarani
išspręsti	resolving
išspręsti	resolve
išspręsti	solve
tiltai	axles
tiltai	bridges
cadillac	cadillac
užrašas	inscription
asmenybė	personality
teismai	judiciary
teismai	courts
slėgis	pressure
slėgis	pressures
vitalijus	vitaly
beta	beta
gimdos	uterus
gimdos	uterine
žievė	bark
sportininkė	sportsman
lightgrey	lightgrey
švento	sacred
šautuvas	shotgun
šautuvas	rifle
atnaujintas	updated
urano	uranium
registras	registries
registras	registry
pardavimai	sales
talpa	capacity
žemėlapiai	maps
žemėlapiai	charts
geležinkeliai	rail
geležinkeliai	railways
gaisras	fire
gėrimai	beverages
gėrimai	drinks
plunksnos	feathers
kačių	cats
branduolys	kernel
branduolys	core
istorikai	historians
šventę	celebration
spausdinti	print
bilbao	bilbao
eduardo	eduardo
laurynas	laurynas
neva	neva
terasa	terrace
françois	françois
jonų	ion
senelis	grandfather
kursai	courses
tėvynę	homeland
ist	ist
formuoti	moulded
avarijos	accident
arklio	horse
archeologai	archaeologists
muzikantai	musicians
koncentracija	concentration
tankiai	densely
išreikšti	expressing
monarchija	monarchy
aston	aston
havajų	hawaiian
rabinas	rabbi
erikas	eric
erikas	erik
taylor	taylor
kūnai	bodies
sultonatas	sultanate
cemento	cement
parengti	prepare
žygis	hike
žygis	quest
kritikavo	criticised
derybos	negotiation
derybos	negotiations
juodkalnija	montenegro
interjeras	decor
indonezijoje	indonesia
kalėdų	christmas
tankai	tank
tankai	tanks
katerina	katherine
katerina	katerina
vėžys	cancer
kanalai	channels
šaulys	shooter
esperanto	esperanto
galūnės	extremities
atsiradimą	emergence
skausmas	pain
kijeve	kiev
dniepro	dnieper
durpių	peat
veronika	veronica
kolumbija	columbia
podolės	kamianets
medžioklė	hunting
pasiskirstymas	distribution
kaspijos	caspian
pasirodymai	performances
ištekliai	resources
eric	eric
motors	motors
nuosavybė	property
nuosavybė	equity
ignotas	ignacy
pagrįstas	justified
ginklą	gun
plakatas	poster
barbus	barbus
ajax	ajax
mac	mac
miltų	flour
miltų	meal
vienybės	unity
išradimų	inventions
vdr	gdr
atodanga	outcrop
stephen	stephen
visu	full
mirti	die
mirti	dying
vnt	piece
laimės	happiness
pasakyti	say
baby	baby
juodai	black
vynuogių	grape
armėnija	armenia
gaga	gaga
antenos	antennae
antenos	antenna
dažni	common
pelnas	profit
vakarai	west
indai	dishes
malio	mali
bendrauti	communicating
audra	storm
alonso	alonso
pagyrimu	honours
žolių	herb
būtinas	necessary
brigada	brigade
patelių	females
alėja	parkway
dirbtinis	artificial
nuotykiai	adventures
nuotykiai	adventure
java	java
nina	nina
psichologija	psychology
erdvę	spots
ligomis	comorbidity
potockis	potocki
tvarkyti	manage
tvarkyti	handle
parako	gunpowder
porų	couples
turnyrai	tournaments
fragmentas	fragment
įspūdį	impression
aerodromas	aerodrome
fiat	fiat
kalėjimą	jail
ašies	axle
ašies	axis
turkai	turks
klasikinis	classic
skysčio	fluid
smėlis	sand
smėlis	tyler
smėlis	sands
kronikos	chronicles
kampanija	campania
kampanija	campaign
plokštelės	wafers
ataka	attack
organizmas	organism
gaujos	gang
partizanams	guerrillas
susiduria	facing
susiduria	faced
karūna	crown
disney	disney
gyvos	living
gyvos	live
eng}}	eng}}
drabužius	clothes
sluoksniai	layers
vertimo	translation
duoklę	tribute
dulkių	dust
audinys	cloth
izabelė	isabella
tarnautojas	servant
tarnautojas	clerk
veidas	wade
darbininkai	workers
ekrano	screen
skystis	liquid
galutinis	final
galutinis	definitive
kiaušinių	eggs
kiaušinių	egg
vyskupų	bishops
patinų	male
išlaisvinimo	liberation
tiesos	truths
tiesos	truth
europiečiai	europeans
genų	gene
visualeditor	visualeditor
kaulai	bones
kaulai	bone
eleonora	eleanor
bokso	boxing
likučiai	residues
likučiai	balances
perspektyvos	prospects
paslaptis	mystery
audiniai	tissues
valymo	cleaning
valymo	purification
teikė	fed
savarankiška	autonomous
traukos	traction
edgaras	edgar
degimo	combustion
degimo	burning
budizmas	buddhism
pilotai	pilots
lankytojų	visitors
lankytojų	visitor
dangus	heaven
dangus	sky
dangus	skies
apranga	dress
apranga	clothes
apranga	clothing
apranga	outfit
vartotojai	consumers
pavojus	hazard
htm	htm
animacija	animation
durys	door
durys	doors
xbox	xbox
sutrikimai	disorders
vitamino	vitamin
baltymai	protein
baltymai	proteins
ginkluoti	armed
senatas	senate
švenčiama	celebrated
franco	franco
iniciatorius	initiator
bmw	bmw
savybė	property
mokėjimo	paying
sausas	dry
everton	everton
vita	vita
remti	supporting
dantys	teeth
kostiumų	costume
harvardo	harvard
auka	victim
fiba	fiba
sultys	juice
vilhelmo	wilhelm
siauras	narrow
pluošto	fibre
pluošto	beam
lobis	treasure
masiškai	massive
masiškai	massively
koalicija	coalition
fbk	fbk
gyvūno	animal
takų	tract
filmavimo	filming
sudėtingas	complex
marc	marc
vedų	vedic
klano	clan
tremtyje	exile
koeficientas	coefficient
mainų	exchanges
albanija	albania
trumpi	short
maitinimo	catering
nesutarimų	disagreements
nesutarimų	controversy
reiškinius	phenomena
bitės	bees
bitės	bee
karvedys	warlord
pskovo	pskov
opozicijos	opposition
chodkevičius	chodkiewicz
mergaitės	girls
sakalas	falcon
sakalas	hawk
kinas	chinese
bažnytinės	ecclesiastical
laboratorija	laboratory
būklė	status
benfica	benfica
treniruočių	workout
siela	soul
hipotezė	hypothesis
kopija	replica
olympiakos	olympiakos
pasakų	tales
islandija	island
ordos	ordos
tvenkiniai	ponds
piešiniai	drawings
piešiniai	paintings
holivudo	hollywood
turku	turku
siaura	narrow
parodas	exhibitions
šokiai	dancing
pasakojimas	story
stiprūs	strong
stiprūs	potent
vabzdžiai	insects
vabzdžiai	insect
fra	fra
vyskupijai	bishopric
bado	starvation
bado	hunger
dovydas	david
vėjai	winds
kojas	legs
drėgnas	moist
anne	anne
milda	melanie
gynybą	defensive
sprendžiant	judging
anglis	coal
anglis	charcoal
anglis	carbon
debesų	clouds
debesų	cloud
gambitas	gambit
medvilnė	cotton
granitas	granite
pontiac	pontiac
forumas	forum
rfc	rfc
karalysčių	kingdoms
klientų	customer
klientų	customers
samių	sami
vedder	vedder
amerikiečiai	americans
išlaiko	keeps
darbininkas	worker
garsai	sounds
molekulių	puzzle
firma	firm
atsakomybė	liability
atsakomybė	responsibilities
atsakomybė	responsibility
animacinis	animated
ginkluotės	ammo
koncerto	concert
pirkti	purchase
pirkti	buying
šeštasis	sixth
audito	auditing
pastabos	remarks
pastabos	observations
pastabos	comments
išmokė	taught
studentas	student
sąjungininkai	allies
žino	knows
samuel	samuel
varpai	bells
praleidžia	spends
bibliotekų	libraries
bibliotekų	library
airbus	airbus
autonomiją	autonomy
mūšių	battles
sąveikos	interoperability
rengiant	drafting
bičių	bees
bičių	bee
fidžio	fiji
karpovas	karpov
ilinojaus	illinois
sindromas	syndrome
levas	lev
dovanojo	donated
humoro	humor
laukinių	wild
laukinių	wildlife
observatorija	observatory
čartoriskis	czartoryski
carinės	tsarist
sukasi	turning
archeologija	archaeology
biologija	biology
formulę	formula
christopher	christopher
myspace	myspace
iždo	treasury
prelatas	prelate
patiekalai	specials
versijų	versions
povandeninių	underwater
išraiškos	expressions
valerijus	valery
drabužiai	garments
drabužiai	clothing
drabužiai	clothes
eurolygos	euroleague
douglas	douglas
sode	garden
egzistuoti	exist
helena	helene
pateikiamos	pulling
perduoda	transmits
mineralų	minerals
rodikliai	indicators
urvas	cave
žarnyno	bowel
žarnyno	gut
altoriaus	altar
giesmė	hymn
vienija	unites
žaibo	lightning
likti	remain
įmonėse	companies
mitybos	nutrition
mitybos	dietary
mitybos	nutritional
mitybos	diet
franz	franz
jovi	jovi
europaea	europaea
okeanijos	oceania
smetona	smetona
gyvi	live
gyvi	alive
steiner	steiner
kambarys	room
rosa	rosa
logika	logic
ekologijos	ecology
ateina	coming
gdansko	gdańsk
gdansko	gdansk
aktyvi	active
bosnija	bosnia
arkties	arctic
debesys	clouds
debesys	cloud
lagūna	lagoon
bondo	bondo
pripažįsta	acknowledges
puikus	excellent
cgi	cgi
greit	soon
greit	fast
pievų	meadows
aviacija	aviation
giuseppe	giuseppe
smuikas	violin
smuikas	fiddle
technikas	technician
uždaryti	close
norą	willingness
inter	inter
palikuonių	progeny
palikuonių	offspring
borussia	borussia
aidai	echoes
reitingas	rating
lapės	foxes
infrastruktūra	infrastructure
infrastruktūra	infrastructures
santos	santos
indėlis	contribution
indėlis	deposit
patinas	male
jordan	jordan
gauta	incoming
priklausomybės	dependency
priklausomybės	dependencies
vertimai	translations
golfo	golf
magdalena	magdalena
konsulas	consul
ginkluotas	armed
faktas	fact
ribose	ribose
seni	dude
mafijos	mafia
praktiką	internship
dūmų	smoke
matmenys	dimensions
reformacijos	reformation
holokausto	holocaust
atskirtas	separated
charakteristikos	characteristics
deutsche	deutsche
įtvirtinimų	fortifications
gabriel	gabriel
pertraukomis	intermittent
mergaitė	girl
slapyvardis	nickname
philip	philip
elektra	electricity
architektai	architects
rašomas	printable
bernardo	bernardo
mintys	thoughts
berniukas	boy
balų	scoring
asteraceae	asteraceae
uogos	berries
bokštą	rook
apibrėžia	defines
klasikinio	classical
moore	moore
moldovos	moldova
temperatūrą	temperature
sinonimai	synonyms
kuras	fuel
kuras	fuels
katė	cat
bolonijos	bologna
šumerų	sumerian
prižiūrėti	watch
prižiūrėti	supervise
plokštės	panels
plokštės	plate
sulčių	juice
trileris	thriller
plokštelių	wafers
klaidingai	false
leidyba	publishing
stepės	steppes
serga	sick
jerzy	jerzy
menininkai	artists
privačiai	privately
atkarpa	segment
čiuožimo	skating
dainuoja	sings
dainuoja	singing
aukščiausiasis	supreme
departamentai	departments
kasos	pancreatic
demokratija	democracy
civilinė	civil
borneo	borneo
užgrobė	hijacked
skonis	flavour
apgyvendintas	inhabited
laiptai	stairs
laiptai	staircase
nicole	nicole
kviečiai	wheat
donecko	donetsk
srautas	flow
verta	worth
verta	worthy
novi	novi
jūrinių	regulates
trikampis	triangle
diskusijos	discussions
diskusijos	discussion
diskusijos	debate
diskusijos	debates
ret	ret
delegacijos	delegations
vls	vls
koalicijos	coalition
išgyventi	survive
išgyventi	surviving
bulvių	potatoes
bulvių	potato
slavai	slavs
gyvulininkystė	livestock
švino	lead
mažumos	minorities
iniciatyvos	initiatives
laboratorijoje	laboratory
bernard	bernard
anūkas	grandson
signalo	signal
medaliai	medals
airėse	aires
momentas	moment
tado	thaddeus
aspektai	aspects
balto	satin
trūko	lacked
palikimas	legacy
palikimas	legacies
portretai	portraits
viltis	hopes
mokoma	taught
lietus	rain
takai	takai
mokestį	bargain
branduolinės	nuclear
picea	picea
sektos	sects
išgelbėti	rescued
didžiulį	tremendous
tamilų	tamil
žinojo	knew
minutę	minute
atvirai	honestly
makšties	vagina
makšties	vaginal
elseif	elseif
žengimo	ascension
vartotojams	consumers
pranašumą	advantage
ideologija	ideology
arnoldas	arnold
uogų	licorice
ženklais	char
populiarumas	popularity
nelly	nelly
išėjimo	output
calcio	calcio
emilis	emil
kalinys	prisoner
fiodoras	fyodor
interjero	interior
sandra	sandra
porsche	porsche
raf	raf
alpės	alps
vlado	vlado
paruošti	prepared
specialių	special
schmid	schmid
scenų	scenes
draugo	friend
upes	rivers
gėlės	flowers
draugė	friend
sony	sony
elgtis	behave
sutrikimas	disorder
natalija	natalia
vasaris	february
žiedynas	inflorescence
gėlė	flower
vakare	evening
branduolių	kernel
stratovulkanas	stratovolcano
padengti	plated
rimtai	seriously
bros	bros
traumos	injury
nam	nam
renata	renate
renata	renata
eritrėjos	eritrea
žudynių	killings
cukrus	sugar
smegenys	brain
smegenys	brains
teoriškai	theoretically
dangos	coatings
dievybė	deity
derliaus	harvest
derliaus	harvesting
giminių	relatives
angelo	angelo
sąveika	interaction
sąveika	interoperability
sąveika	interactions
vestuvės	weddings
vestuvės	wedding
išgauti	extracted
greitas	quick
greitas	rapid
greitas	fast
pablo	pablo
akcija	share
pasirodymų	apparitions
akimis	eyes
georg	georg
kiaulių	pig
paveldėjimo	inheritance
botanikas	botanist
šventyklą	temple
blogai	badly
blogai	bad
infrastruktūros	infrastructure
infrastruktūros	infrastructures
civilių	civilian
orbitą	orbit
rėmėjas	sponsor
cruz	cruz
skrydžiai	flights
niekur	anywhere
bausmę	penalty
gaz	gaz
apeigos	rite
senovinė	pristine
grėsmė	threat
boston	boston
ypatumai	features
skr	scr
šalininkas	supporter
pasirašytas	subscribed
lapė	fox
koledžas	college
kolonistų	colonists
pali	pali
beisbolo	baseball
kimi	kimi
mesjė	monsieur
baldai	furniture
hermann	hermann
autonomijos	autonomy
kvapą	scent
jausmus	feelings
plymouth	plymouth
dėžutė	box
dėžutė	mailbox
kiaulės	pigs
reaguoja	reacts
est	est
kenijos	kenya
kenijos	kenyan
honda	honda
imtynių	wrestling
brothers	brothers
egėjo	aegean
algoritmas	algorithm
grūdai	grain
grūdai	cereals
grūdai	grains
grūdai	cereal
gyvatė	snake
gyvatė	serpent
pietro	pietro
tyrinėti	exploring
sparnais	flapping
imperatoriai	emperors
chronologija	chronology
manyti	believing
prietaisas	appliance
prietaisas	apparatus
bisau	bissau
užbaigti	finish
ingrida	ingrid
filharmonijos	philharmonic
žalsvai	greenish
birželis	jun
birželis	june
lotus	lotus
liberalai	liberals
hotspur	hotspur
meistrai	craftsmen
kabineto	cabinet
komentarai	comments
elektroninių	electronic
vaikinas	guy
vaikinas	chap
vaikinas	boyfriend
traukiniai	trains
gold	gold
žolė	grass
žolė	weed
tottenham	tottenham
persekiojimo	persecution
geba	capability
vitas	whit
rightarm	rightarm
slavia	slavia
infekcijos	infections
levski	levski
uždegimas	inflammation
uždegimas	ignition
prastai	poorly
chemija	chemistry
monako	monaco
nepriklausomybė	independence
patiekalas	dish
dvigubas	dual
prototipas	prototype
atskleidžia	revealing
gina	defends
gina	defending
mgb	mgb
traukia	attracted
traukia	attracts
miręs	dead
alfonso	alfonso
apple	apple
veikiančių	running
sugrįžimas	comeback
jimmy	jimmy
plokštė	plate
jaunimas	youth
hindi	hindi
černigovo	chernihiv
bombos	bomb
bombos	bombs
stiprinti	strengthen
stiprinti	strengthening
kiemas	yard
eksportas	exports
eksportas	export
dvasinis	spiritual
pamokos	lessons
gotikos	gothic
faraonas	pharaoh
gausa	abundance
iranas	iran
laukia	waiting
gustavo	gustavo
kordobos	córdoba
kopenhagoje	grandma
ponto	pontic
maršrutas	route
maršrutas	itinerary
sint	sint
dažnis	frequency
mauzoliejus	mausoleum
américa	américa
gerovės	prosperity
gerovės	welfare
jon	jon
ludwig	ludwig
somalio	somali
ein	ein
tvirtai	stuck
tvirtai	firmly
galaktikų	galaxies
vertinimas	valuation
vertinimas	assessment
vertinimas	appraisal
pranešimas	notification
hip	hip
kolorado	colorado
instruktorius	instructor
bono	bono
vikšrai	caterpillars
prisiminimai	memories
audros	storms
audros	storm
standartizacijos	standardisation
standartizacijos	standardization
nagrinėti	exploring
diplomas	diploma
diplomas	testimony
urugvajus	uruguay
įgaliotasis	authorised
oksfordo	oxford
koledžo	college
eteryje	ether
georges	georges
telekomunikacijų	telecommunications
telekomunikacijų	telecommunication
alfredo	alfredo
renkasi	gather
kovotojas	fighter
vilma	vilma
kamera	camera
linų	flax
išvados	conclusions
genujos	genoa
miego	sleep
rinkimo	fundraiser
domas	dom
klinikos	clinic
žemynas	continent
griovį	ditch
dūmai	smoke
pasiekimų	achievements
migracija	migration
migracija	immigration
reklama	advertising
reklama	systematic
ann	ann
galatasaray	galatasaray
karpatų	carpathian
apleista	abandoned
apleista	immortal
antis	ducks
antis	duck
eilutės	rows
eilutės	lines
sojų	soybean
aktus	acts
tabakas	tobacco
logistikos	logistics
mitas	myth
pulką	regiment
žudynės	massacre
nhl	nhl
aktyvistų	activists
geografinė	geographical
apskaičiuoti	calculate
sergio	sergio
apleistas	neglected
apleistas	abandoned
kapelionas	chaplain
matomos	seemingly
autonomija	autonomy
karštas	hot
ginkluotė	weaponry
kopenhagos	copenhagen
isp	isp
vera	vera
pėdsakų	trace
amūro	amur
tarnauja	serves
vilnos	wool
žievės	bark
hercegovina	herzegovina
pilietinių	civic
laivybos	shipping
laivybos	nautical
stadion	stadion
aiški	pure
kailio	fur
pelkėse	marshes
šautuvai	rifles
sodininkystės	horticulture
sodininkystės	horticultural
sodininkystės	gardening
buveinė	habitat
kirgizijos	kyrgyz
slidinėjimas	skiing
stuburo	spinal
lapas	sheet
gatvėse	streets
avys	ovine
avys	ewes
pažadėjo	pledged
remontas	repair
remontas	repairs
kultūriškai	culturally
spausdina	prints
susitikimai	meetings
žaliojo	cape
neo	neo
maurice	maurice
dažų	paint
dažų	dye
vandenis	waters
mokesčiai	levies
mokesčiai	charges
mokesčiai	taxes
mokesčiai	fees
benz	benz
madona	madonna
antilų	antilles
ian	ian
unix	unix
laikraščiai	newspapers
platono	platonic
genealogija	genealogy
putinas	putin
puslaidininkių	semiconductor
sardinijos	sardinia
pažeidimas	infringement
bulvės	potatoes
bulvės	potato
surinkimo	capture
surinkimo	assembly
atskleisti	disclose
leipcigo	leipzig
pabrėžė	emphasised
pabrėžė	stressed
blogio	evil
gyvačių	snakes
aris	aris
magnio	magnesium
riešutų	nut
riešutų	walnut
žandikaulio	jaw
šiluminė	heat
integracijos	integration
dinastijų	dynasties
gegužė	mai
nelaisvėje	captive
nelaisvėje	trapped
istorijų	stories
roplių	reptile
ledynas	glacier
baritonas	baritone
scuderia	scuderia
kaimynai	neighbors
kaimynai	neighbours
elniai	deer
kompetencijos	excellence
rungtis	tiebreaker
judesiai	movements
pelėda	owl
vettel	vettel
grenlandijos	greenland
teisiškai	legally
ragas	horn
skulptūrą	sculpting
vilkai	wolves
dienoraštis	diary
membranos	membranes
membranos	membrane
stebėjo	watched
adamas	adam
sandraugos	commonwealth
sterlingų	sterling
usd	usd
naikinimo	destruction
naikinimo	exterminate
aek	aek
milanas	milan
plocko	płock
suvienyti	unite
balio	bali
ašis	axle
ašis	axis
jauniklius	cubs
papildymas	addendum
teigiamai	positively
kukurūzų	corn
gėrimo	potion
tautybių	nationalities
psichiatrijos	psychiatry
tulžies	bile
matmenų	dimensional
angelas	angel
pastorius	pastor
vfr	vfr
temperatūrai	screens
concacaf	concacaf
gyva	live
gyva	alive
psichiatras	psychiatrist
kaliniai	inmates
suaugusiems	adult
geto	ghetto
diskografija	discography
reguliuoti	regulate
uždavinys	task
svečiai	guests
žiema	winter
gerti	drink
atlético	atlético
atlas	atlas
olimpija	olimpija
senatorius	senator
uždrausti	ban
uždrausti	prohibit
naudinga	helpful
ryte	morning
sinclair	sinclair
komerciškai	commercially
otonas	otho
konferencijų	conferences
fakultetų	faculties
atsargų	supplies
atsargų	reserves
atsargų	stock
jekaterina	ekaterina
ortodoksų	orthodox
kurtas	kurt
kurtas	curtis
kieme	courtyard
kieme	backyard
kario	curry
grandis	grandis
molis	clay
tuberkuliozės	tuberculosis
stipendija	scholarship
trio	trio
įrankius	gears
pluoštas	fibre
muhammad	muhammad
hormonų	hormone
ausies	ear
techninis	slack
gen	gen
prienai	prienai
sniegas	snow
pagirių	hangover
riešutai	walnuts
pilvas	abdomen
pilvas	belly
poste	poste
suvokimas	perception
nicolas	nicolas
centų	cents
žiurkės	rat
žiurkės	rats
cinko	zinc
serbai	serbs
butano	butane
javai	cereals
javai	cereal
tunelis	tunnel
realizmo	realism
stambulo	istanbul
silpnas	weak
slėniai	valleys
bomba	bomb
didžiulė	huge
storas	fat
galūnių	limb
galūnių	limbs
galūnių	extremities
nove	nowe
krateris	crater
tvirtas	solid
tvirtas	strong
išgelbėjo	saved
ožkos	goats
bankininkystės	banking
olandija	holland
apgulties	siege
neaiški	uncertain
neaiški	vague
išminties	wisdom
vasari	vasari
pėdsakai	trails
pėdsakai	trace
stalinas	stalin
tibete	tibet
dziudo	judo
septintasis	seventh
retais	ltr
italia	italia
commons	commons
doleris	dollar
atolo	atholl
lightgreen	lightgreen
aurelijus	aurelius
sparnus	wings
pentax	pentax
šiluma	heat
šiluma	thermal
noras	desire
noras	willingness
baimė	fear
rankena	handle
sekti	trace
brolija	fraternity
brolija	brotherhood
pakeitimas	amendment
pažeidžia	infringe
pažeidžia	violating
kolonizacijos	colonisation
kurdų	kurdish
rėmėjų	sponsors
rėmėjų	supporters
signalas	signal
žuvėdra	seagull
birmingham	birmingham
roku	roku
angis	viper
etapai	stages
etapai	milestones
flamandų	flemish
profesija	occupation
sužeista	injured
daromi	administer
bell	bell
florida	florida
melodija	melody
kareivis	soldier
deportivo	deportivo
osetijos	ossetia
vokalinių	vocal
susitarimo	arrangement
įtampą	tensions
suvokimo	perceptions
nesutiko	thanked
karvės	cows
karvės	cow
gildijos	guild
geografinis	geographical
bangas	waves
prielaidos	assumptions
trauktis	retreat
fiziškai	physically
tapyti	repainted
karvelis	pigeon
jorge	jorge
žemynų	continents
sunkus	heavy
sunkus	severe
rom	rom
programavimas	programming
dama	lady
pailgos	oblong
komentaras	comment
komentaras	commentary
tankio	density
aukas	victims
navikai	tumours
ilja	ilya
nuodingas	poisonous
mityba	nutrition
mityba	diet
misijų	missions
slovan	slovan
padegimas	arson
jay	jay
dėmės	scars
teresa	teresa
#efefef	#efefef
bendri	general
nowrap	nowrap
sims	sims
kortos	cards
jevgenijus	yevgeny
veikimas	operation
sąsajos	interfaces
sraigtasparnių	helicopters
grėsmės	threat
poras	pores
keistis	exchanging
puola	attacking
koralų	coral
pastovus	steady
klausos	hearing
ios	ios
anderlecht	anderlecht
spa	spa
porūšiai	subspecies
mongolai	mongols
plinta	spreading
plinta	spreads
ideologijos	ideology
uss	uss
ngc	ngc
gydytojai	physicians
gydytojai	doctors
aplankyti	visit
aplankyti	visiting
stovyklose	camps
psv	psv
dega	burns
dega	burn
bengalijos	bengal
kalėjimas	jail
kalėjimas	prison
tragedija	tragedy
olimpiada	olympiad
mitsubishi	mitsubishi
šarvai	armour
wydawnictwo	wydawnictwo
negyvenama	uninhabited
vakaro	evening
nagai	nails
obuolių	apples
rnr	rna
mėnesiai	months
krokuva	krakow
fleita	flute
pabrėžti	stressing
vergai	slaves
pašarų	feed
concat	concat
milžiniškas	tremendous
milžiniškas	huge
klinika	clinic
pakviesti	invited
periodiškai	periodical
sveikas	hey
uždaviniai	tasks
tok	tok
prielaida	presumption
vainikas	wreath
rel	rel
velykų	easter
england	england
draudžiamos	prohibited
džo	joey
kaulas	bone
nelson	nelson
indonezija	indonesia
atostogų	vacation
židinys	fireplace
velnias	damn
kviečių	wheat
nedarbo	unemployment
valentina	valentina
prizo	prize
dirbtinai	artificially
biosferos	biosphere
pistoletai	pistols
kvartale	vicenza
virimo	boiling
virimo	cooking
titas	titus
įgyvendina	implements
grynas	pure
simona	simone
simona	simona
ausys	ears
badas	famine
badas	hunger
nenori	reluctant
būtinai	absolutely
gyvuliai	animals
gyvuliai	livestock
gyvuliai	animal
jausmas	feeling
keliones	tours
keliones	trips
ram	ram
arenos	challenger
chano	chano
sektorių	sectoral
ibm	ibm
liūto	lion
berno	berne
makro	macro
pakraštys	periphery
šlaitų	slopes
graužikų	rodent
graužikų	rodents
ateitis	future
sauber	sauber
parduodami	sold
kiaušiniai	eggs
kiaušiniai	egg
pasakojimo	narrative
privalomas	mandatory
atleisti	drop
procentas	percentage
pažeidimus	infringements
krenta	dropping
krenta	falls
krenta	fall
giminingos	likeness
sula	sula
vartotojas	consumer
dekoratyvinės	decorative
cilindro	cylinder
minėtų	injectors
crvena	crvena
mecenatas	patronage
debesis	cloud
luiza	louise
metrai	metres
efektyvumas	efficacy
hamburg	hamburg
depeche	depeche
struktūras	structures
ceremonijos	ceremony
vėžliai	turtles
rojus	roy
rojus	paradise
juros	jura
dantis	tooth
interwiki	interwiki
susieti	tie
srauto	flow
židinio	focal
kaklas	neck
valensijos	valencia
padėkos	thanksgiving
valdomi	operated
valdomi	managed
atominė	atomic
tapatybės	identity
įvertinimas	rating
įvertinimas	appraisal
įvertinimas	assessment
comics	comics
utf	utf
maras	plague
mitai	myths
įrodymas	proof
drėgmės	moisture
tld	tad
gebėjimas	ability
napoli	napoli
universal	universal
galingas	powerful
vairuotojas	driver
cat	cat
ragai	horns
atletico	atletico
georgijus	georgy
hlist	hlist
disciplina	discipline
turtus	riches
bogdanas	bohdan
nida	nida
turbo	turbo
aspektus	aspects
represijų	repression
širdį	heartbreaking
privilegija	privilege
atgaivinti	revive
atgaivinti	reactivate
shamrock	shamrock
nuotaikos	mood
ritmo	rhythm
vienybė	unity
trūkumai	deficiencies
trūkumai	shortcomings
higienos	hygienic
kristalų	crystal
fra}}	fra}}
vyšnių	cherry
stipendiją	scholarships
stipendiją	scholarship
trąšų	fertilizer
trąšų	fertiliser
greitkelis	motorway
greitkelis	expressway
greitkelis	highway
čin	qin
dubens	pelvic
partizan	partizan
nintendo	nintendo
pažeidimo	infringement
barselonoje	barcelona
smūgis	blow
smūgis	punch
spartos	spartan
spartos	sparta
oldsmobile	oldsmobile
dirvos	soils
priedai	accessories
btr	gtr
šūkis	motto
vėžlys	turtle
rudolf	rudolf
išgirsti	hear
žinduoliai	mammals
grindų	floor
skubiai	urgent
skubiai	urgently
butų	flats
butų	apartments
pakeitimai	amendments
pakeitimai	modifications
spinduliuotės	radiation
baterijos	battery
baterijos	batteries
darželio	kindergarten
darželio	nursery
glentoran	glentoran
protas	mind
išplaukė	sailed
mazgų	knots
žymėjimas	marking
žymėjimas	tagging
atradimas	discovery
pripažintos	recognized
turtingas	rich
stiprumas	potency
prekiavo	acted
leidimai	permits
čigonų	gypsy
pelnęs	earned
gustav	gustav
coelogyne	coelogyne
germain	germain
libija	libya
dėmių	stain
kopos	dunes
gyvybė	life
veteranų	veterans
priekinis	windscreen
bute	apartment
furtado	furtado
kapitalas	capital
žaibas	lightning
rankraščių	codices
mechanika	mechanics
kara	kara
vertingas	valuable
tradicijomis	tradition
arklius	horses
smurto	violence
brno	brno
kolonizacija	colonization
matuojamas	measured
nuomos	rental
nuomos	lease
druskų	saline
druskų	salts
saugojimo	mobile
autobusas	bus
raketas	missiles
baptistų	baptist
marta	martha
lengvas	mild
brolijos	fraternity
aids	aids
valua	valois
pasiūlymus	proposals
požymis	attribute
povandeninis	submarine
povandeninis	underwater
parametrai	parameters
važiuoklė	chassis
pulkai	flocks
dažiklis	dye
spektro	spectrum
švedas	swede
audi	audi
baimės	fear
šuolis	leap
gynėjų	defenders
subjektas	entity
limfoma	lymphoma
puolimas	offensive
akivaizdžiai	manifestly
policininkas	policeman
grynai	purely
int	int
tapatybę	identity
esminis	essential
karine	karine
berniukai	boys
faktorius	factor
liūtai	lions
leidžiantis	authorising
atsakymas	answer
atsakymas	reply
ifk	ifk
papuošalai	jewellery
rotary	rotary
adriano	adriano
chromosomų	chromosome
aukštumas	highs
žemyninės	mainland
dekoratyvinių	ornamental
indas	vessel
indas	indian
sociologija	sociology
gumos	gum
dūmos	duma
peloponeso	peloponnese
skolos	debts
maitina	feeds
jaroslavas	yaroslav
kieta	tough
moravijos	moravia
tunisas	tunisia
gamyklų	factories
gamyklų	mills
investicijos	investment
investicijos	investments
turtų	riches
stalas	desk
dragon	dragon
komitetai	committees
giminei	dishonor
mičigano	michigan
wright	wright
meidži	meiji
lygybės	equality
terapija	therapy
lima	lima
rené	rené
nimfos	nymphs
kardas	sword
img	img
įkvėpimo	inspiration
černobylio	chernobyl
orlando	orlando
achemenidų	achaemenid
juostomis	lanes
mergelių	virgin
moliuskų	molluscs
kašmyro	kashmir
publikuoti	publish
aljanso	alliance
beatles	beatles
mina	mina
gaidys	cock
gaidys	rooster
konfederacijų	confederations
kėlimo	lifting
admirolas	admiral
prietaisai	devices
prietaisai	apparatus
prietaisai	appliances
finikiečių	phoenician
indra	indra
domino	domino
apskaita	accounting
reliatyvumo	relativity
katastrofos	catastrophe
slaugos	nursing
joachim	joachim
filipinai	philippines
ptolemėjas	ptolemy
gauja	gang
smulkiai	finely
vfb	vfb
lūpos	lips
etika	ethics
pavaduotojai	deputies
sera	sera
orai	weather
kanto	kant
bafta	bafta
kovotojai	fighters
luvras	louvre
sintezė	synthesis
kanarų	canary
žodyno	vocabulary
michaelis	michaelis
garų	vapour
moderni	modern
pusbrolis	cousin
utc+	utc+
kūriniams	works
filadelfijos	philadelphia
skraidyti	flying
bowie	bowie
uždarymo	closure
uždarymo	closing
italai	italians
grigorijus	grigory
pareiga	obligation
bananai	bananas
nikola	nikola
beach	beach
con	con
komunistai	communists
komunistai	communist
įtikino	persuaded
atsakyti	answer
atsakyti	reply
raganos	witch
raganos	witches
evoliucija	evolution
gilus	deep
tang	tang
kraujotakos	circulatory
panašumų	similarities
demografija	demographics
demografija	demography
užsakymų	bookings
paskaitos	lectures
paparčių	fern
grace	grace
wacker	wacker
sąvokų	concepts
forte	forte
harris	harris
tariamai	supposedly
tariamai	alleged
tariamai	allegedly
neramumai	unrest
terasos	terraces
mangano	manganese
kryme	crimea
pupelės	beans
skaičiuoti	count
diplomatijos	diplomacy
tolygiai	evenly
musinukė	flycatcher
ville	ville
lang	lang
šekspyras	shakespeare
ypatybės	properties
kone	connie
michelle	michelle
midlothian	midlothian
singapūro	singapore
propaganda	propaganda
vaida	vaida
kiaušinio	egg
rifo	reef
vista	vista
komponentai	components
licencijos	licences
licencijos	licence
sprogimas	explosion
metallica	metallica
čekoslovakijoje	czechoslovakia
organizavimą	organising
sveiki	hello
quercus	quercus
cameron	cameron
registracijos	registration
aktyvistas	activist
karvių	cows
dešimtys	tens
dešimtys	followers
augmenija	vegetation
jauniklių	juvenile
kadrų	frames
daiktas	thing
bauda	penalty
irakas	iraq
išorėje	externally
genetikos	genetics
adams	adams
žydas	jew
vaistinės	pharmacy
vaistinės	pharmacies
banknotai	banknotes
smegenis	brains
švelnus	gentle
minkšta	soft
buvimas	existence
buvimas	presence
aborigenų	aboriginal
ceremonijoje	ceremony
floriana	floriana
shelbourne	shelbourne
katinas	cat
verdi	verdi
vaisingumo	fertility
detroito	detroit
išimtinai	exclusively
arbitražo	arbitration
arbitražo	referee
arbitražo	arbitrage
dalyvio	participant
abejonių	doubts
blogas	bad
sodą	orchard
šokti	dancing
konkrečių	specific
kopenhaga	copenhagen
fermentų	enzyme
geležis	iron
patiko	enjoyed
gausus	abundant
parduodama	sold
parduodama	selling
malaizija	malaysian
devyni	nine
pragyvenimo	subsistence
administravimas	administration
ištraukos	extracts
asirų	assyrian
sylvestris	sylvestris
vienuolynai	monasteries
genetiškai	genetically
trakijos	thrace
magija	magic
boksininkas	boxer
sausa	dry
preparatai	preparations
liauka	gland
treniruotės	workout
treniruotės	cardio
mezoamerikos	mesoamerican
vynuogės	grape
vynuogės	grapes
choreografas	choreographer
išstumti	eject
vakarais	evenings
campbell	campbell
stefano	stefano
parduotuvėse	shops
parduotuvėse	stores
silicio	silicon
silicio	silica
gimimas	birth
doktorantūros	doctoral
trupės	troupe
kalinauskas	kalinowski
sverdlovsko	sverdlovsk
pinyin	pinyin
ribes	ribes
pranešimai	notifications
sweet	sweet
aprašas	inventory
atliekos	waste
atliekos	wastes
bel	crl
bel	bel
cola	cola
sandėlis	warehouse
lyginamosios	comparative
schalke	schalke
textcolor	textcolor
tyrėjas	researcher
tyrėjas	investigator
įjungtas	enabled
gražiai	beautifully
gražiai	nice
palydovai	satellites
konkuruoti	compete
rpg	rag
tešlos	dough
sintezės	fusion
metodika	methodology
neil	neil
spec	spec
saldus	sweet
doktrina	doctrine
kristalai	crystals
arturas	arthur
malavio	malawi
čechovas	chekhov
eindhoven	eindhoven
irina	irina
klaus	klaus
išnykimo	extinction
ragana	witch
keith	keith
lodzės	łódź
taikiai	peacefully
intel	intel
lūžio	fracture
latvijas	latvijas
haičio	haitian
graži	beautiful
rika	rica
müller	müller
hajduk	hajduk
maršrutai	routes
skilimo	decomposition
skilimo	degradation
pagarbą	esteem
bordo	bordeaux
starcraft	starcraft
dešimtuką	jackpot
plokštumos	plane
šilumą	warmth
dovana	gift
laoso	lao
žudikas	murderer
roberts	roberts
baskų	basque
jonijos	ionian
molotovo	molotov
morgan	morgan
kamaz	kamaz
atšauktas	revoked
pagrobė	kidnapped
simetrija	symmetry
įdomu	interesting
įdomu	wonder
nėštumas	pregnancy
veiksnys	factor
kambariai	rooms
mika	mika
kinematografijos	cinematographic
spaudimą	compression
linda	linda
įsipareigojo	undertook
riūkiū	ryukyu
ferganos	fergana
khmerų	khmer
uždara	closed
langas	window
rama	rama
marek	marek
generolai	generals
pagonių	pagan
parduoda	sells
sintezatorius	synthesizer
skaitmeninis	numerical
pirštai	toes
jaučiasi	feels
bokšte	tower
žirgas	knight
žirgas	horse
angliavandenių	carbohydrate
angliavandenių	carbohydrates
juniors	juniors
para	para
organizatoriai	organisers
vda	adt
kanalais	channels
kaimynų	neighbours
įtikinti	convince
įtikinti	persuade
vestfalijos	westphalia
blackburn	blackburn
susigrąžinti	recover
iliustracija	illustration
liucija	lucia
ftb	fbi
kantonų	cantonal
orleano	orleans
romai	roma
#dfffdf	#dfffdf
justina	justina
senegalas	senegal
valdytojai	governors
valdytojai	controllers
valdytojai	managers
gossard	gossard
riteris	knight
kamuolys	ball
šarvus	armor
kasparas	caspar
vaz	vaz
kančios	suffering
bilietų	tickets
bilietų	ticket
vitaminas	vitamin
seleukidų	seleucid
signalus	signals
nme	nme
tulos	tula
scrolls	scrolls
tamara	tamara
supratimą	consciousness
reputaciją	reputation
albion	albion
edvinas	edwin
atmestas	denied
išlaisvinti	freed
kolonijinės	colonial
intelektinės	intangible
intelektinės	intellectual
ncaa	ncaa
sol	sol
galinga	heavy
galinga	powerful
muilo	soap
gebėjimą	ability
milteliai	powder
smūgį	bounty
maja	maya
sieti	bind
karšto	hot
vermachto	wehrmacht
pozicijose	headings
garnys	heron
kūdikis	baby
tyla	silence
shorea	shorea
stebi	watching
priverčia	forcing
sudegintas	burnt
stovėjimo	parking
asteroidas	asteroid
vienodas	uniform
bela	bela
kamčiatkos	kamchatka
įrenginio	installation
horizontaliai	horizontal
gražus	nice
gražus	handsome
adrian	adrian
chanatas	khanate
vietovardžių	gazetteer
ietis	spear
cerro	cerro
šiltas	warm
čaikovskis	tchaikovsky
rafael	rafael
vice	vice
skurdo	lice
šeimininkė	hostess
jausmai	feelings
eazy	eazy
romanus	novels
nuostoliai	losses
mažuma	minority
devintojo	ninth
slopina	inhibits
rankraštis	manuscript
fergie	fergie
siksto	sistine
schmidt	schmidt
ksk	ksk
neoficialus	unofficial
neoficialus	informal
vakaras	evening
būsto	dwelling
valanda	hour
kvalifikacija	qualification
riko	rico
ciklai	cycles
turistai	tourist
turistai	tourists
batoras	báthory
col	col
internetas	internet
tuvalu	tuvalu
sutrukdė	interfered
sebastianas	sebastian
osaka	osaka
laimė	happiness
tito	tito
patikėtinis	trustee
lydymosi	melting
orda	horde
dažai	colours
dažai	paints
dažai	dye
dažai	paint
orlaivis	aircraft
atnaujinimo	renewal
lydi	accompanies
mainai	exchange
petah	petah
unikali	unique
kaupiasi	accumulate
užsieniečių	foreigners
princesės	princess
skrenda	flies
skrenda	flying
supratimas	perception
supratimas	understanding
miltai	flour
miltai	meal
miltai	powder
lankytojai	visitors
kalviai	blacksmiths
statybininkų	builders
žurnalistai	journalist
guru	guru
federico	federico
neabejotinai	undoubtedly
uždegimo	ignition
krūties	breast
airways	airways
ara	ara
techno	techno
nord	nord
depresijos	depressive
sale	sally
alka	alka
invazija	invasion
roll	roll
vairuotojo	driver
reikalavimas	requirement
corpus	corpus
vaikui	child
nosis	nasal
nosis	nose
dėžė	box
visumą	disciplines
transliuotojas	broadcaster
disidentas	dissident
sporte	tracked
kirvis	axe
ulrich	ulrich
tvoros	fences
tvoros	fence
vikingai	vikings
armėnai	armenians
delegacija	delegation
boto	boto
esančiuose	crosses
pedagogai	educators
juosmens	lap
juosmens	waist
juosmens	lumbar
atleido	kicked
polo	polo
atliktų	guilty
atliktų	misunderstood
katalikybė	catholicism
alain	alain
inžinieriai	engineering
inžinieriai	engineers
dekoratyviniai	decorative
dekoratyviniai	ornamental
įrašymo	recording
šuolių	leaps
fontanas	fountain
karaliene	queen
pristatymo	delivery
uleb	uleb
vėlai	late
lubos	ceilings
ivanovas	ivanov
juostelė	stripe
žarna	hose
pusiausvyrą	equilibrium
sekta	sect
pritraukti	attract
magnus	magnus
privilegijos	privileges
savanų	savanes
diagnostikos	diagnostic
ekspertai	experts
klipą	clips
kampai	angles
kavalerija	cavalry
įdiegta	installed
lytis	gender
lytis	sex
amžinai	forever
konservatoriai	conservatives
andre	andre
išversti	translated
išversti	translate
tailandas	thailand
din	din
medžioti	hunt
medžioti	hunting
sūnėnas	nephew
užduotys	tasks
kliūtis	obstacles
kliūtis	obstacle
kliūtis	barrier
pano	pano
tirpsta	melts
tirpsta	soluble
zenit	zenit
srautų	spine
tragedijos	tragedy
mėgėjai	amateurs
šildymo	heating
šildymo	warming
bla	blah
hektarų	hectares
hektarų	acres
etruskų	etruscan
varchar	varchar
imtynininkas	wrestler
misionieriai	missionaries
trimitas	trumpet
mongolija	mongolia
dvyniai	twins
sunkvežimių	trucks
žingsniai	steps
mišinio	mixes
suprojektuotas	designed
ginčai	disputes
ginčai	dispute
diecezija	diocese
kilometrai	kilometres
kilometrai	kilometers
odense	odense
išplėsta	enlarged
eur	ktm
šakelių	twigs
tobago	tobago
klevų	maple
sklypas	parcel
baublys	bittern
pramogos	entertainment
katalonijos	catalonia
pornografijos	pornography
srovių	currents
rasos	dew
tuščias	blank
bombų	bombs
deutschen	deutschen
epizodai	episodes
jordanijos	jordan
montavimo	mounting
keliautojai	travellers
betula	betula
deimantų	diamonds
kambodžos	cambodia
draugus	friends
atributas	attribute
susijungimo	reunification
botvinikas	botvinnik
dozės	dosage
čiukčių	chukchi
apšvietimo	illumination
apšvietimo	lighting
mil	mil
laivyba	shipping
kirovo	kirov
eksperimentas	experiment
sutikimo	consent
singles	singles
modeliavimas	modeling
modeliavimas	simulations
modeliavimas	modelling
modeliavimas	simulation
skalūnų	slate
skalūnų	shale
paskelbia	publish
tarša	pollution
tarša	contamination
mia	mia
maorių	maori
keleivinis	passenger
rūgštys	acids
neris	neris
atsparus	resistant
kordiljera	occidental
ilona	ilona
pak	pak
kortelės	card
pareigybės	posts
liudmila	ludmila
išdėstymas	layout
išdėstymas	arrangement
gyvsidabrio	mercury
studio	studio
jelena	jelena
garcía	garcía
maršrutų	routes
angelai	angels
limfocitų	lymphocytes
ligue	ligue
papūga	parrot
deni	dennis
ramiai	steady
ramiai	chill
lama	lama
flash	flash
liežuvio	tongue
minkštas	soft
sava	sava
pirkimo	purchases
pirkimo	purchasing
pirkimo	purchase
vamzdžių	tube
atodangos	exhumed
džersio	jersey
meteorologijos	meteorological
dana	dana
dėžės	crates
dėžės	boxes
cohen	cohen
pakviesta	invited
dviratininkas	cyclist
ethnologue	ethnologue
susidūrimo	collision
fabaceae	fabaceae
kenijoje	kenya
filialai	branches
turkiją	turkey
neuronų	neurons
josef	josef
prieinamas	affordable
ispaniškai	spanish
bona	bona
perteklius	surplus
ada	ada
triukšmo	noise
vaistas	medicine
raitelis	rider
baras	barr
stiklas	glass
krišna	krishna
kate	kate
disciplinos	discipline
disciplinos	disciplinary
kavinė	café
augusta	augusta
alina	alina
evans	evans
avarija	accident
modeliavimo	modelling
arklys	horse
tiesus	straight
lizdas	slot
lizdas	nest
lizdas	socket
fulbių	fula
kakavos	cocoa
emyratas	emirate
gvianos	guiana
malonaus	pleasant
kantonai	cantons
įamžinti	perpetuate
diskai	disc
diskai	discs
kiemo	yard
kiemo	patio
teroro	terror
maris	maris
koordinuoti	coordinate
koordinuoti	coordinated
priedų	additives
kakadu	cockatoo
baterija	battery
anglo	anglo
medžiotojas	hunter
strategiškai	strategically
naciai	nazis
degtinės	vodka
ministerijų	ministries
keleivis	passenger
dozė	dosage
dozė	dose
tomsko	tomsk
werder	werder
acta	acta
griuvėsių	rubble
liepsna	flame
saratovo	saratov
rosso	rosso
puiki	great
puiki	excellent
tomis	tommy
alavo	tin
rykliai	sharks
rykliai	shark
kaurė	tigris
kramnikas	kramnik
anemija	anaemia
bolton	bolton
afganistanas	afghanistan
gražuolė	beauty
vulka	wólka
klaudijus	claudius
cyprinidae	cyprinidae
tikva	tikva
schemos	diagrams
juostelės	strip
uganda	uganda
ūkas	nebula
siamo	siamese
daugintis	multiply
atsitraukti	retreat
moreno	moreno
kfc	kfc
žyniai	priesthood
nuskendo	sunk
nuskendo	drowned
citrinos	lemon
citrinos	lemons
padangos	tyres
padangos	tyre
kontroliuojama	controlled
įrodymai	documentation
įrodymai	evidence
navikas	tumour
klientas	client
malda	prayer
visko	everything
kordiljeros	cordillera
rodríguez	rodríguez
baikalo	baikal
torres	torres
archyvai	archives
buveinių	habitat
fantastika	senator
fantastika	fantastic
fantastika	fiction
referendumas	referendum
atkarpos	coupon
uniformos	uniforms
sviesto	butter
sevilijos	seville
pet	pet
bendravimas	communicating
bokštelis	turret
leopoldo	leopoldo
cukrų	sugars
aparatai	apparatus
hugh	hugh
administratoriai	administrators
administratoriai	admins
ubuntu	ubuntu
tbilisio	tbilisi
kortelė	card
blason	blason
įgyvendinimas	implementation
parduotuvėje	shop
meile	love
alėjos	alley
mena	mena
krūmynai	scrub
žvalgyba	exploration
viačeslavas	vyacheslav
wikimapia	wikimapia
domenico	domenico
žaizdos	wound
žaizdos	wounds
galina	galina
inžinerija	engineering
kreolų	creole
erika	erica
erika	erika
ginčas	dispute
wikipedias	wikipedias
požemio	dungeon
diagnostika	diagnostic
diagnostika	diagnosis
diagnostika	diagnostics
sturm	sturm
prabangos	luxury
pristatymas	delivery
pristatymas	deliveries
institutų	institutes
aprašymai	stories
aprašymai	descriptions
vulgaris	vulgaris
naujiena	fantastic
sklaidos	dissemination
abchazijos	abkhazia
trinidadas	trinidad
futbolininkai	footballers
profesijos	professions
nerija	spit
filosofai	philosophers
gerklės	throat
žala	injury
žala	damage
ausis	ears
derlingos	fertile
kamerūnas	cameroon
mon	mon
šoka	dances
šoka	dancing
orinoko	orinoco
corydoras	corydoras
eye	eye
juodkalnijoje	montenegro
juodkalnijoje	montenegrin
rossi	rossi
garbė	honour
garbė	honor
garbė	glory
pilkšvai	greyish
rūko	mist
rūko	smokes
uzbekų	uzbek
hokaido	hokkaido
toledo	toledo
dėvėti	wear
dėvėti	worn
viksva	carex
ich	ich
egiptiečiai	egyptians
derinys	shortcut
derinys	combination
stačiakampis	rectangular
sovietai	soviets
šikšnosparniai	bats
apsiginti	defend
beržas	pendula
bryan	bryan
hausų	hausa
fc}}	fc}}
nagų	nail
hana	hanna
murmansko	murmansk
džiunglės	jungle
krakmolo	starch
aleksandr	aleksandr
išties	really
morfologija	morphology
prunus	prunus
trenerių	coaches
siūlomas	proposed
iberijos	iberian
atneša	brings
spygliai	thorns
nelaimės	disaster
čiulpų	marrow
emigracijos	emigration
emigracijos	immigration
unguriai	eels
detektyvas	detective
antoni	antoni
žemaitija	samogitia
trance	trance
skulptorių	sculptors
sportui	sport
urban	urban
draugystė	friendship
piero	piero
reitingai	ratings
benito	benito
trylika	thirteen
reperis	rapper
rusia	ruthenia
diktatorius	dictator
genocidas	genocide
nelaimių	disasters
arkos	arch
batalionai	battalions
čigonai	gypsies
anglikonų	anglican
prisiekė	sworn
bild	bild
liemens	torso
vestuves	weddings
vestuves	wedding
ronaldo	ronaldo
leeds	leeds
finansinis	financial
virti	cooked
referendumo	referendum
funk	funk
baudos	penalties
baudos	fines
fišeris	fisher
karjeras	quarry
alkoholinių	alcoholic
klein	klein
patinka	likes
biatlono	biathlon
pasodino	imprisoned
formavimo	shaping
coupe	coupe
tramvajaus	tramway
plaukia	sailing
plaukia	swimming
kanjonas	canyon
evelina	evelyn
evelina	evelina
gabono	gabonese
rinkėjai	electorate
rinkėjai	chargers
ulan	ulan
kvapas	odour
kvapas	smell
kvapas	scent
burna	mouth
paverčia	converts
giminaičiai	relatives
išsaugojimo	preservation
panonijos	pannonian
nuotaika	mood
deguonis	oxygen
walker	walker
ekspedicijas	expeditions
kasybos	mining
bibliotekininkas	librarian
ragasnapis	hornbill
projektavimas	design
gandai	rumors
gandai	rumor
gandai	rumours
jorubų	yoruba
sraigtasparnis	helicopter
sraigtasparnis	chopper
eksperimentai	experiments
cukranendrių	cane
faunos	fauna
sachalino	sakhalin
karate	karate
sparnas	flaps
pakopa	tier
biologinė	biological
aptarti	discussing
fsb	fsb
sudužo	crashed
ticianas	titian
skaičiavimas	calculation
skaičiavimas	enumeration
said	saeed
patarėja	adviser
antena	antenna
rugių	rye
teorema	theorem
lūpų	lips
lūpų	lip
ernesto	ernesto
gervės	winches
ming	ming
etimologija	etymology
okinavos	okinawa
kalninė	plantain
kolega	colleague
ateivių	alien
jidiš	yiddish
inspekcija	inspectorate
geresnis	better
led	leds
nad	nad
sia	sia
uždarytos	sealed
kleopatra	cleopatra
collins	collins
kepurė	hat
hipotekos	mortgage
tina	tina
leukemija	leukaemia
pinsko	pinsk
belzo	belz
weber	weber
bilas	bill
kursko	kursk
protonų	proton
punta	punta
tarpeklis	gorge
slepiasi	hiding
moko	teaches
banda	herd
pranciška	urszula
poetai	poets
sargybinis	bodyguard
dainininkai	singers
sėdi	sitting
jogos	yoga
biblija	bible
nimfa	nymph
baden	baden
esp	esp
šokėjų	dancers
apyvartą	circulation
ament	ament
absoliutus	allowed
absoliutus	absolute
volkswagen	volkswagen
mocartas	mozart
voyager	voyager
ledi	lady
kornelijus	cornelius
ltu	ltu
misisipės	mississippi
subtropinis	subantarctic
sprintas	sprint
atkūrimas	restoration
pagarba	respect
wikitext	wikitext
riazanės	ryazan
pateikimo	submission
observatorijos	observatory
šešėlis	shadow
šešėlis	shade
išnuomotas	leased
stuburinių	vertebrate
traktorių	tractors
sėkla	seed
lempos	lamp
adele	adele
prokuratūra	prosecutor
kankinių	martyrs
nikita	nikita
spalvotas	tinted
anorthosis	anorthosis
skiriamasis	distinctive
skiriamasis	distinguishing
atmeta	rejects
bulgarai	bulgarians
trilogija	trilogy
amonio	ammonium
siauros	narrow
kazachstanas	kazakhstan
kokosų	coconut
bandymo	test
pen	pen
kraštinės	outboard
dukterinė	subsidiary
anatolijos	anatolia
imigrantai	immigrants
kasyklų	mines
ahmed	ahmed
shell	shell
tunelio	tunnel
didžiuliai	huge
kritiką	criticism
kritiką	criticisms
doom	doom
vfl	vfl
kla	tickling
klara	clara
dialektas	dialect
tundra	tundra
hanzos	hanseatic
reitingų	ratings
reitingų	rating
formuojant	framing
moto	moto
blogis	evil
violončelė	maschio
atsistatydinti	resign
juris	juris
mae	mae
paradoksas	paradox
uranas	uranium
uranas	uranus
fischer	fischer
corvette	corvette
aiškinimas	interpretation
dvigubos	dual
kenkia	damaging
frenkas	frank
batista	batista
raider	raider
andora	andorra
baker	baker
žurnalai	journals
jamaika	jamaica
lsd	lsd
apollo	apollo
kasyklose	mines
ramus	calm
bromwich	bromwich
dalai	dalai
asmeninę	personalised
šventieji	saints
garsiai	loud
receptorių	receptor
eksperimentų	experiments
intervalas	interval
ištrauka	extract
kosmetikos	cosmetic
snieglenčių	snowboard
filantropas	philanthropist
signalai	signals
alkoholis	alcohol
teen	teen
emilio	emilio
alanas	allan
ema	emma
dirbtinių	artificial
universalus	universal
antoine	antoine
chartija	charter
saga	saga
gavimo	receive
paskolos	loan
paskolos	loans
teutonų	teutonic
stambule	istanbul
albanai	albanians
miltelių	dope
erich	erich
streep	streep
itunes	itunes
tabu	taboo
wwe	wwe
pinakoteka	brera
atšaukti	undo
komikas	comedian
albanijoje	albania
piengrybis	lactarius
protestai	protests
protestai	objections
rimtas	serious
indiana	indiana
diagrama	diagram
diagrama	chart
labui	pleasure
tigras	tiger
įdiegti	installed
gautą	derived
apšvietimas	illumination
apšvietimas	lighting
orientuotas	wallonia
rosberg	rosberg
ramos	ramos
įdomus	interesting
eismas	traffic
vadovus	guides
infrastruktūrą	infrastructure
kreivės	plot
kreivės	curves
partizani	partizani
imigracijos	immigration
bahr	bahr
kali	kali
luna	luna
epidemija	epidemic
keršto	vengeance
keršto	revenge
keršto	retaliation
jenisiejaus	yenisei
gaisrų	fires
apribojimai	restrictions
apribojimai	constraints
finansavimas	financing
aristotelis	aristotle
michele	michele
klanai	clans
žvėris	beast
albrecht	albrecht
patogu	comfy
patogu	comfortable
bartos	bartos
pusiausvyra	equilibrium
lig	lig
vorai	spiders
laikotarpius	periods
vertas	worthy
prieglauda	sanctuary
abraham	abraham
hanoverio	hannover
remtis	invoke
igor	igor
kiškiai	hares
morissette	morissette
piligrimų	pilgrimage
dick	dicks
viktoria	viktoria
anders	anders
tamsi	dark
martín	martín
teisininkai	lawyers
naktys	nights
odisėjas	odysseus
jessica	jessica
skyrybų	divorce
maišto	rebellion
karen	karen
kostiumai	costumes
laukiniai	wild
lūžis	fracture
ritualai	rituals
sinajaus	sinai
seb	seb
virusų	viruses
tonga	tonga
diskusija	discussion
porceliano	porcelain
junior	junior
dialektai	dialects
frusciante	frusciante
emocijas	emotions
burton	burton
palankios	favourable
varžovą	contender
policininkai	cops
valtis	boat
išmestas	emitted
išmestas	expelled
grindys	flooring
grindys	floor
rimtų	serious
sujungia	connects
nubijos	nuba
specializacija	specialisation
mechaninė	mechanical
pakto	pact
klasika	classics
ala	ala
stebėjimas	monitoring
stebėjimas	observation
restoranai	restaurants
rodiklį	diversification
grožis	beauty
dalintis	sharing
dalintis	share
hidroelektrinių	hydroelectric
nubausti	punish
nubausti	punished
tatrų	tatra
#dfdfdf	#dfdfdf
atspalvių	shades
regentas	regent
jūrinė	marine
priešistorė	prehistory
griežta	rigorous
liang	liang
integruoti	integrating
sausos	dry
eintracht	eintracht
vedėjai	moderator
limfomos	lymphoma
pardavimas	sales
daugiafunkcis	multifunctional
stoke	stoke
kubą	cube
vektorius	vector
tiekimas	supply
indus	indus
sunaikinimo	breakdown
mara	mara
myli	loves
sandėliai	warehouse
sandėliai	warehouses
tendencija	trend
įsitikinęs	convinced
išradimas	invention
gripo	influenza
ryklys	shark
saugykla	repository
nsdap	nsdap
bananų	banana
bananų	bananas
karšta	hot
tamsus	dark
mineralai	minerals
kūdikiai	infants
kūdikiai	infant
kūdikiai	babies
beringo	bering
wilno	wilno
regencija	regency
geologija	geology
rašybos	spelling
kenčia	suffer
mtk	mtk
legia	legia
eco	eco
persija	persia
mutacijos	mutations
pažeidimai	infringements
ūkiuose	holdings
tiekėjai	suppliers
explorer	explorer
elnio	reindeer
teta	auntie
teta	aunt
kde	kde
čečėnijos	chechen
skiriamieji	distinctive
fiziologija	physiology
sesijos	sessions
naikina	destroying
naikina	destroys
kenija	kenya
finansai	finance
finansai	finances
tps	tps
dino	dino
fermentacijos	fermentation
flickr	flickr
automatinė	auto
radomo	radom
rankinis	manual
frazė	phrase
dorpato	dorpat
antspaudas	stamp
mustang	mustang
zodiako	zodiac
žvaigždutės	sprockets
antonis	antonis
sinonimas	synonymous
sinonimas	synonym
zeppelin	zeppelin
tarnas	servant
ruonių	seal
ruonių	seals
derlius	crops
derlius	harvested
derlius	harvesting
šarvuotis	armadillo
batų	shoes
batų	shoe
kostiumus	costumes
akademinių	academic
daiktavardžiai	nouns
maumedis	larch
valdančioji	governing
prieškario	runciman
atašė	attaché
antys	ducks
boro	boron
saab	saab
atradimų	discoveries
sviestas	butter
kapsulė	capsule
leicester	leicester
skristi	fly
leninas	lenin
geo	geo
užsieniečiai	foreigners
klebonijos	rectory
mugės	fairs
gintis	defend
dalyvaujančios	participating
pakelia	lifts
ąsotenis	albomarginata
svetainių	websites
pralaimėjimų	setbacks
šoninis	lateral
kartografas	cartographer
dresden	dresden
portsmouth	portsmouth
gelfandas	gelfand
kasamas	mined
atsiimti	withdraw
peiliai	knives
dali	dali
pupelių	bean
pupelių	beans
spaudžiant	pressing
ožkų	goats
ožkų	goat
kabelių	cable
sega	sega
baltymas	protein
floros	flora
mylėjo	loved
miežiai	barley
kiras	gull
terra	terra
navikų	tumours
atkuriamojo	restorative
komninas	trebizond
reaktorių	reactors
morris	morris
als	als
populiacijų	populations
spartakas	spartacus
ralph	ralph
aistra	passion
lau	lau
pumpurai	buds
aramėjų	aramaic
città	città
neutronų	neutron
įrengimai	installations
atostogos	vacation
laskeris	lasker
estetika	aesthetics
saksofonas	saxophone
jachta	yacht
liepsnos	flame
liepsnos	flames
reikmenys	accessories
aerodromo	aerodrome
katastrofa	disaster
katastrofa	catastrophe
kakava	cocoa
kataras	qatar
danai	danes
antropologija	anthropology
konsultavimo	consultancy
colin	colin
prognozė	prognosis
prognozė	prediction
heinz	heinz
valentino	valentino
gėrimus	liquor
gėrimus	booze
gili	deep
intensyvi	intense
surinktos	assembled
atsargiai	carefully
atsargiai	careful
agentai	agents
claudio	claudio
griežtas	strict
griežtas	string
urbino	urbino
sabonis	sabonis
jena	jena
šeichas	sheikh
derrida	derrida
heep	heep
priemaišų	impurities
bliuzo	blues
kaukės	masks
lėtinė	chronic
