kaukė	mask
dzin	ding
dzin	jin
šautuvą	shotgun
šautuvą	rifle
nuodai	poison
pigmentas	pigment
kviečia	invites
lópez	lópez
marilyn	marilyn
dubline	dublin
jules	jules
bloga	bad
laikotarpiai	periods
kaltinimai	accusations
generatorius	generator
rex	rex
tiraspol	tiraspol
repertuarą	repertoire
keista	weird
keista	strange
granados	granados
gerhard	gerhard
diskusijas	discussions
diskusijas	debates
spencer	spencer
dre	dre
kazino	casinos
kazino	casino
prieiga	accessibility
leidėjai	publishers
pleistoceno	pleistocene
lango	window
mazda	mazda
mokomųjų	tertiary
tereza	tereza
pučia	blows
superlyga	superliga
poaceae	poaceae
virusai	viruses
valgo	eats
paskirstymo	distribution
kovinė	militia
prov	prov
klinikų	clinics
argumentai	arguments
sie	sie
paulina	pauline
lovos	beds
lovos	bed
larisa	larissa
singapūras	singapore
spora	spore
bobas	bob
zanzibaro	zanzibar
lava	lava
pranašas	prophet
užtaisas	cartridge
tyčia	deliberately
tyčia	intentionally
tunise	tunisia
ansambliai	ensembles
obligacijos	bonds
išnykimas	extinction
saugyklos	repository
kurorto	entertainer
intensyvus	intense
purvo	mud
chan	chan
pietūs	lunch
riebalai	fats
riebalai	fat
beerschot	beerschot
gerard	gerard
gestapo	gestapo
obligacijų	bond
obligacijų	bonds
atakamos	atacama
koch	koch
humanitarinės	humanitarian
cha	cha
derinti	combine
ištikimas	loyal
ištikimas	faithful
sustiprina	reinforces
markgrafas	margrave
kooperatyvų	cooperatives
solidarumo	solidarity
citroën	citroën
litoria	litoria
azovo	azov
wallace	wallace
fernández	fernández
besiktas	besiktas
svečias	guest
šventa	sacred
pakartojo	reiterated
beitar	beitar
veto	veto
salono	cabin
paliaubas	truce
muchafazos	governorates
dramblys	elephant
atnaujinimas	upgrade
atnaujinimas	updating
atnaujinimas	renewal
murray	murray
robur	robur
lvovas	lvov
notre	notre
nižnij	nizhny
veši	thrives
fame	fame
mokymai	training
fff	fff
jungo	yoke
ruta	ruta
tėtis	daddy
gibraltaro	gibraltar
atsisakymas	refusal
sanitarijos	sanitation
dėžutės	boxes
watson	watson
girondins	girondins
žibintai	lamps
ata	ata
obuoliai	apples
larix	larix
vilna	wool
metis	metis
libanas	lebanon
sebastiano	sebastiano
allmusic	allmusic
specializuotos	specialized
šarlotė	charlotte
aberdeen	aberdeen
khan	khan
metacritic	metacritic
fenomenas	phenomenal
kanapių	hemp
valparaiso	valparaíso
sriuba	soup
stari	stary
tyrėjai	researchers
tyrėjai	investigators
keliaujant	travelling
pussycat	pussycat
pakilimas	uplift
apdoroti	handles
rožės	roses
himalajuose	himalayas
seminarai	seminars
dirbtinė	imitation
dirbtinė	artificial
svetlana	svetlana
volta	volta
nuosėdų	sediment
kadras	shot
auflage	auflage
emocijos	emotion
emocijos	emotions
noir	noir
bmp	bmp
donaldas	donald
sveikatingumo	wellness
senienų	antiquities
rolando	rolando
vygandas	wiegand
vasas	vasas
sai	sai
jutlandijos	jutland
sraigtasparniai	helicopters
išmesti	throw
išmesti	dump
izoliuota	insulated
izoliuota	isolated
palengvina	facilitates
komentarų	comment
atomas	atom
butelius	bottles
magadano	magadan
alanis	alanis
auditorijai	audiences
vicente	vicente
amc	amc
swift	swift
musa	musa
ina	ina
žmonija	humanity
bielskis	bielski
vamzdžiai	tops
gsub	gsub
aukomis	sacrifice
slap	slap
umberto	umberto
ilsisi	chilling
olandas	dutchman
integruota	integrated
ramat	ramat
blair	blair
sojos	soya
harmonija	harmony
kultury	kultury
pabaisa	monster
hbo	hbo
idealus	ideals
idealus	ideal
elo	elo
spice	spice
jakovas	yakov
turimas	ranks
haka	haka
renovuotas	renovated
įgūdžiai	skills
įgūdžiai	skill
isaac	isaac
civiliai	civilians
dnb	dnb
patarimai	advice
elektroniniai	electronic
komplikacijų	complications
jacopo	jacopo
aerodrome	aerodrome
bang	bang
hidejoši	hideyoshi
čen	chen
hertha	hertha
neveikia	inoperative
chi	chi
įdomi	exciting
lla	lla
variacijos	variation
ted	ted
požeminis	underground
rekomendacijos	recommendations
tonis	tony
fryzų	frisian
astana	astana
marškinėliai	shirt
genadijus	gennady
gto	gto
rėmėjai	sponsors
gerbiamas	esteemed
savižudybės	suicide
prigimtis	nature
iškovota	caesars
sintezę	synthesis
wojciech	wojciech
sakalai	falcons
spinduliavimas	radiation
bankininkystė	banking
dangoraižis	skyscraper
kriauklės	sinks
kriauklės	shells
skilimas	decomposition
skilimas	degradation
publius	publius
katilas	boiler
ilgalaikio	durable
apsupti	surrounded
apsupti	surround
jemenas	yemen
neteisėtai	illegally
barbarų	barbarian
australis	australis
avarų	avar
suvokiama	perceived
aleksandrija	alexandria
sraigės	snails
xxx	xxx
telefonas	phone
telefonas	telephone
heseno	hessen
hello	hello
ilyrijos	illyrian
jakob	jakob
enzo	enzo
gilbert	gilbert
akcininkas	shareholder
atsakymą	reply
chemoterapija	chemotherapy
obeliskas	obelisk
brahma	brahma
miežių	barley
tramvajų	tram
kelnės	pants
kelnės	trousers
seilių	saliva
hradec	hradec
veiksmažodžių	verbs
bmx	bmx
evangelija	gospel
bombonešis	bomber
moro	moro
uma	uma
integracija	integration
jautrumas	tenderness
jautrumas	sensitivity
mohammed	mohammed
švelniai	softly
švelniai	gently
singapūre	singapore
liekana	residue
skatinimo	promotion
skatinimo	promotional
javier	javier
oromo	oromo
teroristų	terrorist
neįprastai	unusually
lygybė	equality
dulkės	dust
vsevolodas	vsevolod
gotai	goths
dogg	dogg
dukla	dukla
sutarta	agreed
dirvožemis	soil
cholesterolio	cholesterol
artėja	approaching
uždraustos	banned
sekmadieniais	sundays
patologijos	pathology
nigra	nigra
julio	julio
niko	niko
demonas	demon
giacomo	giacomo
pūnų	punic
kapsulės	capsule
kapsulės	capsules
rolę	godmother
halės	halle
hormonas	hormone
mai	mai
ruzveltas	roosevelt
šalmai	helmets
plienas	steel
skeletas	skeleton
atsparumas	resistance
batai	shoes
batai	boots
civilizaciją	civilization
veidrodis	mirror
trofėjus	trophy
specializuotas	specialized
lygu	equals
konkurentų	competitors
anas	anas
paruošimo	reconstitution
formavimas	formation
apdaila	finishing
avn	avn
žole	grass
ustring	ustring
alenas	allen
heidelbergo	heidelberg
mechaniškai	mechanically
timo	timo
įstrižai	diagonal
paauglystėje	adolescence
diržo	belt
pirmininkavo	chaired
lena	lena
mata	mata
daktarai	doctors
ištrinti	erase
ištrinti	delete
žandarmerijos	gendarmerie
tui	fdi
tui	tui
vaikinai	guys
med	med
antgaliai	nozzles
gimnastika	gymnastics
surašymų	censuses
ibrahim	ibrahim
liežuvis	tongue
mann	mann
ribentropo	ribbentrop
beatričė	beatrix
nupirkti	purchased
sekmadienio	sunday
valle	valle
gauso	gaussian
reičel	rachel
voverė	squirrel
profesionalai	professionals
nora	nora
hormonai	hormone
joshua	joshua
patenkintas	satisfied
haag	haag
geneve	geneve
protektoratas	protectorate
hensley	hensley
investuotojų	investor
investuotojų	investors
jordanija	jordan
hera	hera
atkrintamąsias	playoffs
trikampiai	triangular
trikampiai	triangles
profesijų	professions
profesijų	occupations
petru	petru
apdailos	finishing
rezultatyviausiu	scorer
andrés	andrés
garai	steam
garai	vapour
jelgava	jelgava
suzuki	suzuki
gineso	guinness
sekretoriato	secretariat
talentas	talent
melodijų	tunes
iškasti	digging
clarke	clarke
kardinolai	cardinals
botev	botev
mare	mare
piktų	worldly
draudžiamas	prohibited
pamyro	pamir
kasama	kasama
likviduota	liquidated
tikėta	resurrects
bendrabutis	hostel
interscope	interscope
amber	amber
tre	tre
lazerio	laser
pokalbiai	conversations
energetika	energy
rudar	rudar
žinant	knowing
voldemortas	voldemort
grąžinimo	repayment
gilberto	gilberto
stemplės	oesophageal
bnei	bnei
informuoti	informed
peizažo	scenery
bizkit	bizkit
nottingham	nottingham
transformacija	transformation
transformacija	transform
geometrija	geometry
geometrija	geometric
branduolinis	nuclear
klinikoje	clinic
investuoti	invest
matrica	matrix
bohemians	bohemians
stavropolio	stavropol
btv	btv
anastasija	anastasia
žygiavo	marched
semionas	semyon
sapnai	dreams
kaltino	blamed
kirilica	cyrillic
gerina	improves
nicola	nicola
mechaninis	mechanical
mielių	yeasts
mielių	yeast
nuosmukis	recession
pakrikštytas	baptized
przemysław	przemysław
herman	herman
įkalinimo	imprisonment
drambliai	elephants
leonė	leone
geometrijos	geometry
rokoko	rococo
anglys	coal
tekėjo	flowed
irma	irma
klr	prc
sirupas	syrup
liaudis	folk
santuokų	marriages
konrad	konrad
che	che
rūkymas	smoking
sąmokslo	conspiracy
paklusti	obey
pėdomis	footsteps
limp	limp
stebėjimai	observations
stebėjimai	observation
nurodymai	instructions
bundesarchiv	bundesarchiv
pieva	meadow
biala	biała
powell	powell
pasaulietinės	secular
japonica	japonica
orlaiviai	aircraft
privatizavimo	privatisation
įvaizdžio	perfection
tikslios	accurate
drėkinimo	irrigation
genai	genes
bolivaro	bolivarian
šieno	hay
galingų	mighty
nissan	nissan
baptiste	baptiste
xxiii	xxiii
nervai	nerves
nėščia	pregnant
tostring	tostring
tomė	tomé
euras	euro
tomasz	tomasz
atsistatydinimo	resignation
švyturio	lighthouse
susitarimai	arrangements
susitarimai	agreements
sunkvežimis	truck
sunkvežimis	lorry
eto	eto
kalifatas	caliphate
genesis	genesis
drėgnumas	moisture
drėgnumas	humidity
genetiniai	genetic
kenneth	kenneth
okupuotoje	occupied
ism	ism
programuotojas	developer
skandalas	scandal
moll	moll
vertinga	enriching
vertinga	valuable
kapitolijaus	capitol
ayat	ayat
audrų	storms
laiptų	stairs
dekoruoti	decorate
poniatovskis	poniatowski
garsiu	agitator
vežimo	wagon
jaroslavlio	yaroslavl
sionistų	zionist
fermentai	enzymes
levinas	levin
susidūrimas	collision
navbox	navbox
mažylis	baby
jeep	jeep
kalė	bitch
vėžiagyvių	shellfish
skundas	appeal
snoop	snoop
kritiškai	critically
kieno	whose
geograph	geograph
astronomai	astronomers
jovita	jovita
pagrobti	kidnap
kaštonų	chestnut
kompleksų	complexes
fulham	fulham
butas	apartment
tarpininkas	intermediary
tarpininkas	facilitator
iliustratorius	illustrator
sauga	safety
kepler	kepler
ožys	goat
pokalbis	conversation
stabilizatorius	stabiliser
stabilizatorius	stabilising
morta	morta
kaktos	brow
kompetencija	competences
servette	servette
aufl	aufl
tiekėjas	supplier
atidėti	defer
atidėti	postpone
štirijos	styria
pėstininkas	pawn
kano	kann
kvarco	quartz
šopeno	chopin
endriu	andrew
poznanėje	poznań
bendrieji	general
samdiniai	mercenaries
jahija	yahya
tao	tao
gėjų	gay
kurdistano	kurdistan
rašant	writing
chromo	chromium
kostiumas	suit
pirkėjų	purchasers
firefox	firefox
uriah	uriah
hablo	hubble
lježo	liège
kirpėjas	hairdresser
naviko	tumour
cirkas	circus
gorkis	gorky
sąskaitos	billing
bsd	bsd
nusikaltėlis	perpetrator
nusikaltėlis	offender
kriaušės	pear
kriaušės	pears
jautrus	sensitive
dominuoti	dominate
papėdėse	foothills
skola	debt
pusmėnulio	crescent
chuck	chuck
senelė	grandmother
koncertmeisteris	concertmaster
laisves	freedoms
opel	opel
derry	derry
sprogmenų	explosive
švęsti	celebrate
lašišos	salmon
fussballdaten	fussballdaten
rankraščiai	manuscripts
samanos	mosses
alyvos	barrel
alyvos	oils
kamieninių	stem
lingė	harrier
bilis	billy
vsc	vsc
hibernian	hibernian
vyšnios	cherry
vyšnios	cherries
verona	verona
eng	eng
nematomas	invisible
ssc	ssc
kėdės	chairs
kėdės	chair
įspūdingas	impressive
greita	quick
greita	fast
paaiškinimas	explanation
fortuna	fortuna
jungtys	interfaces
jungtys	connectors
jungtys	conjunctions
nedarbas	unemployment
akira	akira
sruogos	strands
disertacija	dissertation
idol	idol
katalogo	catalogue
altas	sax
verslininkai	entrepreneurs
sukilimus	uprisings
gao	gao
opus	opus
agresijos	aggression
bonifacas	boniface
prostatos	prostate
joão	joão
bonus	bonus
electro	electro
balansas	balance
barškuolė	rattlesnake
samsung	samsung
plytos	bricks
nykstančių	endangered
faktais	guaranteed
idris	idris
miega	asleep
miega	sleeps
miega	sleeping
tiuringijos	thuringia
naikinimas	crush
naikinimas	depopulation
siekius	aspirations
eminem	eminem
šiitų	shia
bradley	bradley
metisai	mestizo
profesionaliai	professionally
tyrėjų	detectives
tikrovė	reality
griežti	strict
griežti	hardcore
onkologijos	oncology
kirilas	kirill
horizontali	horizontal
griovių	ditches
drausmės	disciplinary
jerome	jerome
originalas	pirates
mori	mori
aliochinas	alekhine
cao	cao
įvartis	blink
koordinavimo	coordination
koordinavimo	coordinating
porai	leek
stiprina	amplifier
stiprina	strengthens
šiukšlių	garbage
šiukšlių	rubbish
prisiminti	remembering
prisiminti	remember
konsultacijų	consultations
konsultacijų	consultation
jure	jure
dingsta	disappears
dingsta	disappear
kilme	origin
pipirai	pepper
sekmadienis	sunday
alisa	alice
zagora	zagora
šiltos	warm
buto	apartment
būtinybė	necessity
sundos	sunda
laimėjimai	achievements
marse	marcy
bušas	bush
sochaux	sochaux
dao	dao
vankuverio	vancouver
realybė	reality
tobias	tobias
auguste	auguste
rojas	rojas
rowling	rowling
libertadores	libertadores
lankai	bows
blakės	heteroptera
gražu	beautiful
gražu	nice
plaučius	lungs
conus	conus
mustafa	mustafa
demonstracijos	demonstrations
livonija	livonia
matavimai	measurements
matavimai	measurement
pečioros	pechora
dumbliai	algae
janos	janos
uraganas	hurricane
treniruotis	spar
gridcolor	gridcolor
ska	ska
mstislavas	mstislav
delavero	delaware
suopis	buzzard
dalmatijos	dalmatian
birkirkara	birkirkara
drabužis	garment
stipendijos	grants
stipendijos	scholarships
spektras	spectrum
wikidata	wikidata
nino	nino
gobio	gobi
nuosprendis	verdict
okb	okb
hemoglobino	haemoglobin
robertson	robertson
judas	judas
žiurkė	rat
tešla	dough
arterijų	arterial
arterijų	arteries
tuščia	blank
baladė	ballad
transformacijos	transformation
pardavėjas	trader
pardavėjas	seller
pabėgėliai	refugee
pabėgėliai	refugees
keistas	weird
keistas	strange
lingua	lingua
mafija	mob
mafija	mafia
ertmėje	cavity
specializuotų	specialised
rifai	reefs
gazos	gaza
endeminių	endemic
patiekalus	dishes
ūmėdė	russula
vėliavas	banners
klesti	thriving
dora	dora
skystas	liquid
achilo	achilles
alyvuogių	olives
ciklų	cycles
wrocław	wrocław
smithsonian	smithsonian
leben	leben
ekologinė	ecological
pranešimo	notification
tyliai	quietly
tyliai	quiet
vandalai	vandals
porter	porter
discogs	discogs
buteo	buteo
šviesi	bright
tiekėjų	suppliers
sligo	sligo
delle	delle
patogiau	comfortable
padažas	sauce
pliki	baldy
potencialiai	potentially
ign	ign
receptorius	receptor
tonos	tonnes
neigia	denies
zylė	tit
esbo	osce
amour	amour
staigus	sharp
šlovė	hail
žavėjosi	admired
sviedinys	cannonball
cole	cole
proporcingas	proportional
polydor	polydor
patobulinta	upgraded
lgbt	lgbt
levadia	levadia
vadove	guide
madam	madame
ritualas	ritual
estai	estonians
fabio	fabio
palestiniečių	palestinians
balsis	vowel
įsivaizduoti	imagined
revoliucinė	revolutionary
grunge	grunge
poseidonas	poseidon
clarkson	clarkson
sklypų	plots
sklypų	parcels
rosenborg	rosenborg
krizių	crises
triumfavo	prevailed
cellpadding	cellpadding
maximus	maximus
moliuskai	molluscs
kolegos	colleagues
pokalbio	conversation
asirija	assyria
vakar	yesterday
violetinė	purple
oliveira	oliveira
aparatūra	apparatus
akvariumas	aquarium
oksidacijos	oxidation
atari	atari
pokerio	poker
remiama	sponsored
chamberlain	chamberlain
skliaustuose	brackets
blokavimo	blocking
sorbų	sorbian
esminė	critical
jaguar	jaguar
troleibusų	trolleybus
lamborghini	lamborghini
dirvožemį	soil
slyvų	plum
vadi	wadi
biologiškai	biologically
biologiškai	biodegradable
aštrus	spicy
augmenijos	vegetation
turbina	turbine
paviršiai	surfaces
triukšmas	noise
elta	elta
makaronai	macaroni
optika	optics
kalifas	caliph
netinkamas	incorrect
netinkamas	invalid
amino	amino
demonai	demons
džiaugsmas	joy
višnaus	vishnu
plaukikas	swimmer
švelnios	gentle
maratonas	marathon
coleoptera	coleoptera
pirmtakai	predecessors
specializacijos	specialisation
skiemuo	syllable
mozilla	mozilla
animatorius	animator
bora	bora
teleskopo	telescope
brangi	dear
klestėjimas	prosperity
donatello	donatello
hermiona	hermione
postų	posts
robotas	robot
galingi	powerful
minerva	minerva
surinktas	assembled
sprogstamosios	explosive
atsparumo	resistance
southampton	southampton
paaukoti	donate
valyti	cleaned
styga	chord
rožinio	rosé
užtvankų	dams
starta	bunting
granada	granada
turinas	turin
diplomatinių	diplomatic
nirvana	nirvana
bandymą	experiment
braun	braun
šalmus	helmets
energijai	rising
vandeninis	aqueous
dublinas	dublin
sindarin	sindarin
udo	udo
apvalkalas	shell
barrichello	barrichello
budistai	buddhists
tikslumas	precision
tikslumas	accuracy
kremliaus	kremlin
berger	berger
elvis	elvis
vagonų	wagons
suprojektuota	designed
mokymasis	learning
blokų	blocks
svetimas	stranger
sprogsta	explodes
ger	ger
šiaudų	straw
diktatūros	dictatorships
diktatūros	dictatorship
laguna	laguna
paskiria	contact
aktyvistai	activists
komentatorius	commentator
zipcodezoo	zipcodezoo
turkmėnų	turkmen
gbif	gbif
katalonų	catalan
adis	addis
puikų	excellent
tsv	tsv
mono	mono
pagerina	improves
plėšrūnų	predators
apgyvendinimo	accommodation
vežimas	shipments
teito	teito
dumblių	algae
ursus	ursus
forum	forum
listclass	listclass
konkursai	tenders
teologija	theology
paktas	pact
paktas	wardrobes
citadelė	citadel
kaukazas	caucasus
marselio	marseille
brendan	brendan
tor	tor
nendrių	reed
kančia	suffering
kančia	torment
cinkas	zinc
norimą	desired
jūreivių	seamen
laimingas	happy
dirvinė	myosotis
kontaktas	contact
sąjungas	alliances
bismarkas	bismarck
sąsmauka	isthmus
oktavianas	octavian
gegutės	cuckoo
mileris	miller
hunai	huns
elzė	eliza
dal	dal
vakarienė	dinner
elisabeth	elisabeth
kenkėjų	pest
kenkėjų	pests
koridorius	corridors
koridorius	corridor
dunojus	danube
įkvėpti	inspire
lydiniai	alloys
milžinai	giants
charleroi	charleroi
viskio	scotch
viskio	whisky
priimtų	highlights
važiuoklės	chassis
itil	itil
kopa	kopa
dinozaurai	dinosaurs
spiritas	spirits
šeštoji	sixth
egzamino	exam
neišvengiamai	inevitably
finansiniai	financial
krantinės	quay
rūsys	cellar
sakiniai	sentences
suaugusieji	adults
suaugusieji	adult
sophia	sophia
coca	coca
konservantas	preservative
austrai	austrians
tinklinis	volleyball
battista	battista
cikas	cycas
rekomenduoja	recommends
rekomenduoja	recommend
šviesus	bright
toras	thor
incidentas	incident
dominavimo	domination
dominavimo	dominance
kaiser	kaiser
subprefektūra	subprefecture
paskirstymas	allocation
paskirstymas	breakdown
paskirstymas	distribution
tiriami	tested
moses	moses
eritrėja	eritrea
meteoritas	meteorite
ruiz	ruiz
derėtis	negotiate
niufaundlando	newfoundland
maserati	maserati
ogc	ogc
rainbow	rainbow
kontracepcijos	contraception
bangor	bangor
persekiojami	persecuted
leto	leto
beata	beata
plikas	bald
laikrodžiai	clocks
laikrodžiai	watches
krosnis	furnace
krosnis	oven
malcolm	malcolm
bmg	bmg
wordpress	wordpress
kurilų	kuril
burchard	burchard
laidumas	conductivity
butanas	butane
wow	wow
logiškai	logically
diktatūra	dictatorship
renato	renato
dancigo	danzig
owen	owen
direktoriai	directors
karcinoma	carcinoma
apyrankės	bracelets
lynn	lynn
soros	millet
seminaras	workshop
seminaras	seminar
čerčilis	churchill
draugės	friends
aortos	aortic
legionas	legion
kerštas	vengeance
kerštas	revenge
tibetas	tibet
žiemgala	semigallia
miao	miao
kalvis	blacksmith
kambodža	cambodia
drąsiai	bravely
romero	romero
tokelau	tokelau
konstantos	constants
raiteliai	riders
buitinių	household
buitinių	municipal
skylė	hole
trajektorija	trajectory
simboliškai	symbolically
kardą	sword
warcraft	warcraft
guido	guido
viskonsino	wisconsin
rimta	serious
miko	miko
socializmas	socialism
stabilus	stable
knutas	canute
nevis	nevis
pjemonto	piemonte
mesopotamija	mesopotamia
gandras	stork
netikras	fake
sapiens	sapiens
grenlandija	greenland
skaičiavimus	calculations
teo	theo
kor	kor
rodezijos	rhodesia
kaldera	caldera
kiūšiū	kyushu
gijos	threads
len	len
coloma	coloma
eduard	eduard
goda	goda
tres	tres
varškės	cottage
varškės	curd
norintiems	wishing
piper	piper
epa	epa
nerimą	alarming
nerimą	worrying
griežtą	rigorous
rogučių	sledge
skersinis	transverse
skatinimas	promotion
vulkaninė	igneous
gangsteris	gangster
hnk	hnk
astrachanės	astrakhan
sankryža	roundabout
jutos	utah
mayer	mayer
atkrintamųjų	playoff
baigtos	completed
reguliuojamas	adjustable
sunitų	sunni
aronas	aaron
antigva	antigua
įkelti	reload
cfc	cfc
cfc	cfcs
geografiniai	geographical
paša	pasha
eksperimentus	experiments
pasėlių	crop
technikai	technicians
sofi	sofi
prieštaravimų	objections
sekretoriatas	secretariat
pašalinamas	excretion
dir	dir
dumblas	sludge
saba	saba
kaupimo	sharing
slepia	hides
linijinis	linear
stogų	roofing
žvejys	fisherman
juostele	stripe
niger	niger
omega	omega
genomo	genome
jet	jet
tolo	afar
pjovimo	cutting
atlyginimas	salary
atlyginimas	salaries
atlyginimas	remuneration
soma	soma
angų	openings
sutrikimą	confusion
patarimų	advice
brangus	dear
raudų	wailing
būgnas	drum
morena	morena
puškinas	pushkin
skyrybos	divorce
nuovargis	fatigue
borgo	borgo
ofc	ofc
bethoveno	beethoven
genas	gene
vaikšto	walking
vaikšto	walks
jachtos	yachts
šeimose	inbound
vittorio	vittorio
gipso	plaster
gipso	gypsum
cenzūra	censorship
ogovės	ogooué
urdu	urdu
kroft	croft
šengeno	schengen
mega	mega
vožtuvų	valve
ūkininkavimo	farming
diplomatinis	diplomatic
lira	lira
durst	durst
palladio	palladio
minios	crowds
aik	aik
šaudo	shoots
gru	gro
guma	gum
skydliaukės	thyroid
valė	valais
manas	mane
švenčia	celebrates
katy	katy
junano	yunnan
tamsa	darkness
taičio	tahiti
hani	hani
vargas	vargas
plėšikai	robbers
toma	toma
pilsudskis	piłsudski
medikai	paramedics
apolonija	apollonia
martínez	martínez
chloridas	chloride
išlaikymo	retention
pažintis	connecting
parodija	parody
android	android
puošnioji	harlequin
virvės	rope
virvės	ropes
virvės	cords
virvės	twine
dsc	dsc
gleivių	mucus
šamanizmas	shamanism
lynai	ropes
sil	sil
camila	camila
matricos	matrix
septintoji	seventh
trąšos	fertilizer
trąšos	fertilisers
trąšos	fertilizers
trąšos	fertiliser
patikimumas	credibility
skaičiavimai	calculations
valdytojų	governors
mangrovių	mangrove
pagalbininkas	helper
milošas	milos
vhs	vhs
graf	graf
barzda	beard
priesagos	suffixes
stabdžių	brake
hahn	hahn
specializuota	specialized
blanco	blanco
vielos	wire
franciskas	francisco
hinduizmas	hinduism
atsakymai	reply
atsakymai	answers
atsakymai	replies
dviratininkų	cyclists
panaikinimas	repeal
panaikinimas	cancellation
dumblo	sludge
muitinė	customs
pranašumas	advantage
geffen	geffen
adamavos	adamawa
drake	drake
libertas	libertas
giulio	giulio
geleris	geller
vizualiai	visually
fussball	fussball
druskingumas	salinity
mėsinga	fleshy
sugriuvo	collapsed
kubica	kubica
mielės	yeasts
mielės	norman
mielės	yeast
salotos	lettuce
salotos	salads
salotos	salad
fašistų	fascist
formatavimo	formatting
fanai	fans
palmė	jumeirah
svyravimai	fluctuations
sgd	cng
šiongnu	xiongnu
dovanos	blessings
epsa	epsa
pipirų	pepper
cementas	cement
epic	epic
prekė	commodity
taro	taro
andris	andris
svarstyklės	weights
kreiseris	cruiser
zimbru	zimbru
nepatenkintas	dissatisfied
kirgizija	kyrgyzstan
gėlų	gaelic
reitingus	grades
hughes	hughes
kiurasao	curaçao
įsigijimo	acquisition
bartolomeo	bartolomeo
sietlo	seattle
thomson	thomson
sutrumpintas	shortened
rūkyti	smoked
palankus	kinder
publika	audiences
pasakotojas	narrator
atidėtas	deferred
atidėtas	postponed
aitvaras	kite
jautri	sensitive
res	res
bas	bas
feyenoord	feyenoord
pareigūnams	officials
kepenys	liver
aronianas	aronian
magnum	magnum
iškaltas	sculpted
kaltę	guilt
zil	zil
atsparumą	resistance
atsparumą	resilience
patarė	advised
patogus	comfortable
karla	karla
riaušės	riots
dažniausi	popular
stan	stan
svajonė	dream
toros	toros
karjerai	careers
minkštimas	pulp
lipai	gums
teršalų	pollutant
emigracija	emigration
lėtinis	chronic
kaltinimų	accusations
bespalvis	colourless
maestro	maestro
eden	eden
aiškinimo	interpretation
galapagų	galapagos
dub	dub
epitelio	epithelial
mišiniai	mixtures
pašalinimas	withdrawals
vaškas	waxes
vaškas	wax
kaiserslautern	kaiserslautern
arp	arp
halina	halina
laidai	cables
laidai	wiring
aba	aba
užsiėmimai	sessions
komplektas	kit
išmintis	wisdom
nuotėkio	leak
nuotėkio	leakage
migruoti	migrate
nascar	nascar
dniepropetrovsko	dnipropetrovsk
ultra	ultra
alkaloidų	alkaloids
siuzana	susan
krc	krc
ost	ost
amstrad	amstrad
bambuko	bamboo
nereikalingas	withers
nereikalingas	wither
medėja	medea
scherzinger	scherzinger
goa	goa
apribojimus	constraints
miami	miami
vištos	chickens
vištos	chicken
žmoniją	humanity
pasiūlymai	bids
pasiūlymai	proposals
pasiūlymai	tenders
gabonas	gabon
liejimo	moulding
liejimo	casting
bobo	bobo
bilietai	tickets
rijeka	rijeka
adm	adm
darfūro	darfur
įrengimas	installation
lopilato	lopilato
oneginas	onegin
eukaliptų	eucalyptus
apsikeitimo	swaps
pažįstamas	familiar
lps	fta
melas	lie
troleibusai	trolleybuses
universität	universität
greiti	fast
jens	jens
platinimas	distribution
streikas	strike
yehuda	yehuda
neoficiali	unofficial
aria	aria
krakmolas	starches
krakmolas	starch
salonas	showroom
kravitz	kravitz
kanye	kanye
lan	lan
moskvič	moskvitch
bristolio	bristol
flores	flores
grafinis	graphic
prašau	please
panašumo	similarity
impulsų	pulses
babilonas	babylon
atsiųsti	download
jautienos	beef
korėjiečiai	koreans
bronšteinas	bronstein
įtvirtinimas	anchoring
benzino	petrol
pėdsakus	clues
jungti	conjugate
dvikova	duel
smuklė	tavern
vaistininkas	pharmacist
garantijų	warranty
garantijų	guarantees
durklas	dagger
timothy	timothy
giant	giant
fontana	fontana
wembley	wembley
romų	roma
hieroglifai	hieroglyphs
leidimus	permits
rao	rao
aloe	aloe
kiaušinis	egg
koši	cauchy
blauzdos	thigh
nojus	noah
karma	karma
tinamas	tinamou
furjė	fourier
aso	aso
instrumentinis	instrumental
ficus	ficus
aras	macaws
aura	aura
įsipareigoja	commits
dieter	dieter
mango	mango
tolerancijos	tolerance
kopros	copra
veidai	wade
veidai	faces
žūklės	catching
stovyklavietė	campsite
žiurkių	rats
wang	wang
moralė	morale
placebo	placebo
pacientas	patient
kepti	fried
derinimo	debug
zamoiskis	zamoyski
šilingas	shilling
lancia	lancia
linkolnas	lincoln
ūdros	otters
hun	hun
grzegorz	grzegorz
normanai	norman
markizo	marquesas
mana	mana
akimirkos	moments
linkin	linkin
ilgumos	longitude
dario	dario
intertoto	intertoto
kartagina	carthage
išdėstymo	layout
ashley	ashley
nigeris	niger
negalia	disabilities
negalia	disability
vasalai	vassals
meditacija	meditation
tan	tan
unicef	unicef
auditorija	audiences
klientai	customers
naujovės	innovations
naujovės	innovation
išmatuotas	measured
jensen	jensen
skersinės	transverse
simbolinę	symbolic
arkų	arches
ave	ave
mariano	mariano
primatas	primate
liberalizmo	liberalism
dviračiai	bicycles
dviračiai	bikes
garra	garra
lydeka	pike
salvatore	salvatore
priemiesčių	suburban
akimirką	moment
titlestyle	titlestyle
papuošti	decorated
transplantacijos	transplants
transplantacijos	transplant
suprojektuoti	designed
ling	ling
agata	agatha
maribor	maribor
filippo	filippo
jodo	iodine
plėšikas	robber
elamitų	elamite
margo	margo
senatoriai	senators
torre	torre
leideno	leiden
rodrigo	rodrigo
trombocitų	platelet
dialogas	dialogue
dialogas	dialog
karosai	bream
sustojimo	staging
burnley	burnley
franklinas	franklin
ūminis	acute
riešo	twist
maršrutą	routing
arx	arx
uoga	berry
drupal	drupal
ajutajos	ayutthaya
plunksna	feather
myliu	love
gfdl	gfdl
marcelo	marcelo
vale	vale
mic	mic
kepimo	baking
wrexham	wrexham
apeiti	circumvent
apeiti	circumvented
apeiti	bypass
padangas	tires
padėjėjai	assistants
švente	celebration
investuotojas	investor
eile	lane
zeitung	zeitung
epitelis	epithelium
puna	puna
huritų	hurrian
karikatūristas	cartoonist
bulių	bulls
herodotas	herodotus
naminė	tawny
žandarai	gendarmes
reda	reda
ego	ego
krūtų	breast
krūtų	breasts
niutonas	newton
bebrai	beavers
minaretas	minaret
biotechnologijos	biotechnology
gražios	lovely
diplomatija	diplomacy
draugiškas	friendly
draugiškas	amicable
fin	fin
indukcijos	induction
agentūrų	joints
