lan	lan
bristolio	bristol
flores	flores
prašau	asb
prašau	asseblief
impulsų	pulse
babilonas	babylon
atsiųsti	aflaai
jautienos	beesvleis
dvikova	duel
smuklė	tavern
vaistininkas	apteker
garantijų	waarborg
durklas	dagger
timothy	timothy
giant	reus
fontana	fontana
wembley	wembley
hieroglifai	hiërogliewe
rao	rao
aloe	aalwyn
aloe	aloe
kiaušinis	eier
koši	cauchy
nojus	noag
nojus	noah
karma	karma
furjė	fourier
aso	aso
instrumentinis	instrumenteel
aura	aura
įsipareigoja	pleeg
dieter	dieter
mango	mango
tolerancijos	tolerance
cm³	cm³
veidai	wade
veidai	gesigte
žiurkių	rotte
žiurkių	rats
wang	wang
moralė	morale
placebo	placebo
pacientas	geduldig
pacientas	patient
kepti	gebraaide
zamoiskis	zamoyski
šilingas	shilling
lancia	lancia
linkolnas	lincoln
ūdros	otters
hun	hun
normanai	norman
mana	mana
akimirkos	oomblikke
linkin	linkin
ilgumos	lengteligging
ilgumos	lengtegraad
dario	dario
intertoto	intertoto
išdėstymo	uitleg
ashley	ashley
nigeris	niger
negalia	gestremdhede
negalia	gestremdheid
meditacija	meditasie
unicef	unicef
auditorija	gehore
klientai	klante
naujovės	innovasies
naujovės	innovasie
išmatuotas	gemeet
jensen	jensen
simbolinę	simboliese
simbolinę	simbolies
mariano	mariano
primatas	primate
liberalizmo	liberalisme
dviračiai	fietse
lydeka	pike
salvatore	salvatore
priemiesčių	suburban
akimirką	oomblik
titlestyle	titlestyle
ling	ling
agata	agatha
filippo	filippo
jodo	jodium
plėšikas	rower
margo	margo
senatoriai	senators
torre	torre
leideno	leiden
rodrigo	rodrigo
dialogas	dialoog
karosai	bream
franklinas	franklin
ūminis	akute
riešo	twist
riešo	kinkel
maršrutą	roetering
uoga	bessie
uoga	berry
ajutajos	ayutthaya
plunksna	feather
myliu	liefde
gfdl	gfdl
marcelo	marcelo
vale	vale
kepimo	gebak
wrexham	wrexham
apeiti	ompad
apeiti	bypass
švente	viering
eile	lane
zeitung	zeitung
epitelis	epiteelweefsel
puna	puna
bulių	bulle
bulių	bulls
herodotas	herodotos
naminė	tawny
ego	ego
krūtų	breast
niutonas	newton
biotechnologijos	biotegnologie
gražios	lieflik
diplomatija	diplomacy
draugiškas	vriendelik
fin	fin
sima	sima
gulbė	swan
gulbė	swaan
opolės	opole
antverpene	antwerpen
eksportuoti	verstryk
mėgstamiausia	gunsteling
misūrio	missouri
kane	kane
adeno	aden
farm	plaas
sutikimas	toestemming
francesca	francesca
tigrai	tigers
išskirtinės	uitsonderlik
burtininkas	towenaar
burtininkas	assistent
vampyrai	vampires
albino	albino
demokratinis	demokratiese
paneigti	negers
ovalios	oval
ovalios	ovaal
bakterijas	bakterie
kriketo	krieket
javascript	javascript
nepakankamumas	mislukking
sabina	sabina
tiger	tier
tiger	tiger
verneris	werner
vestminsterio	westminster
räikkönen	räikkönen
maldonado	maldonado
džimas	jim
sunkvežimiai	vragmotors
sunkvežimiai	bakkies
sunkvežimiai	trokke
ropliai	reptiele
iššūkis	challenge
iššūkis	uitdaging
fidžis	fiji
samara	samara
deimantas	diamond
deimantas	diamant
braga	braga
giancarlo	giancarlo
barenco	barents
jamato	yamato
lambert	lambert
išpuolių	aanvalle
konfederatų	gekonfedereerde
transliavimo	uitsaai
midi	midi
claudia	claudia
indėlių	inbetaal
blokai	blokke
lil	lil
tapatybė	identiteit
surinamas	suriname
gogo	gogh
welt	welt
genetinis	genetiese
omanas	oman
garavimo	verdamping
puatjė	poitiers
parc	parc
susirinkimai	meetings
susirinkimai	vergaderings
kichotas	quixote
diskriminacija	diskriminasie
tikslumo	akkuraatheid
korteles	kaarte
neutralus	neutraal
balai	tellings
įmontuotas	ingebedde
įmontuotas	ingelegde
įmontuotas	ingebed
konkurentai	mededingers
konkurentai	mededinger
excelsior	excelsior
sanskritas	sanskrit
alexandre	alexandre
ivanovo	iwanowo
neue	neue
americana	americana
gore	gore
gestų	gebare
msv	msv
poravimosi	mating
padavimo	indiening
alicija	alicia
lockheed	lockheed
teismus	howe
drąsa	moed
drąsa	dapperheid
huangdi	huangdi
žydėjimo	flowering
pts	pty
dubajaus	dubai
kryžkelėje	crossroads
miegas	slaap
miegas	slaap
miegas	slapende
citrinų	suurlemoen
dinaras	dinar
tunelį	tonnel
haiku	haiku
įsigyta	gekoop
įsigyta	gekoopte
įsigyta	aangekoop
konsultacijos	samesprekings
egzoplaneta	eksoplaneet
kirmėlių	worms
būstas	opsy
būstas	behuising
ipairs	ipairs
tarantino	tarantino
nuoma	huurkontrak
nuoma	hire
nuoma	huur
nuoma	verhuur
kaimynas	buurman
kaimynas	buurman
idzu	izu
zbigniew	zbigniew
pirštas	vinger
jacqueline	jacqueline
bėgiai	rails
ortega	ortega
ide	ide
mandela	mandela
kiribačio	kiribati
morrison	morrison
noriai	gewillig
français	français
spartą	sparta
seule	seoul
elfai	elwe
elfai	helpers
tuberkuliozė	tuberkulose
džimis	jimmy
swansea	swansea
miškininkystė	bosbou
tarpininkavimo	bemiddeling
patogi	gemaklik
uždirbti	verwerf
subpage	subpage
hodžkino	hodgkin
katryklis	scyliorhinidae
stebėtojai	observers
abdullah	abdullah
išgyvenimo	oorlewing
jin	jin
sidney	sydney
turtai	fortuin
minia	skare
kalbotyra	taalkunde
gražūs	lekker
gražūs	oulike
gražūs	nice
sinensis	sinensis
palustris	palustris
kontūrai	buitelyn
togas	togo
reputacija	reputasie
užutėkis	sund
autobiografija	outobiografie
derva	kougom
derva	gum
mira	mira
choleros	cholera
madeiros	madeira
daiktavardis	werkwoord
krokodilai	krokodille
eldorado	eldorado
joninių	midsomerfees
pakartas	opgehang
auxerre	auxerre
seneliai	grootouers
betty	betty
gibson	gibson
fenerbahçe	fenerbahçe
šonkaulių	ribbes
šonkaulių	rib
#ffcc	#ffcc
stebuklas	miracle
spalvoti	gekleurde
redakcinė	redaksie
mėgstamiausias	gunsteling
mėgstamiausias	gunsteling
encyklopedia	encyklopedia
švarus	skoon
rowland	rowland
arno	arno
rojų	paradise
coffea	coffea
neapykanta	haat
elitas	elite
diržas	gordel
diržas	belt
brien	brien
sms	sms
knowles	knowles
metano	metaan
arekipos	arequipa
massimo	massimo
kirk	kirk
kirk	damara
clinton	clinton
donato	donato
biurų	kantore
matavimas	maatreëls
matavimas	meting
matavimas	mate
matavimas	mates
matavimas	maatreëls
heraldika	heraldiek
vairuotojų	drywers
vairuotojų	bestuurders
vairuotojų	aandrywer
pomidorų	tamatie
sandėlių	pakhuise
sūriai	kase
uagadugu	ouagadougou
romo	rum
gliese	gliese
aleutų	aleoetiese
rcd	rcd
gura	góra
išimtys	uitsonderings
pateikimas	instuur
flavijus	flavius
spinduliuotė	straling
leopardas	luiperd
dviračiu	fietsry
romanovas	romanof
triušiai	haas
triušiai	rabbit
rembrantas	rembrandt
moldavų	moldawies
konfigūracija	opstelling
shannon	shannon
augintojai	breeders
naga	naga
wells	wells
horst	horst
atspindys	refleksie
fotografė	fotograaf
specialistams	professionals
aklas	blind
díaz	díaz
vavelio	wawel
priesaika	eed
linai	vlas
guillaume	guillaume
sunaikinimas	vernietiging
sampdoria	sampdoria
džamu	jammu
continental	kontinentale
continental	continental
fosfatų	fosfaat
plakatai	plakkate
jura	alb
džiuljeta	juliet
respublikose	republieke
nacionalizmas	nationalism
aug	aug
zoran	zoran
čekai	tsjegge
routledge	routledge
andersen	andersen
twitter	twitter
banginis	walvis
skydai	borde
turbinos	opgewek
stela	stella
paleologas	paleologus
karvė	koeie
karvė	koei
mandatas	mandaat
ribojimas	beperking
džiaugsmo	vreugde
zeiss	zeiss
adobe	adobe
mer	mer
meškutė	moth
neteisingas	verkeerd
philipp	philipp
siekiai	aspirasies
twente	twente
seine	seine
mieško	mieszko
kvadratas	division
kvadratas	deling
turkmėnija	turkmenistan
dharma	dharma
alvaro	alvaro
tenesio	tennessee
alegorija	allegorie
mesa	mesa
bruklino	brooklyn
varlė	padda
klounas	clown
klounas	gloei
neutralumo	neutrality
liucernos	luzern
uniformas	uniforms
mauser	mauser
vip	vip
pomidorai	tamatie
pomidorai	tamaties
pasisekė	lucky
pasisekė	gelukkig
žiaurus	brutal
paramore	paramore
įspūdinga	spectacular
samurajus	samurai
adalbertas	albertus
emmanuel	emmanuel
eksportuojami	uitvoer
trukdyti	steur
labas	hallo
labas	hi
labas	haai
atstatymas	restourasie
vanagai	hawks
kištis	inmeng
demokratinėje	demokratiese
kabeliai	kabels
kabeliai	kabel
rapsų	verkragting
ligūrijos	ligurië
kamuoliukas	bofbal
butai	flats
butai	vlakte
maliarija	malaria
advokatai	prokureurs
agripa	agrippa
kapitonai	masters
hansen	hansen
stanfordo	stanford
whitney	whitney
gugenheimo	guggenheim
fermentas	ensiem
adatos	needle
gabriele	gabriele
forbes	forbes
preparatas	voorbereiding
granatų	pomegranaat
suplanuotas	hoax
suplanuotas	poets
viridis	viridis
vasalas	vasal
rubens	rubens
šešėliai	skaduwees
timeaxis	timeaxis
žmogžudysčių	moorde
bara	bara
pradešas	pradesh
sraigtasparnio	helikopter
abejonės	twyfel
kopijas	afskrifte
kopijas	kopieë
stumia	ondermyn
tolerancija	tolerance
pasodinti	geplant
stéphane	stéphane
benetton	benetton
burtininkų	wizards
registracija	registrasies
registracija	registrasie
gaisrai	fires
gaisrai	vure
didvyriai	heroes
didvyriai	helde
soli	soli
bernardino	bernardino
tara	tara
kiauliena	varkvleis
trieste	trieste
xxv	xxv
ontarijas	ontario
bronzinė	troilus
luizianos	russies
luizianos	louisiana
bosch	bosch
švieži	vars
delegatai	afgevaardigdes
matteo	matteo
delo	deliese
protingas	hefboom
protingas	clever
protingas	intelligente
undef	undef
maui	maui
teisėtai	legally
delis	delhi
kriaušių	peer
rajos	stingray
walther	walther
naujovė	innovasie
nogajų	nog
ava	ava
grove	grove
jung	jung
cartier	cartier
mhnt	mhnt
padažu	sous
troškimas	begeerte
yucca	yucca
perlai	pêrels
paruošimas	voorbereiding
triumfas	triumph
ursula	ursula
andersson	andersson
testcases	testcases
sikstas	sixtus
gianni	gianni
pojūtis	sensation
premjerą	premier
importuoti	ingevoer
importuoti	ingevoerde
rodgers	rodgers
chloro	chloor
fenech	fenech
hibridai	hibried
nicholson	nicholson
guobų	elm
tobulas	perfek
konkurentas	mededinger
vikšras	caterpillar
ángel	ángel
antonov	antonov
nuestra	nuestra
aimarų	aymara
daugiskaita	meervoud
cdu	cdu
lokomotive	lokomotive
yamaha	yamaha
vinci	vinci
volvo	volvo
graužikai	knaagdier
andai	andes
pagalvės	pillow
kauliukai	stene
kauliukai	steen
trinties	wrywing
ščecino	szczecin
tikslūs	akkurate
tikslūs	akkuraat
likvidavimo	likwidasie
christine	christine
butelis	bottel
deutsch	deutsch
kusko	cusco
kalmaro	kalmar
nuno	nuno
trokšta	begeer
trento	trient
prefektas	prefek
shah	shah
šviežias	vars
arte	arte
kuzma	koezma
alabama	alabama
clash	botsing
clash	clash
bray	bray
ateiviai	aliens
deutscher	deutscher
persėjas	perseus
aleksijus	alexios
višta	hoender
jubiliejus	herdenking
kalkių	lemmetjie
teherano	teheran
bombardavimo	bomaanval
gros	gros
vat	nat
ačiū	dankie
vidurnakčio	middernag
maitinimas	spyseniering
matematiškai	wiskundig
ketverto	kwartet
nelygybė	ongelykheid
stygas	stringe
nero	nero
semantika	semantiek
lempa	lamp
viskis	whiskey
viskis	whisky
skauda	seer
solis	solis
astra	astra
nuotėkis	lekkasies
remixes	remixes
daugava	daugava
keane	keane
mechelen	mechelen
atidėta	uitgestel
goja	goya
laumžirgis	hawker
altvar	altvar
antoninas	antonín
mozaikos	mosaïek
andrej	andrej
sepc	sepc
andamanų	andaman
mineralinis	mineraal
egzaminas	ondersoeke
egzaminas	eksamen
dviračio	fiets
šaukia	skreeu
mindanao	mindanao
abatas	ab
katmandu	katmandoe
velvet	velvet
vin	vin
kaulavaisis	steenvrug
hewitt	hewitt
parašiutu	valskerm
pianino	klavier
fasas	faso
pirkėjas	koper
derinimas	versoening
derinimas	opstelling
martenas	maarten
kosmologija	kosmologie
mylėti	liefdevolle
kabina	cockpit
kabina	cab
kabina	hut
kabina	kajuit
kabina	cabin
norwich	norwich
musée	musée
geresnė	beter
judaizmas	judaïsme
elis	ellis
ultima	ultima
strauss	strauss
blade	blade
rajon	rajon
ginčytina	betwis
arturo	arturo
rostock	rostock
drobė	doek
blužnies	milt
lova	bed
pitsburgo	pittsburgh
hardy	hardy
grodno	grodno
jautrios	sensitief
krokodilas	krokodil
ieee	ieee
biurai	kantore
mūza	muse
dioniso	dionysos
flamenko	flamenco
liststyle	liststyle
čerkasų	tsjerkasi
viskuo	alles
kama	kama
justinianas	justiniaanse
ebu	ebu
įtaisytas	ingebedde
įtaisytas	ingelegde
įtaisytas	ingebed
factbook	factbook
daniela	daniela
blogiau	erger
blogiau	slegter
zagrebas	zagreb
papuošalas	juweliersware
lyra	lyra
kabinos	cockpit
būgno	drum
būgno	drom
alla	alla
segmentai	segmente
pramoga	vermaak
manipuliuoti	manipuleer
kampinis	detailed
reims	reims
imagesize	imagesize
carrera	carrera
cunamio	tsunami
įtakinga	invloedryke
puccini	puccini
nippon	nippon
kalabrijos	calabria
gómez	gómez
jarosław	jarosław
eli	ellie
ūdra	otter
eclipse	eclipse
eugen	eugen
kobra	cobra
bella	bella
sato	sato
marksas	marx
laukinis	savage
nesėkmė	mislukking
valerius	valerius
kingston	kingston
diaz	diaz
wesley	wesley
plotarea	plotarea
užblokuotas	geblokkeerde
užblokuotas	geblokkeer
užblokuotas	verhoed
užblokuotas	geblok
gala	gala
kalis	kalium
mirtina	lethal
mirtina	fatale
mylios	myl
džonatanas	jonathan
santrumpos	afkortings
scalemajor	scalemajor
ankaros	ankara
geria	gedrink
geria	drinking
geria	drink
geria	drankies
toto	toto
sudamericana	sudamericana
metras	meter
saugus	gimnasium
inka	inca
doro	deugsame
valenciennes	valenciennes
dio	cassius
dostojevskis	dostojefski
išsaugojimas	bewaring
willis	willis
medici	medici
malibu	malibu
christoph	christof
montpellier	montpellier
himalajinis	himalayan
geoffrey	geoffrey
wikitable	wikitable
soto	soto
bilietus	kaartjies
castillo	castillo
liam	liam
granatas	garnet
pont	pont
nicolás	nicolás
biochemija	biochemie
sullivan	sullivan
pamiršti	vergeet
klausas	claus
phantom	phantom
sprache	sprache
sabbath	sabbath
aldo	aldo
kooperatyvas	koöperatiewe
slėpti	versteek
slėpti	verberg
transliacijas	uitsendings
motyvacija	motivering
serge	serge
kedrų	cedar
posėdžiai	meetings
posėdžiai	vergaderings
posėdžiai	sessies
vergas	slaaf
vergas	den
musmirė	caesarea
privalomi	verpligtend
umaras	omar
deimantai	ruite
deimantai	diamonds
universidad	universidad
aliuminis	aluminium
aliuminis	aluminium
darbdavys	werkgewers
darbdavys	werkgewer
testai	toetse
paskola	lening
paskola	lenings
historica	historica
demi	demi
įnašas	bydrae
drakula	dracula
bri	bree
džinas	genie
ramón	ramón
lolita	lolita
hasanas	hassan
afrikanų	afrikaans
elias	elias
verpimo	spinning
loginis	logika
įtarimai	bewerings
streikai	strikes
įžymybių	beroemde
įžymybių	bekendes
blogiausia	swakste
blogiausia	ergste
blogiausia	slegste
pelkę	natalse
olympiacos	olympiacos
abs	abs
sambo	sambo
español	español
sulaužė	bankrot
apklausa	meningspeiling
nelaimė	ramp
nelaimė	disaster
autobuso	bus
haliucinacijos	hallusinasies
rūkymo	rook
grynasis	netto
chanty	chanti
gustaf	gustaf
iucnredlist	iucnredlist
muntjakas	muntjak
absolventų	gegradueerdes
skalės	skale
alignbars	alignbars
musica	musica
pueblo	pueblo
apmokyti	opgeleide
deir	deir
hanau	hanau
caf	caf
greitesnis	gouer
greitesnis	vinniger
drėgmė	humiditeit
sudėtingumas	moeilikheidsgraad
sudėtingumas	moeilikheid
sudėtingumas	complexity
svajonės	drome
sidi	sidi
rupija	roepee
išbandytas	tested
grįžimas	terugkeer
grįžimas	opgelewer
grįžimas	terugkeer
grįžimas	terugstuur
trauka	swaartekrag
trauka	gravitasie
nomenklatūra	nomenclature
shuttle	shuttle
erasmus	erasmus
marcos	marcos
noel	noel
cern	cern
kodavimo	coding
nata	nata
svyravimų	kontras
bam	bam
arkangelas	aartsengel
psichinės	psigies
sofoklis	sophokles
intervencija	intervensie
intervencija	broodnodige
šeštadieniais	saterdae
ignacas	ignaz
nagus	nails
damos	dame
damos	lady
asbesto	asbes
coventry	coventry
sandėlio	warehouse
diabetu	diabetes
nuostabus	fantasties
nuostabus	ongelooflike
nuostabus	wonderlik
nuostabus	amazing
nuostabus	ongelooflik
nuostabus	wonderlik
nuostabus	heerlik
nuostabus	oulike
fabricius	fabricius
subaru	subaru
shelley	shelley
vitaminai	vitamiene
vitaminai	vitamien
osbourne	osbourne
iliuzija	illusie
barjerą	barrier
til	til
poilsis	ontspanning
poilsis	rus
poilsis	res
midus	heuningbier
kabulo	kaboel
sąžinės	bewussyn
vasco	vasco
silpnesnis	swakker
jackie	jackie
vagis	dief
abba	abba
nuoga	naked
manu	manu
pingvinai	pikkewyne
sinatra	sinatra
grobis	prey
andronikas	andronikos
origami	origami
kalikstas	callixtus
dima	dim
dima	dima
hoffmann	hoffmann
lippi	lippi
fidi	chateau
apelsinų	orange
apelsinų	gewysig
apelsinų	lemoen
apelsinų	oranje
mazowieckie	mazowieckie
revolveris	rewolwer
ericsson	ericsson
medūzos	jellievis
dvynys	tweeling
amžina	ewige
suvereniteto	soewereiniteit
gaila	jammer
setas	seth
batus	stewels
suvirinimo	welding
akordeonas	trekklavier
akordeonas	skerpioen
aromato	aroma
prieštaravimai	objections
pilvą	abdomen
tiesiogine	literally
tech	tech
akacija	wattle
pykčio	woede
pykčio	rage
paradas	parade
kopūstai	cabbage
gizos	giza
porta	porta
gaidukas	kemphaan
crest	crest
loa	loa
mora	mora
madre	madre
ateistas	ateïs
czesław	czesław
paraguay	asunción
alvaras	alvar
algebra	algebra
kandži	kanji
javiečių	javanese
dviratis	bike
dviratis	fiets
alyva	olie
klijai	gom
franšizės	franchise
lauda	lauda
rodriguez	rodriguez
regata	regatta
bilietas	kaartjie
ldp	ldp
akcentas	onderdruk
akcentas	accent
akcentas	aksent
björk	björk
cosmos	kosmos
reorganizuoti	herorganiseer
gomes	gomes
mergedrow	mergedrow
hansa	hansa
chiesa	chiesa
baitų	greep
elegans	elegans
vilkikas	trekker
vilkikas	tug
zabrze	zabrze
sunkumai	uitdagings
sunkumai	moeilikheidsgraad
sunkumai	moeilikheid
algos	salarisse
muller	muller
florijonas	florian
roc	roc
ffd	ffd
atspindžiai	reflections
frida	frida
šarvuotas	gewapende
narsą	valor
blanc	blanc
trajanas	trajanus
biskajos	biskaje
luís	luis
apribojimas	beperking
feraros	ferrara
sąjungininkas	ally
azul	azul
malo	malo
gora	gora
groupstyle	groupstyle
anthus	anthus
julianas	julianus
hagen	hagen
kvepalai	parfuum
klijų	gom
hebr	hebr
quo	quo
stojimo	accession
sankcijos	strafskoppe
vladivostoko	wladiwostok
raštingumo	geletterdheid
požemių	underworld
karlsruhe	karlsruhe
įkaitų	hostage
brunėjus	broenei
reguliuojama	verstelbare
lindgren	lindgren
duisburg	duisburg
darjeno	darién
bursa	bursa
karnavalas	carnival
karnavalas	karnaval
kvepalų	fragrance
karina	karin
atspindžio	refleksie
karpiai	carp
ira	ira
lengvesnis	ligter
dateformat	dateformat
amplitudės	amplitude
robotai	robots
robotai	robotte
sokoto	sokoto
ekstraktas	uittreksel
gaja	gaia
interaktyvus	interaktiewe
laz	laz
jautiena	beesvleis
vadis	vadis
apsauginis	beskermende
kupolu	dome
sugalvotas	uitgevind
išvykimo	vertrek
mantra	mantra
birmos	burma
birmos	birmaanse
galvonis	encephalartos
kia	kia
rymano	riemann
pyragas	koek
pyragas	doodeenvoudig
vandalizmo	vandalisme
gansu	gansu
rikis	ricky
skitai	skitiërs
cox	cox
chang	chang
moi	moi
driežas	lizard
driežas	akkedis
anarchija	anargie
bėgikė	naaswenner
bėgikė	runner
maloniai	verleen
thornton	thornton
pašaras	voed
pašaras	stroom
pašaras	toevoer
jakub	jakub
frédéric	frédéric
amazon	amazon
paaiškinimai	remarks
paaiškinimai	verduidelikings
justo	justo
concordia	concordia
gasparas	gasparo
zoo	dieretuin
zoo	zoo
izoliacijos	isolation
izoliacijos	isolasie
rada	rada
satyras	sater
hubert	hubert
saugojimas	berging
diagnozė	diagnose
fuji	fuji
vargo	misery
esteban	esteban
meldėsi	gebid
tirėnų	tirreense
maltiečių	maltese
maltiečių	maltees
tulūzos	toulouse
grietinėlės	room
grietinėlės	cream
eurobasket	eurobasket
angelica	angelica
dimorfizmas	plumage
occidentalis	occidentalis
chorasano	khorasan
piemenys	herdershonde
dervos	hash
akureyri	akureyri
marškiniai	hemp
marškiniai	hemde
mali	mali
mariner	mariner
emeritas	emeritus
kelionėms	reis
wilder	wilder
sales	sale
vaiduoklis	spook
diagramos	diagram
diagramos	grafieke
uri	uri
baja	baja
nuosėdos	sediment
stabdymo	braking
magelanas	magellan
maurjų	maurya
avivas	aviv
perono	voorskoot
kilmarnock	kilmarnock
hofmanas	hoffman
saulėlydžio	skemer
našumas	produktiwiteit
bai	bai
tiranos	tirana
klientui	klant
suahilių	swahili
įgijimas	aanwins
harbour	harbour
dietos	diet
emo	emo
šapalai	chub
morton	morton
bretanės	brittany
tnt	tnt
saksas	saxo
nardymo	duik
nardymo	diving
amon	amon
vudu	voodoo
rahman	rahman
išdavystę	joffe
rush	rush
rush	stormloop
royale	royale
pastabas	observations
pastabas	opmerkings
niro	niro
fantazija	fantasie
sindziango	xinjiang
garantijos	waarborg
garantijos	waarborg
dachau	dachau
demetra	demeter
keltu	ferry
fredas	vrede
užsisakyti	inteken
užsisakyti	registreer
kragas	grebe
vonios	bad
vonios	bath
aptikimo	opsporing
polonija	polonia
kofeino	kafeïen
eugène	eugène
holland	holland
breton	breton
bolivaras	bolívar
polimerų	polimere
tesla	tesla
saro	saarland
gimbutienė	gimbutas
iglesias	iglesias
amphiprion	amphiprion
įsitikinimus	oortuigings
volframo	wolfram
damiano	damiano
klausytojai	luisteraars
sforza	sforza
karlsonas	carlson
taktinis	taktiese
polinezija	polinesië
poemas	poemas
hendrix	hendrix
borough	munisipaliteit
persona	persona
grasino	gedreig
grasino	bedreig
timūras	timoer
gem	gem
zee	zee
močiutė	ouma
močiutė	granny
močiutė	ouma
jefferson	jefferson
represijos	lyke
bantu	bantoe
bantu	bantu
narai	divers
mintimis	gedagtes
adata	needle
moduliai	modules
erdvėlaivių	ruimtetuig
saugi	veilig
saugi	veilige
tiesas	waarhede
kelnes	broek
karstas	coffin
nic	nic
tigrajų	tigrinya
pirkėjai	koper
orientalis	orientalis
tiesiosios	rektum
insulino	insulien
paskirstyti	versprei
gilią	vreeslike
benevento	benevento
chomsky	chomsky
hopkins	hopkins
kasyba	mining
kasyba	myn
kasyba	mynbou
kasyba	mynwese
mondeo	mondeo
stipendijas	scholarships
laboratorijų	laboratoriums
cfa	cfa
kay	kay
pasauliai	worlds
pasauliai	wêrelde
grampus	grampus
atstumai	afstande
impulso	pols
pridėtinės	bygevoeg
suderinama	aanpasbaar
suderinama	versoenbaar
oblivion	vergetelheid
tokugava	tokugawa
ari	ari
française	française
kiaulienos	varkvleis
bhakti	bhakti
femme	femme
lana	lana
rosita	rosita
nagasakio	nagasaki
eksperimentinių	eksperimentele
eksperimentinių	eksperimenteel
žiniatinklio	web
morales	morales
galutiniai	finale
galutiniai	finaal
galutiniai	definitiewe
aliaska	alaska
horizontalus	horisontale
akacijų	acacia
motociklai	motorfietse
garda	garda
savižudybė	selfmoord
prometėjas	prometheus
alf	alf
eil	mislei
pajėgumas	kapasiteit
stebuklingas	magiese
stebuklingas	magical
norvegai	noorweërs
brodvėjaus	broadway
populus	populus
vynuogynų	wingerd
vynuogynų	wingerde
bundesliga	bundesliga
kaisaka	asper
volgogrado	wolgograd
serveriai	bedieners
lėja	leah
pikselių	pixel
varliagyviai	amfibieë
mumijos	mummies
fleming	fleming
dinozauras	dinosaur
dinozauras	dinosourus
traktoriai	trekker
cigarečių	sigaret
sudomino	janet
breslau	breslau
panteono	pantheon
ilio	ili
selo	selo
telekomunikacijos	telekommunikasie
telekomunikacijos	telekommunikasie
breda	breda
petri	petri
vairuotojai	drywers
vairuotojai	bestuurders
vairuotojai	aandrywer
duncan	duncan
atverti	ope
atverti	oopmaak
atverti	oop
conmebol	conmebol
pralaimėjimus	nederlae
gerd	gerd
aguonų	poppy
ipswich	ipswich
buhalteris	rekenmeester
buhalteris	boekhouer
buhalteris	rekeningkundige
besivystančių	emerging
tricolor	tricolor
karteris	carter
ekologinio	organiese
guerra	guerra
izoliacija	isolation
izoliacija	isolasie
kaledonija	caledonia
paprašyti	vra
guillermo	guillermo
émile	émile
šiltinės	tifus
vertigo	vertigo
mussolini	mussolini
kler	claire
piniginė	monetêre
lankstus	soepel
lankstus	buigbare
elite	elite
festivalius	festivals
royce	royce
veiksmingumas	doeltreffendheid
izotopų	isotoop
maurai	moors
malone	malone
išvestinė	afgeleide
drąsos	moed
palaima	blessing
amharų	amharies
bikini	bikini
mikrobangų	mikrogolf
negalią	gestremdheid
plėvelė	rolprent
barų	balke
barų	sterre
barų	kroeë
barų	tralies
šriftas	font
humoras	humor
timas	tim
karščiavimas	koors
blackmore	blackmore
dienoraščiai	diaries
hamletas	hamlet
hamad	hamad
siekiu	strek
siekiu	rek
penkiakovė	vyfkamp
šiandienos	vandag
sukotajaus	sukhothai
beit	beit
trapi	fragile
trapi	brose
marcello	marcello
kubizmo	kubisme
duomo	duomo
freiburg	freiburg
valentin	valentin
balionas	ballon
blogiausias	swakste
blogiausias	ergste
blogiausias	slegste
harisonas	harrison
bitis	bitis
kazanė	kazan
chinensis	chinensis
apeigomis	rites
kilometre	kilometer
magas	towenaar
reo	reo
terorizmu	terrorisme
ingres	ingres
aprėpia	buckle
osvaldo	osvaldo
salai	salai
kalugos	kaloega
ergo	ergo
huang	huang
orgazmas	orgasme
angus	angus
leigh	leigh
eriksson	eriksson
rui	rui
įdiegtas	geïnstalleer
įdiegtas	geinstalleer
nasdaq	nasdaq
abbr	abbr
kaltė	fault
kaltė	breuk
kaltė	skuldgevoelens
kaltė	skuld
amadeus	amadeus
balionų	ballonne
zoologija	dierkunde
homme	homme
slovakai	slowake
įvardis	voornaamwoord
kėdė	chair
kėdė	voorsitter
kėdė	stoel
rimti	ernstige
rimti	ernstig
stein	stein
benoni	benoni
kelionei	reis
lęšiai	lens
tunisą	russies
tunisą	tunisië
memfio	memphis
šėtonas	satan
tulžys	kingfisher
narkotikai	medisyne
narkotikai	drugs
narkotikai	dwelms
lozanoje	lausanne
dina	dina
rinkodara	bemarking
romantizmas	romantiek
amelija	amelia
sakramentas	sacramento
cro	cro
bakas	tenk
def	def
apiaceae	apiaceae
heckler	heckler
esminius	noodsaaklike
esminius	essential
helis	helium
teroristai	terroriste
enschede	enschede
adresai	adresse
retorika	retoriek
studia	studia
andhra	andhra
miltus	meel
tripolis	tripoli
kit	kit
beveren	beveren
geometrinės	geometriese
glam	glam
deginti	skryfwerk
figaro	figaro
pirkimas	aankoop
pirkimas	aankope
pirkimas	aanskaffing
pirkimas	aankope
žąsys	goose
žąsys	gans
žąsys	geese
traktorius	millie
traktorius	trekker
kidman	kidman
paaugliai	tieners
bandeira	bandeira
blackpool	blackpool
erfurt	erfurt
žudo	kills
žudo	killing
lavey	lavey
barbarosa	barbarossa
panaikina	ontrek
tvenkinyje	dammetjie
lancer	lancer
meilužis	lover
stream	stroom
adriana	adriana
diuseldorfo	düsseldorf
bučas	butch
narkotinių	barometer
diplomatai	diplomats
kiaulė	vark
heian	heian
carey	carey
žydėti	blossom
žydėti	bloeisel
pratybos	dril
scaleminor	scaleminor
nereikalinga	sinneloos
nereikalinga	sinnelose
avalynė	skoene
tūkstantmečius	millennia
kala	kala
haus	haus
patikslintas	revised
studentė	student
bitininkystės	byeboerdery
sandūra	junction
plaučiai	long
plaučiai	longe
prekybininkai	traders
prekybininkai	handelaars
kompensacija	vergoeding
belgorodo	belgorod
vargšas	poor
vargšas	arme
vargšas	swak
vargšas	armes
stepė	steppe
pyktis	woede
silkės	herring
spyruoklės	springs
rouge	rouge
stiprintuvas	vermeerdering
yorke	yorke
indeksai	indices
carr	carr
catedral	catedral
colt	colt
cnn	cnn
šviežios	vars
viešpatie	here
satyra	satire
kitsas	kitts
tolstojus	tolstoi
klarkas	clark
patogiai	gemaklik
bender	bender
hormono	hormone
gregory	gregory
gregory	gregorius
isla	isla
timberlake	timberlake
aičio	aichi
karšti	hot
karšti	warm
nemo	nemo
wigan	wigan
baterijų	batterye
herzog	herzog
diabetas	diabetes
regal	regal
communis	communis
žodynėlis	woordelys
avižų	oat
deco	deco
ono	ono
rublis	roebel
jaustis	voel
lionel	lionel
pervalkos	portage
ole	ole
agresyvus	aggressief
menkės	kabeljou
tironas	tiran
macmillan	macmillan
ismail	ismail
portfelio	portfolio
raganosis	rhino
pavlodar	pavlodar
codex	codex
inicialai	voorletters
moralę	morals
prekybininkas	dealer
lds	lds
gabalas	destination
gabalas	stuk
gabalas	stukkie
pusryčiai	ontbyt
pašarai	voed
pašarai	stroom
pašarai	toevoer
supernovos	supernovae
newman	newman
ferreira	ferreira
hamburger	hamburger
smiltpelės	nagmuis
košė	pap
lovoje	bed
elektromagnetinių	elektromagnetiese
stefani	stephanie
bertrand	bertrand
rhinolophus	rhinolophus
atsiliepimai	terugvoer
kaimynė	buurman
koperniko	koperniese
klonas	kloon
aku	aku
dwight	dwight
bulves	potatoes
patriarcho	patriarg
įtariama	vermeende
bongo	bongo
tepalas	smeermiddel
pensija	pensioen
bach	bach
girėnas	girėnas
šrifto	font
hendrik	hendrik
metafizika	metafisika
aristokratija	aristokrasie
visagalis	almighty
bud	bud
badmintono	pluimbal
milvokio	milwaukee
sraigė	slak
kruša	hael
apartheido	apartheid
brigadų	brigades
būdvardis	aktief
kami	kami
lapą	tydskrif
kamiu	camus
šildymas	verhitting
damir	damir
fotografai	fotograwe
išeiga	oplewer
išeiga	opbrengs
duobes	graves
nebaigti	onvoltooide
bonaparte	bonaparte
trauma	skade
trauma	besering
trauma	trauma
metanas	metaan
radikalių	radikale
edvard	edvard
iniciatyvas	ondernemings
iniciatyvas	inisiatiewe
įpročiai	gewoontes
clube	clube
emberiza	emberiza
baha	baha
protinga	hefboom
protinga	clever
jurisdikcijos	jurisdiksie
padovanoti	skenk
hujų	hui
ankštiniai	pulse
odinas	odin
doherty	doherty
cercle	cercle
ekskursijų	touring
žaneta	jeanette
liežuvį	tong
penn	penn
inti	inti
belowstyle	belowstyle
dam	dam
siu	sue
imigracija	immigrasie
kassel	kassel
katekizmas	kategismus
philips	philips
c++	c++
payne	payne
fabian	fabian
botanika	plantkunde
transkripcijos	transkripsie
phra	phra
hendrick	hendrick
vesta	vesta
pywikipedia	pywikipedia
cosworth	cosworth
hyundai	hyundai
šarvuoti	armoured
sandorį	samesmelting
puštūnų	pasjtoe
karenina	karenina
begalinė	oneindige
gaublį	aardbol
gaublį	globe
lugo	lugo
svetimi	vreemdelinge
bello	bello
kafka	kafka
netinkamo	misbruik
prostitucija	prostitusie
académie	académie
lily	lily
ašaros	tears
ašaros	trane
gripas	griep
gripas	flu
ūsai	snor
bsc	bsc
stahl	stahl
asuano	aswan
panoramio	panoramio
sauronas	sauron
radiacija	straling
sueitis	interruptus
nec	nec
gudžarato	gujarat
trinity	trinity
ricci	ricci
quinn	quinn
