supra	supra
phabricator	phabricator
assr	assr
farnezės	farnese
tetraedro	tetrahedral
galerie	galerie
tana	tana
nutekėjimas	รั่ว
gui	gui
guotenė	coccinea
shrewsbury	shrewsbury
ilha	ilha
hack	แฮ็ก
hack	แฮก
protingi	ฉลาด
jahrhunderts	jahrhunderts
kerala	kerala
bilieto	ตั๋ว
bilieto	ใบสั่ง
bilieto	บัตร
dare	ท้า
dare	กล้า
placenta	รก
wikimania	wikimania
teisiniu	คร่า
teisiniu	จิก
apvalkalą	ฝัก
université	université
transliteracija	transliteration
musculus	musculus
baškirija	bashkortostan
inkaro	สมอ
inkaro	สม
subtilus	บอบบาง
asm	asm
ntsc	ntsc
žuvininkai	ospreys
janko	janko
reuter	reuter
vols	vols
alergija	ภูมิแพ้
alergija	ภูมิแพ้
mubarak	mubarak
pikta	โมโห
pikta	โกรธ
semestrą	เทอม
šukuosena	ตัดผม
ambicingas	ทะเยอทะยาน
priepuolių	ชัก
aukai	เหยื่อ
nemirtingas	อมตะ
trier	trier
korčės	korçë
relėjaus	rayleigh
adatų	เข็ม
vilkiko	ชัก
stiklinė	กระจก
stiklinė	แก้ว
seko	seko
senėjimas	นายทุน
kankinimai	ทรมาน
dagmar	dagmar
orf	orf
lccn	lccn
ferokaktusas	glaucescens
brangenybės	อัญมณี
eeb	eec
scarlatti	scarlatti
legio	legio
hdtv	hdtv
norai	ประสงค์
norai	ปรารถนา
nazionale	nazionale
sese	น้อง
hau	hau
borg	borg
reggio	reggio
pisano	pisano
pardo	pardo
vagys	ขโมย
vagys	โจร
kirchner	kirchner
rufescens	rufescens
išsigandęs	กลัว
feo	feo
headerstyle	headerstyle
dyzelinas	ดีเซล
magrebo	maghreb
logiška	ตรรก
ataksija	ataxia
kosmosas	พื้นที่
kosmosas	อวกาศ
kosmosas	space
patarlių	สำนวน
patarlių	สุภาษิต
kils	บันได
gedimas	ขัดข้อง
andželika	angelique
jad	yad
telecom	โทรคมนาคม
baisi	ขี้เหร่
cze	cze
sal	แซล
olympicsresult	olympicsresult
skorpionas	แมงป่อง
messagebox	messagebox
žydinčių	บาน
jogurto	yoghurt
mariae	mariae
vožtuvas	วาล์ว
mmc	mmc
bornemisza	bornemisza
ekstremalus	สุดขีด
dreamcast	dreamcast
abisinijos	abyssinian
hoffenheim	hoffenheim
utilitarizmas	utilitarianism
virškinti	สรุป
toksinių	พิษ
katana	katana
mobutu	mobutu
gėda	ละอาย
gėda	เสียดาย
gėda	ละอาย
gėda	อาย
nusipelno	สมควร
umbrijos	umbria
zoro	zoro
sfr	sfr
nigricollis	nigricollis
psy	psy
premjerų	premiers
treron	treron
fes	fes
moliūgų	ฟักทอง
prabanga	ฟุ่มเฟือย
prabanga	หรูหรา
elgeta	ขอทาน
aršios	ดุร้าย
aršios	ดุดัน
iban	iban
švari	ล้าง
švari	สะอาด
švari	clean
spiegel	spiegel
gimnastė	ยิมนาสติก
stefanie	stefanie
elf	เอลฟ์
rté	rté
alergijos	ภูมิแพ้
dešimtainis	ทศนิยม
algarvės	algarve
aja	aja
nena	nena
tatena	iaea
cvn	cvn
auerbach	auerbach
agüero	agüero
sugebėti	แท็งค์
sugebėti	ถัง
atsitiktinumas	บังเอิญ
budi	budi
kumite	kumite
bugas	บั๊ก
bugas	บัก
ccff	ccff
pudu	pudu
folikulų	follicular
wikivoyage	wikivoyage
spausdintuvai	เครื่องพิมพ์
narod	narod
sachsen	sachsen
bert	เบิร์ต
puyi	puyi
simferopolis	simferopol
pantera	เสือดำ
raukšlėtasis	ยับ
camino	camino
apreiškimas	transfiguration
serranus	serranus
prakaitavimas	เหงื่อ
vulgare	vulgare
mob	มาเฟีย
lopes	lopes
surenkamos	ประกอบ
kostroma	kostroma
boni	boni
kuklus	เจียม
kuklus	ถ่อม
sugerti	ซึมซับ
sugerti	ซึม
brokas	บร็อค
kamui	kamui
maculata	maculata
agliutinacinė	agglutinative
universalis	universalis
monza	monza
hotcat	hotcat
vrt	vrt
pasitelkti	ทางเท้า
tpp	tpp
kato	kato
armani	armani
duero	duero
mėginys	ตัวอย่าง
boksito	bauxite
fahrenheit	ฟาเรนไฮต์
benamių	หลง
žarnyną	ลำไส้
groteles	ตะแกรง
vpk	dac
ried	ried
tuneliuose	อุโมงค์
rodentia	rodentia
koncesijos	concession
severno	severn
kalkės	ปูน
kalkės	มะนาว
lokomotyvai	locomotives
ševčenka	shevchenko
amar	amar
générale	générale
hipotetinis	สมมติ
arimo	ไถ
joanas	joannes
jef	jef
roa	roa
neri	neri
bien	เบียน
kelione	ทัวร์
kelione	ทริป
irkutskas	irkutsk
nahuatl	nahuatl
cervidae	cervidae
rekombinacijos	recombination
mėlynės	ช้ำ
grazer	grazer
gdynės	gdynia
minaj	minaj
msn	msn
sintezatoriai	synthesizers
išlikimas	ชะตา
amen	สาธุ
amen	อาเมน
amen	เมน
camillo	camillo
neustadt	neustadt
cours	cours
mii	mii
vizijas	นิมิต
vizijas	นิมิตร
lcc	lcc
rota	rota
kietai	เท่ห์
kietai	เท่
kietai	เจ๋ง
kietai	เย็น
fhm	fhm
lounge	lounge
grybiena	mycelium
rote	rote
ins	อิน
mouton	mouton
deportacijos	เนรเทศ
gydytojos	เหว
ambox	ambox
wrestlemania	wrestlemania
murillo	murillo
mašinistas	ไดรเวอร์
nuolaidas	ส่วนลด
skystą	ละลาย
skystą	หลอมละลาย
rapa	rapa
togolandas	togoland
irian	irian
lolo	โลโล
lolo	โล
salotų	สลัด
melaneziečių	melanesian
prada	prada
dias	dias
vava	vava
cidade	cidade
reni	reni
triumviratas	triumvirate
miegu	นอน
irt	ict
tinktūra	ทิงเจอร์
kcal	kcal
preke	เทศนา
preke	ประกาศ
carlisle	คาร์ไลล์
carlisle	คาร์ไลส์
kašgaro	kashgar
evergreen	evergreen
sezamo	งา
mangai	มะม่วง
nepatogu	อึดอัด
medley	เมดเลย์
gerbiama	นับถือ
setmetatable	setmetatable
klintys	หินปูน
sesijas	เซสชั่น
sesijas	เซสชัน
asilas	ลา
roe	roe
roe	โร
vizos	วีซ่า
vizos	visa
vizos	วีซ่า
tamias	tamias
gazella	gazella
trad	trad
anastacia	anastacia
pavydas	อิจฉา
pavydas	ริษยา
pavydas	อิจฉา
directx	directx
tragiška	สลด
kleine	kleine
kontekstuose	contexts
švyti	ประกาย
švyti	ส่อง
švyti	เปล่งปลั่ง
nuostabiai	งดงาม
nuostabiai	งามๆ
nacht	nacht
haim	haim
canescens	canescens
siècle	siècle
macaca	macaca
krs	crs
kandi	kandi
sobieski	sobieski
mėginio	ตัวอย่าง
hansson	hansson
lamų	llama
mimo	mimo
tornabuoni	tornabuoni
animuoti	เคลื่อนไหว
offenbach	offenbach
ora	ora
megara	megara
banditai	โจร
kapitalizmas	ทุนนิยม
kula	kula
dumbarton	dumbarton
agurkai	แตงกวา
agurkai	แตงกวา
galvijams	วัว
galvijams	ปศุสัตว์
chirurgai	ศัลยแพทย์
valeria	valeria
rhein	rhein
tofu	เต้าหู้
sutapimas	บังเอิญ
gaudyklė	ดัก
valjadolido	valladolid
eigenmann	eigenmann
rimskis	rimsky
gprs	gprs
andrade	andrade
miela	หวานๆ
miela	หวาน
pontormas	pontormo
wikia	wikia
penza	penza
giovanna	giovanna
įvertis	คะแนน
wai	หวาย
tve	tve
colonna	colonna
prievarčio	pyloric
skundai	อุทธรณ์
antradienis	อังคาร
montesuma	moctezuma
konstruktyvizmas	constructivism
sufizmas	sufism
ivatės	iwate
leila	ไลลา
khun	ขุน
khun	ขุ่น
adp	adp
ilgaamžiškumo	durability
beludžistanas	balochistan
tero	tero
kvapų	น้ำหอม
gozo	gozo
artes	artes
ucla	ucla
torneo	torneo
ubs	ubs
michelin	michelin
piedras	piedras
sevastopolis	sevastopol
repeticija	ซ้อม
kreminė	creamy
kreminė	ครีม
įprotis	นิสัย
emerald	มรกต
emerald	emerald
vogti	ขโมย
nuolaidos	ส่วนลด
nuolaidos	ส่วนลด
lbf	lbf
visureigiai	suv
grynosios	ตาข่าย
grynosios	net
grynosios	สุทธิ
grynosios	เน็ต
grynosios	ถ้วน
įstrigo	ติด
linksmai	สนุก
linksmai	สนุกสนาน
skale	ขนมปัง
galvosūkiai	ปริศนา
smd	smd
federalistų	federalist
gaspar	gaspar
scrofa	scrofa
antakių	คิ้ว
ryškiau	สดใส
purvinas	สกปรก
purvinas	สกปรก
vitis	vitis
sumo	ซูโม่
gaudyklės	ดัก
toska	tosca
skala	skala
uvea	uvea
tinkantis	คู่ควร
pura	pura
džiulija	julia
qpr	qpr
oleksandras	oleksandr
cdna	cdna
sukneles	ชุด
iras	iras
oriente	oriente
videos	วีดีโอ
videos	วิดีโอ
kreditoriai	หนี้
hua	ฮวา
lepidus	lepidus
schulz	schulz
ultratop	ultratop
madagascariensis	madagascariensis
galvutes	นิวเคลียร์
efloras	efloras
sadi	sadi
takeliais	catwalk
gorda	gorda
rtecs	rtecs
araneae	araneae
ymca	ymca
gilinti	กระชับ
hakka	แคะ
svoboda	svoboda
fernand	fernand
demografiniai	ประชากรศาสตร์
sop	sop
juokiasi	หัวเราะ
hugenotai	huguenot
masažas	นวด
frazier	frazier
suprojektuotos	ออกแบบ
engl	engl
piaf	piaf
tetija	tethys
kuipers	kuipers
melionai	แตง
seri	เสรี
ridl	ridl
vakcinacijos	วัคซีน
išbandyta	ทดสอบ
katlėja	cattleya
balkonas	ระเบียง
ubisoft	ubisoft
herz	herz
flamengo	flamengo
germanikas	germanicus
skanus	อร่อย
skanus	อร่อย
sak	กระสอบ
okeanografijos	oceanographic
mun	มูล
mun	mun
doe	โด
doe	ใสๆ
etiketo	มารยาท
baltažiedis	arabidopsis
coor	coor
bom	bom
drėgnis	ความชื้น
drėgnis	ความชื้น
dvoržakas	dvořák
šypsena	ยิ้ม
šypsena	smile
piratavimas	eka
okw	okw
trina	trina
taça	taça
sartre	sartre
sdk	sdk
rhs	rhs
lomas	lomas
township	ตำบล
township	สิริ
nordisk	nordisk
paradisaea	paradisaea
corot	corot
kendall	kendall
qantas	qantas
qcd	qcd
sti	sti
joplin	joplin
deportiva	deportiva
apeliacijos	อุทธรณ์
dart	โผ
išimtinė	exclusive
išimtinė	พิเศษ
münster	münster
sliekas	หนอน
checktype	checktype
jangdzė	yangtze
dansk	dansk
teke	teke
migrantai	ต่างด้าว
mehmet	mehmet
loja	เห่า
npg	npg
bananus	กล้วย
esperanza	esperanza
kvk	cmc
ddr	ddr
rufa	rufa
nanda	nanda
gsd	gsd
susirūpinęs	กังวล
susirūpinęs	ห่วง
dėžėse	กล่อง
skiepijimas	วัคซีน
tuščiaviduriai	โพรง
funky	funky
uvertiūra	โหมโรง
const	const
chem	เคมี
chiara	chiara
jørn	jørn
lėtinio	เรื้อรัง
spö	spö
vargšai	คนจน
vargšai	ยากจน
keto	keto
pasveikti	หาย
pasveikti	รักษา
pasveikti	เยียวยา
topografija	ภูมิประเทศ
nailono	nylon
nailono	ไนลอน
monopolis	เศรษฐี
kokso	โค้ก
kokso	โคเคน
sesilija	cécile
tts	tts
patinimas	บวม
dlr	dlr
gamerankings	gamerankings
grietinėlė	ครีม
odė	ode
verrucosa	verrucosa
gabaliukai	เศษ
gabaliukai	ชิ้น
uždraudimas	แบน
yao	เหยาะ
yao	เหยา
mainsnak	mainsnak
missa	missa
turkestanas	turkestan
equus	equus
spinosa	spinosa
paguodos	สบาย
paguodos	สบายใจ
orumo	ศักดิ์ศรี
daigai	ถั่วงอก
momentus	moments
klee	klee
lomonosovas	lomonosov
leven	leven
selasie	selassie
nuostabios	เยี่ยม
nuostabios	วิเศษ
deguto	tar
alles	alles
fernanda	fernanda
artefaktas	วัตถุ
sqmi	sqmi
drausmė	วินัย
laukimas	รอ
mova	sleeve
punctatus	punctatus
tondo	tondo
dich	dich
brokeris	โบรกเกอร์
brokeris	broker
jfk	jfk
kutai	พู่
samguk	samguk
blazer	blazer
totorio	tottori
erhard	erhard
standus	แข็ง
muay	muay
muay	มวย
shoten	shoten
wmflabs	wmflabs
mti	mti
adr	adr
wmf	wmf
motacilla	motacilla
tomáš	tomáš
luv	รัก
daugiklis	factor
daugiklis	ตัวประกอบ
daugiklis	ปัจจัย
bjaurus	ขี้เหร่
rezginys	plexus
vitesse	vitesse
plaušienos	pulp
injekcija	ฉีด
rutaceae	rutaceae
dešros	ไส้กรอก
montreux	montreux
politopas	polytope
ustinovas	ustinov
insularis	insularis
alpinizmas	mountaineering
munch	munch
nusa	nusa
gris	gris
ping	ping
ping	ผิง
glutamatas	glutamate
kristobalio	cristóbal
razinos	ลูกเกด
tempti	ลาก
marui	marui
ketvirtadieniais	พฤหัส
ketvirtadieniais	พฤหัสฯ
ketvirtadieniais	พฤหัสบดี
silvestris	silvestris
oriksas	oryx
baikonuro	baikonur
komforto	สบาย
komforto	สบายใจ
worldstatesmen	worldstatesmen
antakiai	คิ้ว
antonius	antonius
nrhp	nrhp
kari	kari
beos	beos
sylvatica	sylvatica
combo	คอมโบ
balnas	อาน
fani	fanny
unita	unita
adidas	adidas
tes	เทส
dae	แด
chakasija	khakassia
našlys	หม้าย
jerez	jerez
trachypithecus	trachypithecus
blogspot	blogspot
furukawa	furukawa
kapitalistinės	นายทุน
ganosi	ถาก
dangčiu	ฝา
mandagumo	มารยาท
pigūs	ถูกๆ
peirce	peirce
passo	passo
strigidae	strigidae
pagalvė	หมอน
ketvirtadienio	พฤหัส
ketvirtadienio	พฤหัสฯ
ketvirtadienio	พฤหัสบดี
tiara	เกล้า
cianido	ไซยาไนด์
karoliukai	ประคำ
maa	mam
investavimas	ลงทุน
drąsūs	กล้า
princeps	princeps
brueghel	brueghel
usgs	usgs
pripetė	pripyat
orumas	ศักดิ์ศรี
citationclass	citationclass
fontanų	น้ำพุ
šakniavaisiai	รากฐาน
šakniavaisiai	ราก
matytas	คุ้นๆ
matytas	คุ้น
sanctus	sanctus
murat	murat
rustamas	rustam
mtb	mtb
kyšininkavimo	สินบน
mihai	mihai
žemapelkės	fens
atvirukus	โปสการ์ด
grb	grb
bakufu	bakufu
ajaccio	ajaccio
gerbia	เคารพ
tis	tis
nepenthaceae	nepenthaceae
metropolitana	metropolitana
lieder	lieder
kahn	คาห์น
superbike	superbike
christus	christus
subotica	subotica
gmo	gmos
linn	linn
mah	mah
nausikaja	nausicaa
tvm	tvm
aurelianas	aurelian
kvalifikacijų	คุณวุฒิ
kvalifikacijų	วุฒิ
laido	ลวด
darbštus	ขยัน
sps	sps
zimmermann	zimmermann
aga	aga
kabila	kabila
cimbolai	zildjian
aki	อากิ
aki	อะกิ
aki	aki
termitai	ปลวก
komentuoti	หมายเหตุ
raiden	raiden
falconiformes	falconiformes
csi	csi
nežinojimo	งมงาย
longa	longa
karūnas	การุณย์
telegrafas	โทรเลข
alkoholiai	alcohols
šakočius	flava
skėčiai	ร่ม
išdžiovinti	แห้ง
airplay	airplay
pagalvėlės	cushion
paranoja	หวาดระแวง
paranoja	ระแวง
paranoja	หวาดระแวง
noël	noël
hermes	hermes
sodinimo	ปลูก
taikikliai	ทิวทัศน์
renaud	renaud
iltimis	เขี้ยว
popietę	บ่าย
apgyvendinimą	ที่พัก
savikaina	ต้นทุน
likvidumas	คล่อง
bleikas	เบลค
bleikas	เบลก
bleikas	ลค
ncbi	ncbi
spectabilis	spectabilis
komentaruose	หมายเหตุ
komentaruose	คอมเมนท์
mendelejevas	mendeleev
triušio	กระต่าย
hidrolizės	hydrolysis
papiamento	papiamento
vashem	vashem
cisc	cisc
posix	posix
targa	targa
lengua	lengua
miserere	miserere
chavannes	chavannes
música	música
surištos	ผูกพัน
rolfe	rolfe
taira	taira
iškalbos	โวหาร
seurat	seurat
ramírez	ramírez
fatih	fatih
odoakras	odoacer
pavydi	อิจฉา
pavydi	หึง
spu	spu
iškęsti	ยืนยง
bičas	dude
cura	cura
suis	suis
amt	amt
erzina	รำคาญ
erzina	ท้อแท้
peres	peres
jabbar	jabbar
verkti	ร้องไห้
stirnabudė	personata
fei	กวาด
diener	diener
psg	psg
arion	arion
kojines	ถุงเท้า
kojines	socks
puodus	หม้อ
kleist	kleist
kau	kau
iptv	iptv
mineiro	mineiro
nicki	nicki
titan	titan
išplauti	เกย
blick	blick
emanuele	emanuele
kalvadosas	calvados
kis	dude
kis	ciu
meškėnas	แรคคูน
motorsport	motorsport
košice	košice
bor	bor
bfc	bfc
čiau	ciao
mulas	ล่อ
mls	mls
grioveliais	ร่อง
raudonuodegės	phoenicurus
gigi	gigi
xxxv	xxxv
sistano	sistan
orazio	orazio
aristidas	aristide
bua	บัว
kal	คา
migrena	ไมเกรน
susanne	susanne
getparent	getparent
insulinas	อินซูลิน
naštą	ภาระ
trinita	trinita
insignis	insignis
madinga	แฟชั่น
messe	messe
sultingi	ฉ่ำ
samdinys	รับจ้าง
cori	cori
malatesta	malatesta
veleno	ด้าม
veleno	เพลา
kodžiki	kojiki
koi	koi
nuolaida	ส่วนลด
arxiv	arxiv
daf	daf
iberia	iberia
asl	asl
frankfurter	frankfurter
rudess	rudess
pyrsas	เพียซ
apmokymą	mentor
musorgskis	mussorgsky
uomo	uomo
pflanzen	pflanzen
currentsinglesranking	currentsinglesranking
pál	pál
snmp	snmp
africana	africana
elephas	elephas
smg	smg
sfsr	sfsr
protestuoti	ประท้วง
mita	mita
smailių	peaks
navbar	navbar
cena	cena
profiliai	โปรไฟล์
ronaldinho	ronaldinho
savonarola	savonarola
zane	เซน
dzedunas	zedong
fab	fab
mandragora	mandragora
icd	icd
soong	soong
gin	gin
gin	จิน
virgen	virgen
livre	livre
idealu	อุดมคติ
makrofagų	macrophages
mollis	mollis
mitingus	หล่า
mitingus	หลวย
propagavimas	โปรโมท
propagavimas	โปรโมชัน
hopas	โรย
lom	หล่ม
lom	lom
dividendai	เงินปันผล
liejinių	casting
direktoratas	directorate
pozityvizmas	positivism
geforce	geforce
elegija	elegy
ilgesio	ปรารถนา
sohc	sohc
duval	duval
degeneres	degeneres
dolce	dolce
nasser	nasser
išaiškinimas	ตีความ
išaiškinimas	ทำนาย
ghirlandaio	ghirlandaio
mies	mies
inis	inis
portret	portret
coulibaly	coulibaly
moz	มอซ
moz	มอ
pelningas	กำไร
įdaryti	ยัด
banksy	banksy
imbiero	ขิง
köhler	köhler
clio	clio
parengtus	สไตล์
clément	clément
tif	tif
aminai	amines
nvidia	nvidia
shabab	shabab
alenia	alenia
zhu	จู
galatėja	galatea
rūpinimasis	ห่วงใย
dariusz	dariusz
sylvain	sylvain
euronymous	euronymous
muaythai	muaythai
muaythai	มวยไทย
reiner	reiner
plantacija	ไร่
ontologija	ontology
shlomo	shlomo
krebso	krebs
kono	โคน
guichard	guichard
castelli	castelli
slobodan	slobodan
atf	atf
sapienza	sapienza
šiltine	typhoid
heidelbergensis	heidelbergensis
ignoruojami	ละเว้น
ding	ติง
įgudę	ช่ำชอง
bajan	bayan
sodininkai	ชาวสวน
pusbroliai	ญาติ
heidegger	heidegger
tabasko	tabasco
febė	ฟีบี
papadopoulos	papadopoulos
elongata	elongata
gmp	gmp
asiatique	asiatique
carlsson	carlsson
europäische	europäische
charizma	เสน่ห์
draugiška	มิตร
bae	เบ
bae	เบเบ
bae	ที่รัก
bae	เบย์
bae	เบย
osama	osama
maišymo	กลมกลืน
drugelis	ผีเสื้อ
pusillus	pusillus
eso	eso
ibby	ibby
lomo	lomo
grassi	grassi
pygmaea	pygmaea
nyc	nyc
skagerako	skagerrak
zebrai	ม้าลาย
cccc	cccc
torunė	toruń
vermandua	vermandois
aum	อั้ม
aum	aum
pygmaeus	pygmaeus
kcl	kcl
spalvingų	สีสัน
kraina	carniola
ninox	ninox
šeivikaulio	น่อง
motinoms	มารดา
medšarkės	lanius
stratigrafija	stratigraphy
juoktis	หัวเราะ
vers	กลอน
vers	ท่อน
dziang	เจียง
saladas	salado
filipinas	filipinas
ateik	มา
verkia	ร้องไห้
verkia	ร้องไห้
organoidai	organelle
siurrealizmas	surrealism
vengimo	เลี่ยง
schmitt	schmitt
övp	övp
hof	hof
troye	troye
žievelės	เปลือก
žievelės	ปลอก
citratas	citrate
antagonistai	antagonists
perm	ดัด
darbotvarkę	กำหนดการ
darbotvarkę	วาระ
valio	เร่
valio	เย
valio	เย่
sunaudojimas	บริโภค
aze	aze
tambo	tambo
galant	galant
mijako	miyako
mki	mki
pfc	pfc
rido	rideau
garažas	อู่
garažas	โรงรถ
civitas	civitas
plasmodium	plasmodium
orkaitėje	เตา
žąsinas	ทึ่ม
pang	บัง
pang	pang
telegrama	โทรเลข
absorbuoti	ซึมซับ
absorbuoti	ซึม
ovario	owari
masas	meuse
ika	ika
longford	longford
bak	บาก
eisner	eisner
exp	exp
ifc	ifc
commedia	commedia
matra	matra
kimberley	kimberley
ayew	ayew
agurkas	แตงกวา
steindachner	steindachner
sungai	sungai
cinereus	cinereus
roald	roald
annalen	annalen
neteisingą	เกล
kalbėtojų	ลำโพง
sveikinimai	สวัสดี
sveikinimai	ทักทาย
nuomojamas	เช่า
domine	domine
coetzee	coetzee
vados	กระบะ
ort	ort
nevskis	nevsky
varles	กบ
herta	herta
grynieji	ตาข่าย
grynieji	net
grynieji	สุทธิ
grynieji	เน็ต
grynieji	ถ้วน
grynieji	แคช
grynieji	เงิน
grynieji	เงินสด
grynieji	cash
bukit	บูกิต
kilogramas	กิโลกรัม
mergaite	สาว
sorbai	sorbs
dscn	dscn
utu	utu
peña	peña
paleontologija	palaeontology
pacifica	pacifica
tep	tep
sudrebino	เขย่า
birmoje	พม่า
folija	ฟอยล์
prosperas	prospero
corylus	corylus
nativity	ประสูติ
reuters	reuters
xxxvi	xxxvi
ene	annie
alpinus	alpinus
kempė	gibbosa
messerschmitt	messerschmitt
sgi	sgi
kpa	kpa
petite	petite
girnelės	เอ็น
vadžrajana	vajrayana
historische	historische
cathy	แคธี
huracán	huracán
afs	afs
nkp	พังงา
urų	uru
mong	มง
kambarinė	คนใช้
pliuralizmo	pluralism
publicationdate	publicationdate
frères	frères
markusas	มาร์คัส
snak	snak
supermenas	superman
dorsalis	dorsalis
muzikologija	musicology
alerginės	ภูมิแพ้
gvazdikų	คาร์เนชั่น
mėlynė	ช้ำ
ott	ott
tuomas	tuomas
joja	ขี่
forex	forex
sidonas	sidon
forsyth	forsyth
bum	ตูม
bum	บูม
hobis	hobby
mur	mur
plagioklazas	plagioclase
paavo	paavo
apencelis	appenzell
vegan	มังสวิรัติ
calvus	calvus
demonstravimo	สาธิต
nums	nums
scorpions	แมงป่อง
borneensis	borneensis
ambrosio	ambrosio
ašoka	โศก
tennant	tennant
kranas	เครน
capitis	capitis
blackberry	blackberry
rusa	rusa
herato	herat
wojna	wojna
laukiai	แก่ง
laukiai	คูต
orm	orm
icmp	icmp
mou	โม
mou	moe
bdsm	bdsm
tualetai	ส้วม
honneur	honneur
chromas	chrome
chromas	โครม
phoiac	phoiac
eteeq	eteeq
marginata	marginata
jpn	jpn
dėkui	ขอบคุณ
loaddata	loaddata
ritiniai	ม้วน
xxxiii	xxxiii
išnaudojama	เหนื่อย
natūralizmas	naturalism
išrašas	คลาย
peterborough	peterborough
wyclef	wyclef
ludacris	ludacris
özil	özil
kumo	kumo
kamal	kamal
chf	chf
crocodylus	crocodylus
kintamumas	variability
kintamumas	ผันผวน
bijūnas	anomala
budelio	hangman
demos	สาธิต
demos	demos
seligman	seligman
thérèse	thérèse
valdemar	waldemar
josep	josep
reale	reale
nishimura	nishimura
gau	gau
qos	qos
močiutės	ยาย
sagrada	sagrada
flavus	flavus
nowiki	nowiki
jukka	jukka
jesper	jesper
iffhs	iffhs
lune	lune
hala	hala
gelbėjimas	กู้ภัย
laukiu	รอ
pravda	pravda
cis	cis
biographisches	biographisches
lautrec	lautrec
hee	ฮี
draugišką	มิตร
mammuthus	mammuthus
hidalgas	hidalgo
sankti	sancti
alpina	alpina
vvg	ล่าช้า
vvg	lag
vvg	ชักช้า
visuomenes	สังคม
transformatorių	transformer
transformatorių	หม้อแปลง
viršenybė	primacy
fcc	fcc
cerera	ceres
langedokas	languedoc
požemiai	dungeons
mma	mma
vlt	vlt
ecm	ecm
įsivaizduojamą	จินตนาการ
vonia	อ่าง
vonia	อ่างอาบน้ำ
vonia	อาบ
duk	faq
nosinės	ผ้าเช็ดหน้า
sunaikins	ทุบ
charizmatiškas	บารมี
vieillot	vieillot
esporte	esporte
serino	serine
virves	เชือก
iggy	iggy
nustebinti	เกรง
nustebinti	หวั่น
ibc	ibc
atvirukas	โปสการ์ด
atvirukas	ไปรษณียบัตร
gmelin	gmelin
jazira	jazira
gmail	gmail
pistacia	pistacia
adv	adv
ginčijo	พิพาท
ricard	ricard
corrado	corrado
vaidenasi	สิง
vaidenasi	สิงค์
vaidenasi	หลอน
pūkuotukas	บวม
kamo	kamo
virginiana	virginiana
vikinaujienos	wikinews
kadžarų	qajar
moa	moa
pupa	พลอย
temporalis	temporalis
monopolijos	เศรษฐี
apis	api
samojiečiai	samoans
verso	verso
friuli	friuli
pakabukas	จี้
delnų	ฝ่ามือ
delnų	ปาล์ม
debeto	เดบิต
vivir	vivir
corax	corax
deloitte	deloitte
nacionalistinių	ชาตินิยม
tap	แตะ
tap	แท็ป
susidomėję	สนใจ
archangelskas	arkhangelsk
gba	gba
fulvus	fulvus
despotija	despotate
ausf	ausf
tunas	ทูน่า
peticija	คำร้อง
vakajamos	wakayama
trečiadienis	พุธ
sukčiavimas	ฉ้อโกง
garibay	garibay
hasbro	hasbro
disociacijos	dissociation
sine	ไซน์
daugybes	ท่วม
aon	aon
trubadūras	troubadour
ibara	ibarra
krieg	krieg
nendrė	phragmites
ekstazės	ปลาบปลื้ม
khaled	khaled
blau	blau
runabout	runabout
dha	dha
stromos	stromal
presbiterionai	presbyterianism
schleswig	schleswig
basano	bassano
marlou	marlowe
brun	brun
michiel	michiel
sasa	sasa
tah	tah
bahnhof	bahnhof
kantonuose	orientales
vienkartinės	ก้อน
rais	rais
valentinianas	valentinian
kir	kir
hibridinių	ลูกผสม
györgy	györgy
dello	dello
werke	werke
tver	tver
repubblica	repubblica
eglise	eglise
vltavos	vltava
pliuralizmas	pluralism
edizioni	edizioni
hale	เฮล
kiaulėms	หมู
darbotvarkė	กำหนดการ
darbotvarkė	วาระ
gtb	gtb
medvilniniai	สายไหม
medvilniniai	ฝ้าย
medvilniniai	cotton
getelementbyid	getelementbyid
sūdyta	เค็ม
tarkvinijus	tarquinius
tunai	ทูน่า
apa	ลิง
bundestagas	bundestag
lebron	lebron
kurortuose	รีสอร์ท
lhs	lhs
fishbase	fishbase
volodymyras	volodymyr
ašara	ฉีก
ašara	น้ำตา
stimpankas	steampunk
magnetas	magnet
bund	bund
sija	วงเล็บ
einar	einar
moulin	moulin
žavesio	เสน่ห์
pictus	pictus
severin	severin
žnyplėmis	คีม
žnyplėmis	คีบ
ntv	ntv
schwarzenegger	schwarzenegger
džoana	โจน
vergine	vergine
echnatonas	akhenaten
heinemann	heinemann
ramu	เงียบ
ramu	สงบ
ramu	สันติ
bru	บรู
bru	บรูก
ipo	ipo
parašiau	เขียน
sorbitolis	sorbitol
saugikliai	ฟิวส์
imago	imago
turdidae	turdidae
lfc	lfc
atrakcija	แรงดึงดูด
artigas	artigas
kiekybinis	quantitative
franken	franken
yitzhak	yitzhak
balkonai	ระเบียง
lite	lite
rac	rac
cochrane	cochrane
cooh	cooh
jacinto	jacinto
racer	racer
laimikis	ก้น
mariusz	mariusz
einaudi	einaudi
endotelio	endothelial
tek	tek
žiedlapiai	กลีบ
jugra	yugra
džirolamas	girolamo
ganykla	eng
androgenai	androgens
savanorišką	อาสา
gaertn	gaertn
uccello	uccello
benedictus	benedictus
maksimiljanas	maximilien
henrique	henrique
ankor	นคร
famiglia	famiglia
svgborder	svgborder
hieronymus	hieronymus
katrin	katrin
maclean	maclean
honthorst	honthorst
shtml	shtml
nenugalimas	คงกระพัน
édition	édition
varia	varia
klonavimas	โคลนนิ่ง
marža	ขอบ
tjk	tjk
monodelphis	monodelphis
nepriklausomumas	อิสรภาพ
nepriklausomumas	เอกราช
hakeris	แฮกเกอร์
iib	iib
vela	vela
lenz	lenz
sūdyti	เค็ม
fermentuoti	หมัก
amboise	amboise
užkrėstas	เจือปน
ulla	ulla
tyson	tyson
asc	asc
myriam	myriam
nowitzki	nowitzki
sela	cella
iškritimas	relegation
borch	borch
strypai	แท่ง
bibi	bibi
gyja	เยียวยา
kiekybiniai	quantitative
bobą	ดูด
ūmaus	เฉียบพลัน
finikija	phoenicia
sdtv	sdtv
parlophone	parlophone
kepsnys	สเต็ก
gara	gara
tunica	tunica
oper	oper
pasigailėjimo	เมตตา
pasigailėjimo	ปราณี
roadster	roadster
sylva	sylva
crivelli	crivelli
tatlinas	tatlin
kosmodromas	cosmodrome
slaugytoja	พยาบาล
balandėliai	คู่รัก
paribas	paribas
grenoble	grenoble
intermedius	intermedius
masaru	masaru
candida	candida
mėšlas	ปุ๋ย
chong	ชอง
chuntai	uprising
klestinčios	รุ่งเรือง
mcgee	แมคกี
iškastinio	ดึกดำบรรพ์
iškastinio	ฟอสซิล
iškastinio	ซากดึกดำบรรพ์
tbt	icc
plūgas	ไถ
plūgas	ไถนา
beluga	beluga
padėklai	ถาด
ovata	ovata
dasa	dasa
fotometrija	photometry
udmurtija	udmurtia
cham	จาม
sinica	sinica
wojny	wojny
amata	amata
nusivylę	หงุดหงิด
nusivylę	ท้อแท้
aptvarų	ฟันดาบ
familjebok	familjebok
susižavėjimo	ชื่นชม
sacharinas	saccharin
ūml	aml
puiku	เยี่ยม
puiku	ยอด
nijhoff	nijhoff
bcl	bcl
hno	hno
antspaudus	แสตมป์
cruzeiro	cruzeiro
vevo	vevo
montanus	montanus
veltinio	รู้สึก
sriubą	ซุป
apgavo	โกง
kickstarter	kickstarter
jasmin	jasmin
nebloga	รั่ว
abortą	ทำแท้ง
abortą	แท้ง
prodcode	prodcode
rune	rune
vecchi	vecchi
išpažinties	สารภาพ
chardin	chardin
undiano	undiano
linecolor	linecolor
komandiruotės	ทูต
komandiruotės	ภารกิจ
abdu	abdu
fuerteventura	fuerteventura
rand	แรน
rand	แรนด์
kitano	kitano
ntfs	ntfs
alberti	alberti
tutanchamonas	tutankhamun
powerpoint	powerpoint
akai	akai
robbia	robbia
aha	ใช่
aha	ใช่
aha	เย่
herbst	herbst
bateliai	รองเท้า
zainal	zainal
čiulpia	ห่วย
trisomija	trisomy
sdb	sdb
svensson	svensson
sgml	sgml
benešo	beneš
dėkingi	กตัญญู
oldid	oldid
salamas	ซาลาม
kneseto	knesset
ait	ait
tutu	tutu
streptokokai	streptococci
palembangas	palembang
mlb	mlb
ananasų	สับปะรด
iloilo	iloilo
žvakė	เทียน
žvakė	เทียนไข
diplomat	ฑูต
rehder	rehder
habilis	habilis
iaa	iaa
totalitarinių	totalitarian
bump	ตุ่ม
bump	กระแทก
idealizmas	อุดมการณ์
oriolas	oryol
kazuki	kazuki
sierpinski	sierpinski
livius	livius
wrx	wrx
kembridžšyras	cambridgeshire
allori	allori
sbs	sbs
sportivo	sportivo
ifbb	ifbb
bakshi	bakshi
kralovė	králové
klausti	ถาม
klausti	สอบถาม
galvoju	คิด
lašišinės	salmonidae
glaukoma	ต้อหิน
ergaster	ergaster
jakutskas	yakutsk
triukas	ทริค
manerheimo	mannerheim
uncia	uncia
bulvare	blvd
ssn	ssn
juokinga	ขัน
juokinga	ตลก
juokinga	ขำ
goldene	goldene
yunnanensis	yunnanensis
sąžiningą	แฟร์
sąžiningą	ยุติธรรม
ginčijamas	พิพาท
sns	sns
karpos	หูด
adh	adh
domus	domus
šlapimtakių	ureter
alu	alu
cucumis	cucumis
alerginė	ภูมิแพ้
isidro	isidro
instagram	instagram
kiekybinė	quantitative
fallax	fallax
popo	popo
tva	tva
alkanas	หิว
bsp	bsp
mmo	mmo
iain	iain
horner	horner
magnetitas	magnetite
smilkalus	ธูป
ffa	ffa
trachėja	หลอดลม
širdy	heart
širdy	ใจ
širdy	หัวใจ
skiedinio	ครก
musonas	มรสุม
dscf	dscf
baisios	แย่
baisios	สาหัส
stallman	stallman
mlg	mlg
puokštė	ช่อ
akumuliatoriai	แบตเตอรี่
subalansuotas	สมดุล
balkarija	balkaria
šluotos	ไม้กวาด
ribosomos	ribosomal
théâtre	théâtre
surtees	surtees
suhrkamp	suhrkamp
rajė	rayet
vantaa	vantaa
superba	superba
deportes	deportes
aldridge	aldridge
veranda	ระเบียง
wikiproject	wikiproject
ahn	อัน
kilnojamasis	movable
šolochovas	sholokhov
medica	medica
įsiurbimo	ดูด
serozinis	serous
alebarda	halberd
