nuoga	naked
manu	manu
ješiva	yeshiva
chemie	chemie
pingvinai	penguins
timisoara	timisoara
sinatra	sinatra
suformuluoti	tiêm
kon	kon
įterpti	chèn
omx	omx
grobis	capture
grobis	prey
andronikas	andronikos
origami	origami
urartų	urartian
kalikstas	calixtô
dima	dim
dima	dima
hoffmann	hoffmann
hoffmann	hoffman
lippi	lippi
fidi	chateau
apelsinų	cam
mazowieckie	mazowieckie
ericsson	ericson
ericsson	ericsson
medūzos	sứa
dvynys	twin
dvynys	song
amžina	mải
novodevičės	novodevichy
segunda	segunda
ulmanis	ulmanis
setas	seth
batus	giày
batus	bốt
batus	ủng
batus	boots
suvirinimo	hàn
akordeonas	accordion
aromato	aroma
pilvą	bụng
tech	ktv
diablo	diablo
kopūstai	bắp
gizos	giza
porta	porta
gaidukas	ruff
crest	crest
loa	loa
aliejai	oils
mora	mora
madre	madre
czesław	czesław
paraguay	asunción
alvaras	alvar
kandži	kanji
alyva	nhớt
alyva	dầu
vejle	vejle
kaskada	cascade
klijai	keo
lauda	lauda
vieversys	lark
rodriguez	rodriguez
radikalų	radicals
bilietas	vé
ldp	ldp
akcentas	suppress
brahmos	brahmos
cosmos	cosmos
kiaušidės	ovarian
hart	hart
gomes	gomes
mergedrow	mergedrow
hansa	hansa
chiesa	chiesa
baitų	byte
elegans	elegans
serravalle	serravalle
vilkikas	tractor
vilkikas	tug
zabrze	zabrze
maiden	maiden
algos	lương
muller	muller
florijonas	florian
išmokyti	dạy
roc	roc
roc	róc
ffd	ffd
atspindžiai	reflections
gavėjas	receiver
frida	frida
lamu	lamu
blanc	blanc
kendo	kendo
biskajos	biscay
hegemonija	hegemony
tropicos	tropicos
luís	luis
luís	luís
feraros	ferrara
sąjungininkas	ally
berklio	berkley
azul	azul
malo	malo
gora	gora
groupstyle	groupstyle
hagen	hagen
kvepalai	perfume
klijų	keo
quo	quo
stojimo	accession
sankcijos	phạt
vladivostoko	vladivostok
lemūras	lemur
požemių	underworld
sodinti	trồng
sodinti	cấy
karlsruhe	karlsruhe
brunėjus	brunei
lindgren	lindgren
duisburg	duisburg
witold	witold
dusios	dytiscidae
bursa	bursa
karnavalas	carnival
fierro	fierro
karina	karin
karina	carina
karina	karina
ūkininkus	ngã
ira	ira
moderno	moderno
gilmour	gilmour
dateformat	dateformat
robotai	robot
robotai	robots
sokoto	sokoto
gaja	gaia
energingai	vigorous
laz	laz
motu	motu
vadis	vadis
kupolu	dome
kupolu	vòm
purana	purana
mantra	mantra
birmos	burma
birmos	miến
galvonis	encephalartos
kia	kia
vaccinium	vaccinium
rymano	riemann
pyragas	bánh
įgimta	congenital
gansu	gansu
kalnodara	orogeny
rikis	ricky
ištvermės	perseverance
cox	cox
chang	chang
moi	moi
driežas	lằn
anarchija	hỗn
bėgikė	runner
thornton	thornton
pašaras	feed
pašaras	forage
jakub	jakub
amazon	amazon
justo	justo
spurs	spurs
concordia	concordia
gasparas	gasparo
ervinas	ervin
zoo	thú
zoo	zoo
jėgeriai	jaeger
rada	rada
satyras	satyr
hubert	hubert
spin	spin
spin	quay
dorota	dorota
chmelnickio	khmelnytsky
fuji	fuji
vargo	khổ
vargo	misery
esteban	esteban
gerovė	vượng
prl	prl
tulūzos	toulouse
grietinėlės	kem
grietinėlės	cream
angelica	angelica
universitatis	universitatis
footballdatabase	footballdatabase
dimorfizmas	plumage
occidentalis	occidentalis
chorasano	khorasan
dervos	băm
dervos	hash
dervos	resin
sujungimas	interconnection
akureyri	akureyri
marškiniai	áo
mali	mali
mariner	mariner
nov	nov
emeritas	emeritus
kelionėms	du
wilder	wilder
vaiduoklis	ghost
vaiduoklis	ma
uri	uri
baja	baja
kana	canna
stabdymo	phanh
magelanas	magellan
maurjų	maurya
avivas	aviv
berat	berat
berkeley	berkeley
kilmarnock	kilmarnock
hofmanas	hoffman
ostrovskis	ostrovsky
saulėlydžio	twilight
bai	bạch
tiranos	tirana
suahilių	swahili
harbour	cảng
dietos	diêt
emo	emo
morton	morton
turfano	turfan
lightblue	lightblue
bretanės	bretagne
bretanės	brittany
tnt	tnt
dragan	dragan
nardymo	lặn
amon	amon
vudu	voodoo
rahman	rahman
išdavystę	phản
rush	rush
royale	royale
pastabas	comments
tora	tora
niro	niro
fantazija	fantasy
dachau	dachau
demetra	demeter
širovas	shirov
karabinas	carbine
keltu	đò
keltu	ferry
keltu	phà
fredas	hòa
kragas	podiceps
vonios	tắm
vonios	bad
vonios	bath
vonios	tắm
aptikimo	detection
polonija	polonia
amati	amati
kofeino	caffeine
holland	holland
tesla	tesla
saro	saarland
iglesias	iglesias
amphiprion	amphiprion
vezuvijaus	vesuvius
volframo	tungsten
volframo	vonfram
volframo	wolfram
damiano	damiano
sibiu	sibiu
sforza	sforza
karlsonas	carlson
polinezija	polynesia
kasitų	kassite
pavlovas	pavlov
dejan	dejan
pecs	pecs
poemas	poemas
hendrix	hendrix
persona	persona
grasino	tiềm
timūras	timur
elbasan	elbasan
pusrutulių	hemispheres
gem	gem
zee	zee
močiutė	bà
močiutė	bà
močiutė	granny
močiutė	ngoại
jefferson	jefferson
bantu	bantu
mintimis	suy
erdvėlaivių	spacecraft
saugi	an
tiesas	truths
kelnes	quần
kelnes	quần
palmira	palmira
karstas	rương
nic	nic
tigrajų	tigrinya
orientalis	orientalis
insulino	insulin
benevento	benevento
chomsky	chomsky
hopkins	hopkins
kasyba	mỏ
mobygames	mobygames
agustín	agustin
salo	salo
laboratorijų	laboratories
cfa	cfa
tarasovas	tarasov
tadžikai	tajiks
kay	kay
pasauliai	worlds
grampus	grampus
impulso	nhịp
impulso	mạch
tokugava	tokugawa
ari	ari
française	française
vps	vps
bhakti	bhakti
femme	femme
lana	lana
rosita	rosita
nagasakio	nagasaki
žiniatinklio	web
morales	morales
galutiniai	final
galutiniai	bum
nuomininkai	tenants
aliaska	alaska
horizontalus	ngang
mvp	mvp
akacijų	keo
akacijų	acacia
motociklai	môtô
garda	garda
prometėjas	prometheus
alf	alf
koro	koro
brodvėjaus	broadway
ile	île
populus	populus
bundesliga	bundesliga
kaisaka	asper
volgogrado	volgograd
volgogrado	belgrade
lėja	leah
baudžiava	serfdom
pikselių	pixel
formica	formica
acipenser	acipenser
varliagyviai	amphibians
tojotomi	toyotomi
marica	marica
uzbekai	uzbeks
fleming	fleming
traktoriai	tractor
kamuolinis	globular
sudomino	janet
pirin	pirin
breslau	breslau
panteono	pantheon
ilio	ili
selo	selo
berchem	berchem
svidleris	svidler
šilta	ấm
breda	breda
petri	petri
rowell	rowell
duncan	duncan
atverti	download
atverti	mở
atverti	má
olmekų	olmec
conmebol	conmebol
gerd	gerd
aguonų	poppy
transporte	transporte
kilpą	lặp
tricolor	tricolor
karteris	carter
viljandžio	viljandi
ekologinio	organic
guerra	guerra
išilginės	longitudinal
kaledonija	caledonia
srb	srb
paprašyti	bảo
paprašyti	hỏi
guillermo	guillermo
pasmerktas	doomed
vertigo	vertigo
mussolini	mussolini
kler	claire
girėjus	giray
lankstus	dẻo
mtz	mtz
elite	elite
royce	royce
skerdynės	carnage
clamp	kẹp
maurai	moor
maurai	moors
arkadijus	arkady
korozijos	corrosion
malone	malone
drąsos	dũng
drąsos	chống
palaima	blessing
improvizacija	improvisation
bikini	bikini
kėdžių	ghế
plėvelė	phim
plėvelė	film
barų	thanh
timas	tim
karščiavimas	sốt
kiaušidžių	ovarian
susirėmimų	clashes
užterštas	độc
blackmore	blackmore
hamletas	hamlet
hamad	hamad
siekiu	stretch
siekiu	duỗi
siekiu	căng
šiandienos	nay
sukotajaus	sukhothai
beroe	beroe
nukleotidų	nucleotide
gamecube	gamecube
kašubų	kashubian
lindl	lindl
beit	beit
trapi	sệt
marcello	marcello
duomo	duomo
stigmella	stigmella
freiburg	freiburg
valentin	valentin
valentin	valentín
harisonas	harrison
bitis	bitis
kazanė	kazan
antonina	antonina
chinensis	chinensis
ingres	ingres
berlusconi	berlusconi
atkuriama	khôi
trulli	trulli
kilikijos	cilician
osvaldo	osvaldo
salai	salai
kalugos	kaluga
ergo	ergo
huang	hoàng
huang	huang
orgazmas	orgasm
angus	angus
drogheda	drogheda
leigh	leigh
pupos	đậu
eriksson	eriksson
rui	rui
acanthurus	acanthurus
nasdaq	nasdaq
synthpop	synthpop
lubelskie	lubelskie
gand	gand
branickis	branicki
amadeus	amadeus
kėdė	ghế
kėdė	lí
kėdė	cậy
rimti	bách
stein	stein
benoni	benoni
kelionei	du
lęšiai	lens
tunisą	tunisia
memfio	memphis
šėtonas	sa
šėtonas	satan
tulžys	todiramphus
charger	sạc
charger	charger
narkotikai	vải
ica	ica
lozanoje	lausanne
dina	dina
rinkodara	marketing
romantizmas	romanticism
amelija	amelia
sakramentas	sacramento
cro	cro
bakas	tank
bakas	tăng
bakas	bể
def	def
abejotinas	questionable
apiaceae	apiaceae
heckler	heckler
cidarija	bilineata
helis	helium
helis	heli
teroristai	khủng
enschede	enschede
studia	studia
andhra	andhra
gitana	gitana
miltus	bột
tripolis	tripoli
kit	kit
transilvanijoje	transylvania
beveren	beveren
olų	dens
aiseno	aysén
geometrinės	geometrical
glam	glam
deginti	cháy
figaro	figaro
vai	vai
pirkimas	mua
ateizmas	atheism
žąsys	ngỗng
žąsys	goose
žąsys	ngỗng
traktorius	millie
traktorius	mili
traktorius	tractor
kidman	kidman
paaugliai	teens
bandeira	bandeira
pld	pld
rike	rike
blackpool	blackpool
erfurt	erfurt
kylie	kylie
algonkinų	algonquian
žudo	giết
lavey	lavey
barbarosa	barbarossa
graužikas	eater
panaikina	rút
tvenkinyje	ao
lancer	lancer
meilužis	lover
stream	luồng
stream	suối
stream	stream
diuseldorfo	düsseldorf
diuseldorfo	düsseldorf
diuseldorfo	dusseldorf
bučas	butch
kiaulė	heo
kiaulė	lợn
kiaulė	thối
kiaulė	heo
kiaulė	đẻ
heian	heian
carey	carey
frullania	frullania
ponderosa	ponderosa
žydėti	blossom
pratybos	khoan
ikrai	caviar
ikrai	roe
scaleminor	scaleminor
kala	kala
haus	haus
studentė	bmi
bitininkystės	beekeeping
sandūra	junction
srt	srt
plaučiai	phổi
plaučiai	lung
plaučiai	phổi
plaučiai	ớt
kompensacija	bù
belgorodo	belgorod
vargšas	nghèo
vargšas	nghiệp
dantė	dante
rouge	rouge
morrowind	morrowind
stiprintuvas	booster
klodai	giăng
yorke	yorke
carr	carr
catedral	catedral
colt	colt
cnn	cnn
šviežios	tươi
viešpatie	huân
larsson	larsson
sig	sig
kitsas	kitts
tolstojus	tolstoy
klarkas	clark
kapelmeisteris	kapellmeister
bender	bender
hormono	hormone
hormono	hormon
gregory	gregory
isla	isla
timberlake	timberlake
aičio	aichi
karšti	hot
karšti	nóng
nemo	nemo
wigan	wigan
kreida	chalk
kreida	phấn
parabellum	parabellum
baterijų	bình
baterijų	pin
herzog	herzog
feso	fès
regal	regal
gimine	kin
communis	communis
deco	deco
ono	ono
rublis	rubel
silene	silene
rubus	rubus
lionel	lionel
pervalkos	portage
ole	ole
menkės	cod
žiurkėnai	hamster
macmillan	macmillan
ismail	ismail
manija	mania
raganosis	rhino
pavlodar	pavlodar
hora	hora
uragano	mindy
codex	codex
cupressus	cupressus
prekybininkas	buôn
prekybininkas	buôn
gabalas	chunk
gabalas	mảnh
gabalas	miếng
gabalas	piece
gabalas	vở
pusryčiai	sáng
pašarai	feed
pašarai	forage
hai	hải
supernovos	supernovae
newman	newman
atskyrimas	segregation
ferreira	ferreira
hamburger	hamburger
smiltpelės	gerbillus
košė	cháo
lovoje	bed
lovoje	giường
tengri	tengri
tuopos	poplar
legatas	legate
stefani	stephanie
aemilius	aemilius
bertrand	bertrand
rhinolophus	rhinolophus
arne	arne
runų	run
klonas	clone
dwight	dwight
bongo	bongo
tepalas	mỡ
lsu	lsu
bach	bach
orto	ortho
girėnas	girėnas
hendrik	hendrik
kfar	kfar
nevalgoma	inedible
aristokratija	aristocracy
bud	nghị
bud	răn
bud	bud
oksana	oksana
milvokio	milwaukee
sraigė	ốc
laurinaitis	laurinaitis
apartheido	apartheid
mate	mate
oleg	oleg
kami	kami
kamiu	camus
mak	mak
damir	damir
arvensis	arvensis
fotografai	photographers
duobes	graves
duobes	đào
bonaparte	bonaparte
trauma	tổn
metanas	mêtan
metanas	metan
metanas	methane
coleraine	coleraine
agm	agm
edvard	edvard
clube	clube
ararato	ararat
emberiza	emberiza
baha	baha
pseudotsuga	pseudotsuga
asfalto	nhựa
hujų	huệ
hujų	hui
hujų	hủi
hujų	huy
odinas	odin
doherty	doherty
miškinės	arborophila
cercle	cercle
žaneta	jeanette
liežuvį	lưỡi
penn	penn
inti	inti
belowstyle	belowstyle
dam	dam
dam	đập
siu	sue
siu	kiện
itanium	itanium
kassel	kassel
leymus	leymus
philips	philips
payne	payne
mustaine	mustaine
fabian	fabian
užsakymas	booking
griunfeldo	grünfeld
etnologija	ethnology
phra	phra
hendrick	hendrik
hendrick	hendrick
vesta	vesta
pywikipedia	pywikipedia
hyundai	hyundai
šarvuoti	armoured
remo	remo
puštūnų	pashto
karenina	karenina
šlaunies	đùi
gsp	gsp
blagoevgrad	blagoevgrad
marsa	marsa
begalinė	infinite
begalinė	vá
gaublį	globe
mag	mag
lugo	lugo
dipterocarpaceae	dipterocarpaceae
bello	bello
gota	gota
gifu	gifu
kafka	kafka
cinerea	cinerea
académie	académie
lily	lily
ašaros	lăn
gripas	cúm
gripas	cúm
bsc	bsc
stahl	stahl
asuano	aswan
panoramio	panoramio
sauronas	sauron
bašio	bashō
radiacija	xạ
sueitis	interruptus
nec	nec
gudžarato	gujarat
trinity	trinity
ricci	ricci
quinn	quinn
göttingen	göttingen
drugelių	bướm
aguilera	aguilera
ames	ames
fausto	fausto
rihanna	rihanna
manos	manos
cobain	cobain
ryszard	ryszard
tuzla	tuzla
pha	pha
hyla	hyla
petrucci	petrucci
įprastinis	conventional
alkmaar	alkmaar
alkmaar	síp
akiniai	sunglasses
akiniai	kính
dreamworks	dreamworks
peilius	dao
peilius	tung
darko	darko
winston	winston
winehouse	winehouse
raukšlės	folds
upanišada	upanishad
aksu	aksu
suknelė	váy
suknelė	áo
migdolų	almond
rioso	ríos
almeida	almeida
uraganai	hurricanes
lim	lim
maximilian	maximilian
užsidirbti	giành
marsh	marsh
baškirų	bashkir
dada	dada
viela	dây
trombonas	trombone
trombonas	kèn
naujagimio	neonatal
slyvos	plum
slyvos	mận
slyvos	mận
ghibli	ghibli
#fff	#ff
#fff	#fff
skalbimo	rửa
luo	luo
luo	la
apynių	hops
lipidų	lipid
lopšys	võng
koridorių	lang
barack	barack
bradford	bradford
aviganis	shepherd
athlone	athlone
agostino	agostino
krosnių	furnace
triukų	tricks
leu	lêu
leu	leu
rathaus	rathaus
riurikaičių	rurik
hole	holly
voltas	volt
voltas	volts
voltas	vôn
gabriela	gabriela
semiotika	semiotics
vaiduokliai	ghosts
vaiduokliai	ma
maišas	túi
maišas	bag
maišas	pose
konsorciumas	consortium
gta	gta
gracilis	gracilis
elfsborg	elfsborg
lašiša	salmon
jogurtas	yogurt
rothschild	rothschild
penktadienis	fri
antioksidatorius	antioxidant
kva	kva
polibijus	polybius
afonso	afonso
fier	fier
kaligula	caligula
pica	pizza
barjeras	barrier
gian	gian
rolf	rolf
roberta	roberta
tera	tera
tera	terra
mila	mila
taupymo	cut
taupymo	cắt
taupymo	méo
taupymo	chém
deutsches	deutsches
dispersija	dispersion
pavasarinis	adonis
kietu	đặc
kalcis	calcium
kalcis	canxi
scavo	scavo
amg	aim
amg	ame
laiminga	phúc
laiminga	vui
mitra	mitra
huddersfield	huddersfield
apulijos	apulia
entuziastai	enthusiasts
pabėgimo	getaway
arenas	arenas
concerto	concerto
atlygį	thưởng
filtras	lọc
austrė	oyster
austrė	hàu
logistika	logistics
paisley	paisley
isr	isr
swe	swe
utrechte	utrecht
safari	safari
atvykimas	đến
devon	devon
tirol	tirol
hernando	hernando
internetinį	webcam
lošimų	gaming
korsika	corse
korsika	corsica
duran	duran
patricija	patricia
koranas	quran
gazeta	gazeta
abel	abel
abel	able
kočabambos	cochabamba
mev	mev
jelcinas	yeltsin
latte	latte
tvf	imf
rebecca	rebecca
angelina	angelina
rytoj	mai
arkive	arkive
kuoduotasis	mào
azam	azam
pulicerio	pulitzer
herschel	herschel
aeg	aeg
kew	kew
santana	santana
mei	mai
mei	mei
foucault	turano
foucault	foucault
umm	uhm
mandolina	mandolin
slenkstis	ngưỡng
kuhn	kuhn
verkė	khóc
mandarinų	mandarin
mandarinų	quýt
šalinimas	excretion
galway	galway
karakorumo	karakoram
root	root
root	chủ
džesika	jess
džesika	jessica
šnipas	điệp
malkų	củi
mcdonnell	mcdonnell
rivnės	rivne
maharaštros	maharashtra
pluoštų	tơ
maxi	maxi
deivis	davy
pradedantiesiems	aspiring
soo	tô
soo	soo
palo	palo
tierra	tierra
fermi	fermi
integruotos	integrated
bautista	bautista
christgau	christgau
belenenses	belenenses
celentano	celentano
miulerio	mealy
kiedis	kiedis
ofk	ofk
dani	dani
yan	yến
yan	yan
yan	nhan
alam	alam
brahmanas	brahman
asa	asa
craiova	craiova
fiesta	fiesta
clifford	clifford
bellini	bellini
boulingo	bowling
oskar	oskar
kraujospūdį	luộc
aikos	ajka
sarpsborg	sarpsborg
dulkes	bụi
dulkes	chốn
betta	beta
betta	betta
pakabinti	hung
pakabinti	hưng
bulgakovas	bulgakov
abejotina	questionable
abejotina	nghi
analų	annales
johansson	johansson
crawford	crawford
laikinojo	tạo
gentile	gentile
kovalainen	kovalainen
pterocarpus	pterocarpus
magnis	magie
magnis	magiê
magnis	magnesium
crimson	crimson
intro	intro
flor	flor
jakutų	yakut
rostov	rostov
chronicle	chronicle
tiuringo	turing
liebe	liebe
skaisčiai	scarlet
mergaites	girls
mergaites	gái
skėriai	chấu
belle	belle
huseinas	hussein
braškių	strawberry
braškių	dâu
orson	orson
pitagoro	pythagorean
kalviukas	anthus
suvorovas	suvorov
mokymuisi	học
ragenos	cornea
pamaina	shift
pamaina	ca
giuliano	giuliano
stealth	stealth
užuomina	hint
deginimas	cháy
pratensis	pratensis
bunkeris	bunker
bunkeris	boongke
bunkeris	cũi
argento	argento
pulsas	nhịp
pulsas	mạch
civilis	civilis
alga	lương
miso	miso
deu	deu
plastikų	nhựa
moralinę	đạo
citrusinių	citrus
hayley	hayley
uodų	muỗi
krosnies	furnace
hipodromas	hippodrome
prizmės	prisms
pumos	cougars
satavahanų	satavahana
goro	goro
istrijos	istria
marakaibo	maracaibo
roda	roda
fina	fina
žemiausio	beginner
sambora	sambora
rtv	rtv
jimi	jimi
mitochondrijų	mitochondrial
niva	niva
tea	iea
julien	julien
ternopilio	ternopil
branko	branko
siluetas	silhouette
prešovo	prešov
marlene	marlene
genijus	genius
kintamasis	biến
mekos	makkah
vidurdienį	noon
vidurdienį	trưa
hiogo	hyōgo
kata	kata
deng	đặng
tiepolo	tiepolo
brijeg	brijeg
sql	sql
bistrica	bistrița
ale	ale
wismut	wismut
balearų	balearic
adansonia	adansonia
kreta	crete
khalifa	khalifa
qaeda	qaida
starr	starr
hugenotų	huguenots
fregata	frigate
ves	ves
pinto	pinto
jive	jive
fernandez	fernandez
dion	dion
heros	heros
kanapės	hemp
skyrim	skyrim
meine	meine
grenadinai	grenadines
dirk	dirk
nikon	nikon
sati	sati
kančias	khổ
kopūstų	bắp
cefa	cefa
apurimako	apurímac
fikusas	elastica
etnografija	ethnography
fragaria	fragaria
mura	mura
gaubtas	enclosure
fragmentais	motifs
delgado	delgado
kerpės	lichens
andromeda	andromeda
mezgimo	đan
mezgimo	knitting
hektoras	hector
tigranas	tigran
myrtaceae	myrtaceae
asahi	asahi
sabrina	sabrina
romulas	romulus
romana	romana
maxwell	maxwell
jorkšyro	yorkshire
rastis	rusty
angra	angra
džango	django
suisse	suisse
tesėjas	theseus
epyras	epirus
istoriografija	historiography
blokavimas	chặn
eos	eos
fangio	fangio
nemiga	insomnia
npc	npc
natas	nath
limpopo	limpopo
valties	tàu
valties	thuyền
valties	boat
askorbo	ascorbic
guidžou	guizhou
latino	latino
odorata	odorata
kepure	mũ
kepure	xịt
kepure	nón
dis	haze
dis	dis
bleu	bleu
sachs	sachs
defektas	defect
dianthus	dianthus
vola	wola
gibonas	gibbon
gibonas	vượn
tanis	thani
carroll	carroll
chartiją	charter
kailiai	lông
bystrica	bystrica
pula	pula
kldr	dprk
balionai	xylanh
cinamono	quế
prokofjevas	prokofiev
dubenį	bát
rem	rem
daniele	danielle
orig	orig
jenų	yen
efesas	ephesus
fukuoka	fukuoka
taranto	taranto
citata	quote
marvel	marvel
šamas	catfish
blokus	chặn
pagavo	caught
anima	anima
apipavidalinimas	livery
doria	doria
valonijos	walloon
landa	landa
išmatos	phân
cyrus	cyrus
shirley	shirley
delfino	delfino
vestgotai	visigoth
ans	gina
chlorido	clorua
aikido	aikido
schizothorax	schizothorax
tele	tele
lega	lega
sumaišyti	võ
sumaišyti	mose
sumaišyti	rêu
mont	mont
gogolis	gogol
km³	km³
repinas	repin
nguyen	nguyen
nguyen	nguyễn
volcanism	volcanism
liūdnai	notorious
liūdnai	infamous
svyravo	ranged
voltų	volt
voltų	vôn
notts	notts
porno	porn
puebla	puebla
willy	willy
vasaras	summers
čili	chili
čili	ớt
gerda	gerda
išilginė	longitudinal
eliziejaus	champs
tama	tama
judrus	agile
bogdan	bogdan
idi	idi
waregem	waregem
fiore	fiore
antin	antin
skydus	shields
skydus	khiên
linksma	fun
linksma	ké
linksma	vui
vyborgo	vyborg
tong	tong
muzeum	muzeum
saragosos	zaragoza
symbian	symbian
ban	ban
ban	cấm
nakamura	nakamura
sivan	sivan
leszek	leszek
beždžionė	khỉ
vostok	vostok
dag	dag
eizenšteinas	eisenstein
palatino	palatine
siurblys	cleaner
siurblys	bơm
petronijus	petronius
maga	maga
olsen	olsen
tupolev	tupolev
žudikai	assassins
jong	jong
formules	formulae
nominantai	nominees
karlomanas	carloman
greco	greco
siegfried	siegfried
tobula	hảo
sindo	sindh
liana	liana
martinez	martinez
hidra	hydra
momentai	moments
ioannis	ioannis
contador	contador
ado	ado
europaeus	europaeus
gmt	utc
gmt	gmt
drakonai	rồng
tintoretas	tintoretto
rezervuaras	reservoir
hipposideros	hipposideros
kobe	kobe
arkanzaso	arkansas
fosfatas	phosphate
tna	tna
gemma	gemma
marti	marty
globalizacija	globalisation
achajos	achaia
rousseau	rousseau
minogue	minogue
sdp	sdp
apgauti	lừa
galileo	galileo
zhang	trương
įrašoma	viết
irving	irving
keller	keller
blanka	blanka
salvia	salvia
vedžitas	vegeta
dns	dns
lėlė	doll
netbsd	netbsd
majus	majus
kobalto	coban
kobalto	cobalt
amano	amano
safavidų	safavid
kvintas	quintus
amonas	amun
astma	hen
messi	messi
hari	harry
terenganu	terengganu
gente	gente
bakai	buck
rubra	rubra
lokeren	lokeren
šetlando	shetland
vernon	vernon
vernon	dượng
chu	chu
konsepsjono	concepción
ula	ula
wilde	wilde
arakano	arakan
elijus	aelius
ateis	đến
ateis	tới
bale	bale
indigo	chàm
almagro	almagro
šamanas	shaman
addclass	addclass
inn	inn
ars	ars
ikosaedras	icosahedron
širdys	nhép
širdys	cơ
širdys	hearts
bukowski	bukowski
katrina	katrina
bresson	bresson
piktžolių	weeds
pluoštai	tơ
gibraltaras	gibraltar
espanyol	espanyol
diu	diu
čola	chola
biografiniai	biographical
fisichella	fisichella
albano	albano
biurokratai	bureaucrats
koriakų	koryak
tarašo	tarrasch
ivica	ivica
energingas	energetic
liao	liêu
fdp	fdp
manko	manco
peta	peta
auklė	nanny
lenfilm	lenfilm
toru	toru
opensuse	opensuse
turgenevas	turgenev
žąsų	ngỗng
žąsų	goose
žąsų	ngỗng
admiraliteto	admiralty
berliner	berliner
bloch	bloch
nava	nava
ateistai	atheists
tutmozis	thutmosis
čigorino	chigorin
larsen	larsen
gata	gata
vladislav	vladislav
traviata	traviata
vagystės	trộm
vagystės	cướp
antikūnai	antibody
haas	haas
haas	has
kentukio	kentucky
keistai	weird
keistai	rar
keistai	lạ
bouchet	bouchet
arfa	hạc
arfa	harp
cosimo	cosimo
kornvalio	cornwall
ulrika	ulrika
canadensis	canadensis
stal	stal
sočyje	sochi
etanolis	ethanol
danuta	danuta
risc	risc
thames	thames
benzinas	xăng
benzinas	xăng
neill	neill
materializmas	materialism
pokémon	pokémon
pokémon	pokemon
miriam	miriam
handbuch	handbuch
vištiena	gà
vas	vas
celtics	celtics
hepburn	hepburn
linksmas	jolly
toi	toi
željko	željko
pakavimo	khít
oktava	octave
renzo	renzo
lacerta	anatololacerta
kapa	capa
pesas	peso
tirgu	târgu
fsk	fsk
hobsas	hobbs
kardus	gươm
kardus	kiếm
blanca	blanca
levine	levine
zpu	zpu
krabas	cua
dohc	dohc
zina	babes
guadalajara	guadalajara
edouard	edouard
peržiūra	review
plastikas	nhựa
sovetov	sovetov
dženifer	jennifer
rover	rover
supercopa	supercopa
plutarchas	plutarch
sandino	sandino
drastiškai	khốc
duarte	duarte
kurmis	mole
kurmis	talpa
koma	mê
džoakinas	gioachino
žemuogių	strawberry
žemuogių	dâu
skaidrių	slide
skaidrių	trượt
ozzy	ozzy
užkarpatės	zakarpattia
uno	uno
sutrikęs	căm
dia	dia
espanjolos	hispaniola
sanguinis	sanguinis
karštis	nhiệt
akropolis	acropolis
hetfield	hetfield
smogė	bewitched
austral	austral
apalačų	appalachian
luanda	luanda
atestuotas	chartered
ama	ama
emerson	emerson
siurbliai	bơm
musik	musik
faro	faro
bučinys	hôn
bučinys	kiss
kosulys	khạc
kosulys	host
kosulys	ho
šilerio	schiller
aiesec	aiesec
veterinaras	vet
česnakų	tỏi
dikas	milt
dikas	dick
dikas	dick
veja	lawn
balius	bóng
balius	banh
gheorghe	gheorghe
televizorius	tivi
manfredas	manfred
artemisia	ngải
artemisia	artemisia
ilija	ilija
clancy	clancy
įkvėpimas	inspiration
antonino	antonine
conte	conte
cesare	cesare
karnataka	karnataka
duo	duo
skandalų	scandals
dažikliai	màu
groß	groß
agaricus	agaricus
johnstone	johnstone
habsburg	habsburg
muang	muang
teritorijoms	rainforest
komodo	komodo
tev	tev
ekspresionizmas	expressionism
novy	nový
šypsenos	smile
šypsenos	cười
šypsenos	cười
apatinius	lót
apatinius	underwear
alnus	alnus
mergedtoprow	mergedtoprow
ignacio	ignacio
burbulas	bubble
mylimas	yêu
cyril	cyril
allah	allah
kojinės	vớ
kojinės	socks
sheva	sheva
klose	klose
amir	amir
erectus	erectus
trua	troyes
mladost	mladost
bohemija	bohemia
musique	musique
akvarele	watercolor
herojės	heroines
kamen	kamen
formosa	formosa
pigus	cheap
pigus	rẻ
larsa	larsa
čečėnijoje	chechnya
sugababes	sugababes
perspektyvas	rang
perspektyvas	rank
voluinė	volhynia
veidų	mặt
žaliavas	rurale
cum	cum
blizgantis	spotless
sadas	sade
konstancijus	constantius
westwood	westwood
scuola	scuola
acheno	aachen
iter	iter
kanagavos	kanagawa
ahly	ahly
mundo	mundo
krevečių	tôm
alyvuogės	ôliu
alyvuogės	olives
dyzeliniai	diesel
dms	dms
northrop	northrop
lac	lac
puikaus	đan
suvenyrų	niệm
phyllonorycter	phyllonorycter
mirza	mirza
zis	zis
hayek	hayek
brevis	brevis
abdel	abdel
penaltyscore	penaltyscore
izraelitai	israelites
herceg	herceg
saulėgrąžų	sunflower
jako	jaco
stupa	stupa
rėmai	khung
maseru	maseru
trump	trump
mėšlo	phân
contra	contra
piešėjas	shader
truman	truman
cryptomeria	cryptomeria
skaitiklis	numerator
meir	meir
ddt	ddt
žibintas	lamp
žibintas	đèn
augalinis	rau
vliorės	vlorë
kasijus	cassius
oahu	oahu
vatas	watt
jiménez	jiménez
receptas	thức
receptas	recipe
ortiz	ortiz
boogie	boogie
freebsd	freebsd
šikoku	shikoku
wacław	wacław
ragina	gọi
asai	asai
davies	davies
ainu	ainu
čalukjų	chalukya
šiltai	ấm
tks	tks
tks	tcs
gunmos	gunma
kobayashi	kobayashi
vika	vic
galenas	galen
šeimyna	đình
horacijus	horace
kagošimos	kagoshima
pia	pia
camaro	camaro
sanga	sanga
molinis	molar
aguilar	aguilar
taboras	tabor
btc	btc
fitzgerald	fitzgerald
oruro	oruro
inferno	thoa
krupp	krupp
gottlieb	gottlieb
kepures	hats
kepures	mũ
kepures	hatter
nominalas	denomination
warhol	warhol
blogi	xấu
blogi	bad
blogi	kém
blogi	khiếp
blogi	tệ
inkstai	thận
inkstai	cật
kea	kea
dire	dire
kalorijų	calorie
kalorijų	calo
kalorijų	calories
kalorijų	calo
eredivisie	eredivisie
csstext	csstext
diuma	dumas
internacional	internacional
boavista	boavista
rodolfo	rodolfo
gonzalo	gonzalo
dragūnas	dragoon
struvės	struve
sausra	lau
bronisław	bronisław
cassini	cassini
asterix	astérix
hillel	hillel
pakarpatės	podkarpackie
como	como
eliza	elise
lavina	avalanche
sabine	sabine
labės	labem
