alyvos	barril
alyvos	olis
kamieninių	tija
lingė	arpella
bilis	billy
vsc	vsc
hibernian	hibernian
vyšnios	cirera
vyšnios	cherry
vyšnios	cireres
verona	verona
eng	eng
nematomas	invisible
ssc	ssc
kėdės	presideix
kėdės	cadires
kėdės	cadira
įspūdingas	impressionants
greita	ràpid
paaiškinimas	explicació
jungtys	interfícies
jungtys	conjuncions
nedarbas	desocupació
nedarbas	atur
akira	akira
sruogos	ramals
sruogos	vessants
idol	ídol
katalogo	catàleg
altas	sax
verslininkai	emprenedores
verslininkai	empresaris
verslininkai	emprenedors
sukilimus	aixecaments
gao	gao
opus	opus
agresijos	agressió
bonifacas	bonifaci
prostatos	pròstata
joão	joão
bonus	bonus
bonus	gratificació
bonus	bonificació
electro	electro
balansas	balanç
balansas	saldo
balansas	equilibri
samsung	samsung
rebelde	rebelde
plytos	maons
plytos	rajoles
faktais	garantit
faktais	garantida
idris	idris
miega	adormits
miega	adormit
miega	dormint
tiuringijos	turíngia
naikinimas	crush
naikinimas	esclafar
naikinimas	despoblament
siekius	aspiracions
eminem	eminem
šiitų	xiïta
bradley	bradley
profesionaliai	professionalment
tyrėjų	detectius
tikrovė	realitat
griežti	estricte
griežti	hardcore
onkologijos	oncologia
kirilas	kirill
horizontali	horitzontal
griovių	rases
drausmės	disciplinari
jerome	jerome
originalas	pirates
aliochinas	alekhin
cao	cao
įvartis	parpelleig
koordinavimo	coordinació
porai	porro
stiprina	amplificador
stiprina	reforça
šiukšlių	escombraries
tonumber	tonumber
prisiminti	recordant
prisiminti	recorda
prisiminti	recordeu
konsultacijų	consultes
konsultacijų	consulta
dingsta	desapareix
dingsta	desaparèixer
kilme	origen
pipirai	pebrot
pipirai	pebre
sekmadienis	diumenge
alisa	alice
zagora	zagora
olimpia	olimpia
šiltos	warm
šiltos	càlid
buto	apartament
laimėjimai	èxits
laimėjimai	realitzacions
bušas	bush
sochaux	sochaux
dao	dao
vankuverio	vancouver
realybė	realitat
auguste	auguste
rojas	rojas
rowling	rowling
lankai	arcs
blakės	heteroptera
gražu	bonic
gražu	niça
plaučius	pulmons
mustafa	mustafa
mustafa	mustafà
demonstracijos	manifestacions
demonstracijos	demostracions
demonstracijos	mobilitzacions
livonija	livònia
matavimai	mesuraments
matavimai	mesura
matavimai	mesurament
pečioros	pechora
dumbliai	alga
uraganas	huracà
treniruotis	entrenar
gridcolor	gridcolor
ska	ska
mstislavas	mstislav
delavero	delaware
suopis	aligot
birkirkara	birkirkara
stipendijos	subvencions
stipendijos	beques
spektras	espectre
wikidata	wikidata
lapienis	tremella
nino	nino
nuosprendis	veredicte
okb	okb
robertson	robertson
judas	judes
žiurkė	rata
arterijų	artèries
baladė	balada
transformacijos	transformació
pardavėjas	venedor
pabėgėliai	refugiat
pabėgėliai	refugiats
keistas	estranya
keistas	strange
keistas	estrany
mafija	mob
mafija	màfia
ertmėje	cavitat
rifai	esculls
gazos	gaza
endeminių	endèmica
patiekalus	plats
ūmėdė	russula
vėliavas	estendards
vėliavas	banderoles
klesti	evolucionant
dora	dora
skystas	líquid
skystas	liquid
alyvuogių	olives
ciklų	cicles
wrocław	wrocław
smithsonian	smithsonian
ekologinė	ecològica
ekologinė	ecològic
ekologinė	ecològiques
pranešimo	notificació
tyliai	tranquil
vandalai	vàndals
porter	porter
discogs	discogs
tiekėjų	proveïdors
strėliukė	zigòpter
sligo	sligo
delle	delle
patogiau	calaixera
patogiau	còmodes
padažas	salsa
pliki	baldy
potencialiai	potencialment
ign	ign
receptorius	receptor
esbo	osce
amour	amour
staigus	sharp
staigus	sostingut
šlovė	calamarsa
žavėjosi	admirat
berberai	berbers
sviedinys	cannonball
cole	cole
proporcingas	proporcional
proporcingas	proporcionals
polydor	polydor
lgbt	lgbt
lgbt	lgtb
levadia	levadia
vadove	guia
madam	madame
ritualas	ritual
fabio	fabio
palestiniečių	palestins
balsis	vocal
įsivaizduoti	imaginat
revoliucinė	revolucionari
grunge	grunge
poseidonas	posidó
clarkson	clarkson
rosenborg	rosenborg
triumfavo	prevaler
cellpadding	cellpadding
kolegos	companys
pokalbio	conversa
asirija	assíria
vakar	ahir
violetinė	porpra
violetinė	morat
oliveira	oliveira
akvariumas	aquàrium
oksidacijos	oxidació
atari	atari
pokerio	poker
pokerio	pòquer
remiama	patrocinat
remiama	patrocinats
chamberlain	chamberlain
skliaustuose	parèntesis
blokavimo	bloquejant
sorbų	sòrab
esminė	crític
jaguar	jaguar
troleibusų	troleibús
lamborghini	lamborghini
dirvožemį	sòl
slyvų	prunera
slyvų	pruna
vadi	wadi
biologiškai	biològicament
biologiškai	biodegradables
aštrus	picant
augmenijos	vegetació
turbina	turbina
paviršiai	superfícies
triukšmas	soroll
elta	elta
optika	òptica
kalifas	califa
netinkamas	incorrectes
netinkamas	incorrecte
netinkamas	invàlid
amino	amino
demonai	dimonis
džiaugsmas	alegria
višnaus	vishnu
plaukikas	nedador
švelnios	gentil
maratonas	marató
maratonas	marathon
kibernetikos	cibernètica
coleoptera	coleoptera
pirmtakai	predecessors
specializacijos	especialització
mozilla	mozilla
animatorius	animador
bora	bora
teleskopo	telescopi
brangi	benvolguts
klestėjimas	prosperitat
donatello	donatello
hermiona	hermione
cellspacing	cellspacing
postų	publicacions
robotas	robot
galingi	poderós
galingi	poderosos
galingi	potent
galingi	poderosa
galingi	poderoses
minerva	minerva
sprogstamosios	explosiva
atsparumo	resistència
southampton	southampton
paaukoti	donas
styga	corda
starta	sit
granada	granada
turinas	torí
nirvana	nirvana
bandymą	experiment
braun	braun
šalmus	cascs
vandeninis	aquosa
dublinas	dublín
dublinas	dublin
sindarin	sindarin
udo	udo
apvalkalas	shell
barrichello	barrichello
budistai	budistes
triplophysa	triplophysa
tikslumas	precisió
tikslumas	precisió
tikslumas	exactitud
kremliaus	kremlin
elvis	elvis
vagonų	vagons
suprojektuota	dissenyada
suprojektuota	dissenyat
mokymasis	aprenentatge
blokų	blocs
sprogsta	esclata
šiaudų	palla
diktatūros	dictadura
laguna	laguna
paskiria	contacte
aktyvistai	activistes
zipcodezoo	zipcodezoo
gbif	gbif
katalonų	catalan
katalonų	català
tsv	tsv
mono	mono
ijo	ijo
plėšrūnų	depredadors
apgyvendinimo	allotjament
vežimas	trameses
teito	teito
dumblių	alga
forum	fòrum
forum	forum
listclass	listclass
konkursai	licitacions
teologija	teologia
citadelė	ciutadella
kaukazas	caucas
marselio	marseille
marselio	marsella
brendan	brendan
tor	tor
nendrių	reed
kančia	patiment
kančia	sofriment
kančia	patint
kančia	moltíssim
cinkas	zinc
norimą	desitjada
norimą	desitjat
norimą	desitjats
laimingas	feliç
kontaktas	contacte
sąjungas	aliances
bismarkas	bismarck
sąsmauka	istme
gegutės	naevia
mileris	miller
hunai	huns
elzė	eliza
vakarienė	sopar
kenkėjų	plagues
koridorius	passadissos
koridorius	corredor
dunojus	danubi
įkvėpti	inspirar
lydiniai	aliatges
milžinai	gegants
charleroi	charleroi
viskio	whisky
priimtų	destaca
priimtų	destacats
priimtų	ressaltats
važiuoklės	bastidor
dinozaurai	dinosaures
spiritas	esperits
šeštoji	sisena
šeštoji	sisè
egzamino	examen
finansiniai	financer
finansiniai	financera
rūsys	celler
sakiniai	frases
suaugusieji	adults
suaugusieji	adult
galija	belgica
sophia	sophia
coca	coca
konservantas	conservant
austrai	austríacs
tinklinis	voleibol
cikas	cycas
rekomenduoja	recomana
rekomenduoja	recomanar
rekomenduoja	recomana
rekomenduoja	recomanen
toras	thor
incidentas	incident
dominavimo	dominació
kaiser	kaiser
subprefektūra	sotsprefectura
paskirstymas	assignació
paskirstymas	desglossament
paskirstymas	distribució
tiriami	provat
tiriami	provada
moses	moses
moses	moisès
eritrėja	eritrea
meteoritas	meteorit
ruiz	ruiz
derėtis	negociar
gub	gub
niufaundlando	martes
maserati	maserati
ogc	ogc
bangor	bangor
persekiojami	perseguit
leto	leto
plikas	calvo
laikrodžiai	rellotges
krosnis	forn
malcolm	malcolm
bmg	bmg
wordpress	wordpress
laidumas	conductivitat
butanas	butà
wow	ostres
logiškai	lògicament
diktatūra	dictadura
renato	renato
dancigo	danzig
owen	owen
direktoriai	directors
karcinoma	carcinoma
apyrankės	polseres
lynn	lynn
soros	millet
seminaras	curset
seminaras	taller
seminaras	seminari
čerčilis	churchill
draugės	amics
draugės	amistats
aortos	aòrtica
legionas	legió
kerštas	venjança
kerštas	venjança
tibetas	tibet
žiemgala	semigàlia
kalvis	herrero
kalvis	ferrer
kambodža	cambodja
drąsiai	valentament
romero	romero
tokelau	tokelau
raiteliai	riders
raiteliai	genets
buitinių	municipal
buitinių	municipals
skylė	forat
trajektorija	trajectòria
simboliškai	simbòlicament
kardą	espasa
warcraft	warcraft
guido	guido
rimta	greus
rimta	seriós
miko	miko
socializmas	socialisme
stabilus	estable
nevis	nevis
mesopotamija	mesopotàmia
gandras	cigonya
netikras	fals
netikras	fake
sapiens	sapiens
grenlandija	groenlàndia
skaičiavimus	càlculs
teo	theo
kor	kor
rodezijos	rhodèsia
kiūšiū	kyushu
gijos	fils
len	len
coloma	coloma
eduard	eduard
goda	goda
varškės	recuit
norintiems	desitjant
piper	piper
epa	epa
nerimą	alarmant
nerimą	preocupant
griežtą	rigorós
skersinis	transversal
skatinimas	promoció
gangsteris	gàngster
hnk	hnk
sankryža	rotonda
jutos	utah
mayer	mayer
atkrintamųjų	playoff
atkrintamųjų	desempat
baigtos	completat
baigtos	finalitzats
sunitų	sunnita
aronas	aaron
antigva	antigua
įkelti	recarrega
cfc	cfc
paša	paixà
eksperimentus	experiments
pasėlių	cultiu
pasėlių	conreu
dailininkės	potes
technikai	tècnics
prieštaravimų	objeccions
sekretoriatas	secretaria
pašalinamas	excreció
dir	dir
dumblas	llots
saba	saba
kaupimo	compartint
linijinis	lineal
žvejys	pescador
niger	niger
niger	níger
omega	omega
genomo	genoma
jet	jet
tolo	llunyania
pjovimo	tall
atlyginimas	salari
atlyginimas	sou
atlyginimas	sous
atlyginimas	salaris
atlyginimas	retribucions
atlyginimas	retribució
soma	soma
angų	obertures
sutrikimą	confusió
patarimų	assessorament
brangus	benvolguts
būgnas	drum
būgnas	tambor
morena	morena
puškinas	puixkin
skyrybos	divorci
nuovargis	fatiga
borgo	borgo
ofc	ofc
bethoveno	beethoven
genas	gene
genas	gen
vaikšto	caminant
vaikšto	passeigs
vaikšto	caminades
jachtos	iots
vittorio	vittorio
gipso	guix
cenzūra	censura
urdu	urdú
kroft	croft
mega	mega
vožtuvų	vàlvula
ūkininkavimo	agricultura
lira	lira
palladio	palladio
minios	multituds
pelėnas	microtus
aik	aik
šaudo	dispara
gru	gro
guma	xiclet
skydliaukės	tiroides
valė	valais
manas	mane
katy	katy
tamsa	foscor
tamsa	tenebres
taičio	tahiti
hani	hani
vargas	vargas
wisla	wisla
toma	toma
pilsudskis	piłsudski
martínez	martínez
chloridas	clorur
išlaikymo	retenció
pažintis	connectant
parodija	paròdia
android	android
puošnioji	arlequín
virvės	corda
virvės	cordes
dsc	ced
šamanizmas	xamanisme
lynai	cordes
bauskės	bauska
sil	sil
camila	camila
matricos	matriu
septintoji	setena
septintoji	setè
trąšos	adob
trąšos	fertilitzant
trąšos	adobs
trąšos	abonaments
trąšos	fertilitzants
patikimumas	credibilitat
skaičiavimai	càlculs
valdytojų	governadors
mangrovių	manglar
pagalbininkas	ajudant
milošas	melos
vhs	vhs
barzda	barba
priesagos	sufixos
stabdžių	fre
hahn	hahn
specializuota	especialitzats
specializuota	especialitzat
blanco	blanco
vielos	filferro
vielos	cable
franciskas	francisco
hinduizmas	hinduisme
atsakymai	respon
atsakymai	respostes
atsakymai	respostes
dviratininkų	ciclistes
panaikinimas	derogatòria
panaikinimas	derogació
dumblo	llots
muitinė	duanes
muitinė	costums
pranašumas	avantatge
geffen	geffen
drake	drake
libertas	libertas
giulio	giulio
geleris	geller
vizualiai	visualment
druskingumas	salinitat
kubica	kubica
mielės	norman
mielės	llevats
mielės	llevat
mielės	rent
salotos	enciams
salotos	enciam
salotos	amanides
salotos	amanida
fašistų	feixista
formatavimo	formatat
formatavimo	formatació
fanai	fans
fanai	admiradors
fanai	ventiladors
palmė	jumeirah
svyravimai	fluctuacions
sgd	cng
dovanos	benediccions
dovanos	encarar
epsa	epsa
pipirų	pebrot
pipirų	pebre
cementas	ciment
epic	epic
epic	èpica
prekė	mercaderia
andris	andris
svarstyklės	peses
svarstyklės	pesos
zimbru	zimbru
kirgizija	kirguizistan
gėlų	gaèlic
hughes	hughes
kiurasao	curaçao
įsigijimo	adquisició
bartolomeo	bartolomeo
sietlo	seattle
thomson	thomson
sutrumpintas	escurçar
rūkyti	fumat
palankus	kinder
publika	auditoris
pasakotojas	narrador
atidėtas	diferit
atidėtas	ajornat
jautri	sensible
jautri	sensibles
bas	bas
feyenoord	feyenoord
pareigūnams	funcionaris
kepenys	fetge
aronianas	aronian
magnum	magnum
iškaltas	esculpida
kaltę	culpa
kaltę	culpabilitat
zil	zil
atsparumą	resistència
patarė	aconsella
patarė	aconsellat
patogus	calaixera
patogus	còmodes
karla	karla
riaušės	motí
dažniausi	popular
dažniausi	populars
stan	stan
svajonė	somia
svajonė	somiar
svajonė	somni
karjerai	carreres
karjerai	curses
minkštimas	polpa
teršalų	contaminant
emigracija	emigració
kaltinimų	acusacions
bespalvis	incolor
eden	eden
aiškinimo	interpretació
dub	dub
epitelio	epitelial
mišiniai	barreges
mišiniai	mescles
vaškas	cera
kaiserslautern	kaiserslautern
arp	arp
halina	halina
laidai	cables
laidai	cablejat
aba	aba
užsiėmimai	sessions
komplektas	kit
išmintis	saviesa
nuotėkio	filtració
nuotėkio	fuita
nuotėkio	fuites
migruoti	migrar
nascar	nascar
dniepropetrovsko	dnipropetrovsk
ultra	ultra
alkaloidų	alcaloides
siuzana	susan
krc	krc
amstrad	amstrad
bambuko	bambú
nereikalingas	withers
medėja	medea
scherzinger	scherzinger
goa	goa
apribojimus	condicionants
apribojimus	restriccions
luhansko	luhansk
miami	miami
vištos	pollastres
vištos	pollastre
žmoniją	humanitat
pasiūlymai	propostes
pasiūlymai	licitacions
gabonas	gabon
liejimo	emmotllament
liejimo	fosa
liejimo	càsting
liejimo	casting
bobo	bobo
kenos	qena
bilietai	bitllets
bilietai	entrades
rijeka	rijeka
adm	adm
darfūro	darfur
oneginas	oneguin
eukaliptų	eucaliptus
eukaliptų	eucalyptus
apsikeitimo	permutes
pažįstamas	familiar
melas	mentida
universität	universität
greiti	ràpid
jens	jens
platinimas	distribució
streikas	vaga
zinaida	zinaïda
yehuda	yehuda
krakmolas	midons
krakmolas	fècula
kravitz	kravitz
dinas	dinas
kanye	kanye
lan	lan
bristolio	bristol
flores	flores
prašau	sisplau
panašumo	similitud
impulsų	lleguminoses
babilonas	babilònia
atsiųsti	descàrrega
atsiųsti	descarrega
jautienos	vedella
korėjiečiai	coreans
bronšteinas	bronstein
benzino	gasolina
benzino	benzina
dvikova	duel
smuklė	taverna
vaistininkas	farmacèutic
garantijų	garantia
garantijų	garanties
durklas	daga
timothy	timothy
giant	gegant
fontana	fontana
wembley	wembley
leidimus	permisos
rao	rao
aloe	aloe
kiaušinis	ou
koši	cauchy
blauzdos	cuixa
nojus	noè
nojus	noah
karma	karma
tinamas	tinamú
furjė	fourier
aso	aso
instrumentinis	instrumental
ficus	ficus
aura	aura
įsipareigoja	comet
dieter	dieter
mango	mango
tolerancijos	tolerància
kopros	copra
cm³	cm³
veidai	wade
veidai	cares
žiurkių	rates
žiurkių	rats
wang	wang
placebo	placebo
pacientas	pacient
kepti	fregit
derinimo	depurar
derinimo	depuració
zamoiskis	zamoyski
šilingas	xíling
lancia	lancia
linkolnas	lincoln
ūdros	llúdrigues
hun	hun
grzegorz	grzegorz
normanai	norman
markizo	marquesas
mana	mana
akimirkos	moments
linkin	linkin
ilgumos	longitud
dario	dario
intertoto	intertoto
kartagina	cartago
išdėstymo	disposició
ashley	ashley
nigeris	niger
nigeris	níger
negalia	discapacitat
negalia	invalidesa
meditacija	meditació
unicef	unicef
auditorija	auditoris
klientai	clients
naujovės	innovacions
naujovės	innovació
išmatuotas	ronc
jensen	jensen
skersinės	transversal
simbolinę	simbòlica
simbolinę	simbòlics
simbolinę	simbòlic
ave	ave
mariano	mariano
primatas	primat
liberalizmo	liberalisme
dviračiai	bicicletes
dviračiai	motos
garra	garra
lydeka	pike
lydeka	pica
salvatore	salvatore
oyama	oyama
priemiesčių	suburbana
akimirką	moment
titlestyle	titlestyle
papuošti	decorats
papuošti	decorat
transplantacijos	trasplantaments
transplantacijos	trasplantament
suprojektuoti	dissenyada
suprojektuoti	dissenyat
ling	ling
agata	agatha
maribor	maribor
filippo	filippo
jodo	iode
plėšikas	atracador
elamitų	elamita
margo	margo
senatoriai	senadors
leideno	leiden
rodrigo	rodrigo
dialogas	diàleg
karosai	orada
sustojimo	escenificació
burnley	burnley
franklinas	franklin
ūminis	aguda
riešo	gir
maršrutą	routing
arx	arx
uoga	berry
drupal	drupal
ajutajos	ayutthaya
plunksna	ploma
myliu	amor
gfdl	gfdl
marcelo	marcelo
vale	vale
mic	mic
apeiti	eludir
padangas	pneumàtics
padėjėjai	ajudants
padėjėjai	assistents
švente	celebració
investuotojas	inversor
eile	carril
zeitung	zeitung
puna	plegadis
karikatūristas	dibuixant
bulių	braus
bulių	toros
bulių	bous
herodotas	heròdot
žandarai	gendarmes
reda	reda
ego	ego
krūtų	mamella
krūtų	pits
niutonas	newton
minaretas	minaret
biotechnologijos	biotecnologia
gražios	lovely
diplomatija	diplomàcia
draugiškas	simpàtica
draugiškas	amistós
fin	aleta
indukcijos	inducció
sima	sima
gulbė	cigne
gulbė	swan
opolės	opole
antverpene	anvers
eksportuoti	exportació
mėgstamiausia	preferit
mėgstamiausia	favorit
gks	gks
misūrio	missouri
kane	kane
adeno	aden
farm	granja
išpirkti	bescanviar
socialistai	socialistes
sutikimas	consentiment
naujagimių	nadó
naujagimių	neonatal
francesca	francesca
tigrai	tigres
išskirtinės	excepcionals
išskirtinės	excepcional
pensininkas	pensionista
burtininkas	assistent
vampyrai	vampirs
albino	albino
demokratinis	democràtica
demokratinis	democràtic
ochotsko	okhotsk
paneigti	negro
ovalios	oval
bakterijas	bacteris
kriketo	criquet
patikėti	encomanar
mosfilm	mosfilm
javascript	javascript
raibuolė	paphiopedilum
nepakankamumas	fracàs
sabina	sabina
tiger	tiger
tiger	tigre
darkgrey	darkgrey
verneris	werner
vestminsterio	westminster
telugų	telugu
räikkönen	räikkönen
gimines	familiars
gimines	parents
maldonado	maldonado
džimas	jim
investavo	invertits
investavo	invertit
mfk	mfk
dialogo	diàleg
sunkvežimiai	camions
ropliai	rèptils
iššūkis	challenge
iššūkis	repte
iššūkis	desafiament
fidžis	fiji
timoras	timor
deimantas	diamond
deimantas	diamant
braga	braga
giancarlo	giancarlo
barenco	barents
jamato	yamato
lambert	lambert
išpuolių	atacs
konfederatų	confederats
transliavimo	radiodifusió
trumpalaikis	breu
midi	midi
claudia	claudia
frem	frem
investuotojai	inversor
investuotojai	inversors
indėlių	dipòsit
blokai	blocs
lil	lil
tapatybė	identitat
surinamas	surinam
gogo	gogh
malaga	màlaga
kolibris	colibrí
welt	welt
choreografija	coreografia
ritės	bobines
lst	lst
omanas	oman
garavimo	evaporació
puatjė	poitiers
sugebėjimą	intencionada
aušinimo	refrigeració
aušinimo	refredament
susirinkimai	reunions
kichotas	quijote
diskriminacija	discriminació
tikslumo	precisió
tikslumo	exactitud
korteles	cartes
korteles	targetes
fiorentino	fiorentino
neutralus	neutre
neutralus	neutral
balai	puntuacions
įmontuotas	incrustat
įmontuotas	encastat
konkurentai	competidors
konkurentai	competidor
excelsior	excelsior
sanskritas	sànscrit
dai	dai
latviešu	latviešu
alexandre	alexandre
ivanovo	ivànovo
suomiai	finlandesos
neue	neue
kardelis	gladiolus
užsakytas	reservat
gore	gore
gestų	gestos
msv	msv
diafragmos	diafragma
bata	bata
ankstesnė	anterior
alicija	alicia
nobunaga	nobunaga
lockheed	lockheed
teismus	tribunals
drąsa	coratge
drąsa	valentia
drąsa	valentia
alatau	alatau
pts	pty
dubajaus	dubai
griaučiai	esquelets
miegas	dorm
miegas	dormir
miegas	dormint
citrinų	llimona
citrinų	llimones
kalev	kalev
tunelį	túnel
marciano	marciano
gydo	cures
evakuoti	evacuat
evakuoti	evacuar
haiku	haiku
įsigyta	comprats
konsultacijos	consultes
konsultacijos	consulta
sujungimo	maker
sujungimo	interconnexió
kirmėlių	cucs
reaktoriai	reactors
būstas	habitatge
būstas	allotjament
andrejevas	andréiev
ipairs	ipairs
eisena	anadura
imtuvas	receptor
tarantino	tarantino
nuoma	llogant
nuoma	lloguer
nuoma	renda
nuoma	arrendament
kaimynas	veí
kaimynas	veí
kaimynas	veïna
idzu	izu
zbigniew	zbigniew
pirštas	dit
jacqueline	jacqueline
bėgiai	baranes
bėgiai	rails
vėžiagyviai	crustacis
ortega	ortega
ide	ide
mandela	mandela
kiribačio	kiribati
colo	colo
giallo	giallo
morrison	morrison
kamskis	kamsky
français	français
spartą	esparta
likučių	residu
seule	seül
elfai	elfs
tuberkuliozė	tuberculosi
udinese	udinese
džimis	jimmy
swansea	swansea
horizontas	horitzó
miškininkystė	forestal
tarpininkavimo	mediació
patogi	calaixera
patogi	còmodes
apmokestinimo	taxació
apmokestinimo	fiscalitat
subpage	subpage
hodžkino	hodgkin
katryklis	canutus
stebėtojai	observadors
abdullah	abdullah
avenir	avenir
išgyvenimo	supervivència
valdis	valdis
jin	jin
sidney	sydney
minia	multitud
kalbotyra	lingüística
mans	mans
teisėta	legítim
gražūs	bonic
gražūs	niça
sinensis	sinensis
palustris	palustris
milius	milius
kontūrai	esquema
kontūrai	contorn
togas	togo
priešnugarėlė	protòrax
reputacija	reputació
užutėkis	sund
autobiografija	autobiografia
nuolaidų	concessions
derva	xiclet
derva	resina
lingvistiškai	lingüísticament
choleros	còlera
madeiros	madeira
daiktavardis	substantiu
polina	polina
eldorado	eldorado
joninių	midsummer
auxerre	auxerre
seneliai	avis
įrašymas	gravació
įrašymas	enregistrament
devi	devi
betty	betty
grevenmacher	grevenmacher
fenerbahçe	fenerbahçe
šonkaulių	costelles
šonkaulių	costella
panda	panda
stebuklas	miracle
neigimas	denegació
neigimas	negació
redakcinė	editorial
mėgstamiausias	favourite
mėgstamiausias	preferit
mėgstamiausias	favorit
sankirtos	intersecció
arno	arno
zuzana	zuzana
rojų	paradís
rojų	paradise
coffea	coffea
triptikas	tríptic
tiriamas	estudiat
neapykanta	odi
neapykanta	odi
elitas	elit
diržas	cinturó
brien	brien
sms	sms
ešerys	perca
metano	metà
arekipos	arequipa
massimo	massimo
kirk	kirk
clinton	clinton
donato	donato
biurų	oficines
matavimas	mesuraments
matavimas	mesura
matavimas	mesurament
heraldika	heràldica
vairuotojų	controladors
vairuotojų	conductors
vairuotojų	xofers
pomidorų	tomàquet
sandėlių	magatzems
sūriai	formatges
žydėjimas	floreix
uagadugu	ouagadougou
romo	rom
gliese	gliese
rcd	rcd
gura	góra
išimtys	excepcions
išimtys	exclusions
išimtys	exempcions
flavijus	flavi
mmorpg	mmorpg
spinduliuotė	radiació
spinduliuotė	radiacions
leopardas	lleopard
dokumentacijos	documentació
dviračiu	cycling
dviračiu	ciclisme
monografijos	monogràfics
romanovas	romanov
triušiai	conill
rembrantas	rembrandt
klonų	clons
konfigūracija	configuració
shannon	shannon
granatos	granades
augintojai	reproductores
augintojai	criadors
naga	naga
degtinė	vodka
imunitetas	immunitat
wells	pous
žodynų	vocabularis
horst	horst
laurence	laurence
atspindys	reflexió
fotografė	fotògraf
fotografė	fotògrafa
specialistams	professionals
brassicaceae	brassicàcia
aklas	cecs
aklas	cec
díaz	díaz
ironija	ironia
vavelio	wawel
transplantacija	trasplantament
transplantacija	trasplantament
priesaika	jurament
slankstelio	vertebra
linai	lli
guillaume	guillaume
sunaikinimas	destrucció
sampdoria	sampdoria
džamu	jammu
continental	continental
fosfatų	fosfat
plakatai	cartells
plakatai	pòsters
jura	jura
karel	karel
metodologija	metodologia
džiuljeta	julieta
džiuljeta	juliet
respublikose	repúbliques
nacionalizmas	nacionalisme
aug	ago
zoran	zoran
čekai	txecs
routledge	routledge
andersen	andersen
twitter	twitter
banginis	balena
skydai	juntes
skolininko	deutor
patarėjai	assessors
stela	stella
paleologas	paleòleg
karvė	vaques
karvė	vaca
mandatas	mandat
ribojimas	restricció
likusiam	ordenant
džiaugsmo	alegria
zeiss	zeiss
adobe	adobe
failas	arxiu
failas	fitxer
mer	mer
elgėsi	comportat
neteisingas	incorrectes
neteisingas	incorrecte
philipp	philipp
siekiai	aspiracions
alkūnės	colzes
twente	twente
bate	bate
seine	sena
seine	seine
mieško	miecislau
kvadratas	divisió
turkmėnija	turkmenistan
dharma	dharma
alvaro	alvaro
jānis	jānis
tenesio	tennessee
ginčytinas	contenciosa
kinematografija	cinematografia
bruklino	brooklyn
varlė	granota
klounas	pallasso
klounas	clown
neutralumo	neutralitat
bachtinas	bakhtín
liucernos	lucerne
uniformas	uniformes
mauser	mauser
sprogimai	explosions
pilkapis	túmul
obi	obi
nevienodas	desigual
vip	vip
archimedo	arquimedià
pomidorai	tomàquet
pomidorai	tomàquets
pasisekė	sort
žiaurus	pervers
žiaurus	brutal
paramore	paramore
cichlidae	cichlidae
įspūdinga	impressionants
buena	buena
samurajus	samurai
adalbertas	adalbert
antikūnų	anticòs
emmanuel	emmanuel
eksportuojami	exportacions
eksportuojami	exportat
eksportuojami	exportats
gre	gre
bim	bim
trukdyti	comprometin
trukdyti	molesten
labas	ei
netinkama	inhàbil
atstatymas	restauració
vanagai	hawks
uml	uml
demokratinėje	democràtica
demokratinėje	democràtic
kabeliai	cables
kabeliai	cable
rapsų	colza
rapsų	violació
ligūrijos	liguria
adaptacijos	adaptacions
katarina	katarina
verslininkė	empresària
kamuoliukas	beisbol
lūžių	fractures
lūžių	fractura
butai	pisos
maliarija	malària
advokatai	advocats
agripa	agripa
kapitonai	masters
kapitonai	amos
kapitonai	capitans
hansen	hansen
stanfordo	stanford
pojūčius	sensacions
nustebino	sorprenen
kraujavimas	sagnat
fermentas	enzim
adatos	agulla
gabriele	gabriele
forbes	forbes
preparatas	elaboració
preparatas	preparació
granatų	magrana
nusipelnė	mereix
nusipelnė	merescut
nusipelnė	mereixia
nusipelnė	mereixien
suplanuotas	engany
viridis	viridis
rubens	rubens
šešėliai	ombres
pasirūpinti	concertar
timeaxis	timeaxis
žmogžudysčių	assassinats
ekosistemos	ecosistemes
bara	bara
pradešas	pradesh
sraigtasparnio	helicòpter
abejonės	dubte
abejonės	dubtes
kopijas	còpies
kopijas	exemplars
stumia	empenyent
stumia	impulsant
tolerancija	tolerància
pasodinti	plantada
stéphane	stéphane
registracija	matriculació
registracija	inscripció
gaisrai	incendis
raja	skate
didvyriai	heroes
didvyriai	herois
soli	soli
étienne	étienne
gebėjimai	capacitats
bernardino	bernardino
tara	tara
trieste	trieste
xxv	xxv
ontarijas	ontario
bronzinė	troilos
luizianos	louisiana
bosch	bosch
švieži	fresc
švieži	fresques
švieži	fresca
švieži	frescos
delegatai	delegats
matteo	matteo
vienuolės	monges
undef	undef
imuniteto	immunitat
pamokslų	sermons
maui	maui
teisėtai	legalment
delis	delhi
kriaušių	pera
kriaušių	peres
karbonatas	carbonat
žiburiai	llums
akcininkai	accionistes
pranciškonai	franciscà
walther	walther
naujovė	novetat
naujovė	innovació
nogajų	nogai
ava	ava
grove	grove
grove	olivar
jung	jung
cartier	cartier
mhnt	mhnt
padažu	salsa
troškimas	desig
yucca	yucca
ežys	eriçó
perlai	perles
portadown	portadown
timbaland	timbaland
paruošimas	elaboració
paruošimas	preparació
triumfas	triomf
ursula	ursula
ursula	úrsula
actinidia	actinidia
andersson	andersson
baba	baba
sikstas	sixt
gianni	gianni
marienburgo	malbork
premjerą	premier
demokratiškai	democràticament
importuoti	importat
importuoti	importada
rodgers	rodgers
chloro	clor
įspūdingų	cridaners
hibridai	híbrids
buteliai	ampolles
nicholson	nicholson
guobų	elm
saudas	saüd
tobulas	perfecte
tobulas	perfecta
konkurentas	rival
konkurentas	competidor
vikšras	eruga
utar	uttar
falenopsis	phalaenopsis
antonov	antónov
leko	leko
aimarų	aimara
daugiskaita	plural
lervų	larves
cdu	cdu
gbe	gbe
lokomotive	lokomotive
lcs	lcs
yamaha	yamaha
gorica	gorica
vinci	vinci
pečius	espatlles
rezonanso	ressonància
volvo	volvo
graužikai	rodent
graužikai	rosegadors
andai	andes
pagalvės	coixí
kauliukai	daus
drumcondra	drumcondra
trinties	fricció
ščecino	szczecin
cronquist	cronquist
tikslūs	precisa
tikslūs	precís
naudingumo	utilitat
likvidavimo	liquidació
christine	christine
butelis	ampolla
ruch	ruch
milton	milton
deutsch	deutsch
kusko	cusco
kalmaro	kalmar
nuno	nuno
dekoras	decora
išformuota	dissolts
trokšta	desitjos
trento	trento
prefektas	prefecte
shah	xah
shah	xa
šviežias	fresc
šviežias	fresques
šviežias	fresca
šviežias	frescos
komunalinių	utilitats
arte	arte
monde	monde
kuzma	kuzma
alabama	alabama
clash	clash
bray	bray
ateiviai	aliens
ateiviai	estrangeria
trs	trs
trs	fms
persėjas	perseu
aleksijus	aleix
višta	pollastre
jubiliejus	aniversari
kalkių	calç
teherano	teheran
kalniečių	tartà
gros	gros
vat	humida
vat	mullat
inde	inde
ačiū	gràcies
vidurnakčio	midnight
vidurnakčio	mitjanit
beselio	bessel
pasiuntinius	emissaris
maitinimas	càtering
matematiškai	matemàticament
ketverto	quartet
lynch	lynch
nelygybė	desigualtat
nelygybė	desigualtats
stygas	cadenes
nero	nero
semantika	semàntica
lempa	làmpada
viskis	whisky
astra	astra
nuotėkis	filtracions
universitatea	universitatea
remixes	remixes
daugava	daugava
keane	keane
mechelen	mechelen
krešėjimo	coagulació
piastų	piastres
atidėta	diferit
atidėta	ajornat
katilai	calderes
goja	goya
gandrai	cigonyes
laumžirgis	hawker
altvar	altvar
dekarto	cartesiana
kaa	kaa
varškė	recuit
antoninas	antonín
mozaikos	mosaic
andrej	andrej
sheryl	sheryl
stemma	stemma
sepc	sepc
mineralinis	mineral
atyrau	atirau
paulus	paulus
rezoliucijos	resolucions
egzaminas	examen
nuodėmes	pecats
dviračio	bicicleta
žolelių	herbes
mindanao	mindanao
abatas	abat
katmandu	kathmandu
velvet	vellut
velvet	velvet
kat	kat
vin	vin
kaulavaisis	drupa
morkų	pastanagues
morkų	pastanaga
ketinimus	intencions
hewitt	hewitt
parašiutu	paracaigudes
pianino	piano
fasas	faso
mostar	mostar
pirkėjas	comprador
derinimas	conciliació
derinimas	configuració
humbolto	humboldt
martenas	maarten
kosmologija	cosmologia
mylėti	amorosa
kabina	cabina
kabina	taxi
kabina	cabina
kabina	cabana
stulpo	farola
norwich	norwich
judaizmas	judaisme
elis	ellis
cfr	cfr
strauss	strauss
blade	blade
rajon	rajon
domina	interessat
domina	interessats
ginčytina	disputada
arturo	arturo
rostock	rostock
drobė	llenç
blužnies	melsa
lova	llit
pitsburgo	pittsburgh
hardy	hardy
grodno	grodno
maz	maz
talentingas	talent
jautrios	sensible
jautrios	sensibles
atskyrimo	segregació
atskyrimo	segregacions
krokodilas	cocodril
varuna	varuna
ieee	ieee
biurai	bureaux
biurai	oficines
mūza	muses
mūza	musa
dioniso	dionís
flamenko	flamenc
čerkasų	txerkassi
ano	ano
viskuo	everything
viskuo	tot
kama	kama
celta	celta
justinianas	justinià
gomurio	paladar
ebu	ebu
įtaisytas	incrustat
įtaisytas	encastat
auglys	tumor
factbook	factbook
daniela	daniela
berg	berg
zagrebas	zagreb
kardiologijos	cardiologia
lyra	lyra
kabinos	cabina
baseinai	conques
procesija	processó
būgno	drum
būgno	tambor
sutuoktiniai	cònjuges
atmesta	denegat
atmesta	denegada
sprogo	esclatat
alla	alla
segmentai	segments
pramoga	entreteniment
pramoga	entertainment
manipuliuoti	manipular
kampinis	angular
donata	donata
reims	reims
mok	mok
sakykla	púlpit
ikarus	ikarus
agresija	agressió
imagesize	imagesize
carrera	carrera
cunamio	tsunami
wes	wes
esbjerg	esbjerg
pagražinti	embellida
įtakinga	influents
puccini	puccini
nippon	nippon
kalabrijos	calàbria
gómez	gómez
jarosław	jarosław
eli	ellie
ūdra	llúdria
ūdra	llúdriga
eclipse	eclipsi
lemiamas	decisiu
eugen	eugen
auditas	auditories
kobra	cobra
tirštiklis	espessidor
ornitologų	ornitològic
sato	sato
vagonai	vagons
vagonai	furgonetes
vagonai	furgons
marksas	marx
laukinis	salvatge
nesėkmė	fracàs
kongresų	congressos
diaz	díaz
diaz	diaz
wesley	wesley
plotarea	plotarea
užblokuotas	bloquejats
užblokuotas	bloquejat
gala	gala
kalis	potassi
mirtina	letal
mylios	kilòmetre
mylios	milla
džonatanas	jonathan
santrumpos	abreviatures
scalemajor	scalemajor
ankaros	ankara
geria	begudes
toto	toto
fal	fal
