canterbury	canterbury
definere	defining
definere	define
hardanger	hardanger
territoriet	territory
halle	halle
arving	heir
butikk	shop
butikk	store
foretrekker	prefers
foretrekker	prefer
banks	banks
planlagte	scheduled
yang	yang
merkelig	weird
merkelig	strange
merkelig	odd
merkelig	oddly
mohammed	mohammed
mislykket	failed
mislykket	unsuccessful
snitt	intersection
salmer	hymns
basen	base
palestinske	palestinian
mandat	mandate
astronomi	astronomy
vegard	vegard
ansikt	faces
ansikt	face
overleve	survive
maryland	maryland
tusenvis	thousands
kunngjorde	announced
lærde	scholars
zevs	zeus
seksuell	sexual
fløyte	flute
syndrom	syndrome
stk	tangos
kirsten	kirsten
koloniene	colonies
innvilget	granted
spurte	asked
galileo	galileo
kunder	customers
kunder	clients
infrastruktur	infrastructure
aserbajdsjan	azerbaijan
nürnberg	nürnberg
nürnberg	nuremberg
case	case
jakten	pursuit
kampanje	promotion
kampanje	campaign
boris	boris
stones	stones
ryddet	cleared
ryddet	cleaned
porter	gates
porter	porter
utdrag	excerpts
utdrag	excerpt
dokumentar	documentary
java	java
plassere	placing
stoltenberg	stoltenberg
björn	björn
divisjoner	divisions
karakterisert	characterized
realiteten	reality
dommere	judges
samles	gather
trek	trek
bjørnson	bjørnson
anbefalte	recommended
franco	franco
bobsleigh	bobsleigh
utnyttet	exploited
foster	foster
foster	fetus
legendariske	legendary
jin	jin
hevet	raised
hevet	adjourned
shah	shah
über	über
muhammad	muhammad
birdlife	birdlife
digitalt	digital
monument	monument
avbrutt	cancelled
avbrutt	canceled
avbrutt	interrupted
avbrutt	aborted
luigi	luigi
variasjoner	variations
legend	legend
kambodsja	cambodia
malcolm	malcolm
brooklyn	brooklyn
fabrikker	factories
mod	mod
guangdong	guangdong
flikvinger	nymphalidae
ruth	ruth
tsar	tsar
rund	round
løftet	lifted
inntekt	revenue
inntekt	income
astronom	astronomer
raf	raf
terrenget	terrain
slam	slam
atlantic	atlantic
div	div
gjeld	debts
gjeld	debt
hobbs	hobbs
nansen	nansen
sittet	sitting
sittet	sat
opprinnelsen	origins
sheffield	sheffield
württemberg	württemberg
tel	tel
departement	department
departement	ministry
rgb	rgb
hong	hong
kjæreste	girlfriend
kjæreste	boyfriend
mikhail	mikhail
forekomster	occurrences
avhandlingen	dissertation
forhånd	advance
miste	lose
box	box
enorm	tremendous
enorm	huge
enorm	enormous
primære	primary
chang	chang
torp	torp
poul	poul
angola	angola
varmt	hot
varmt	warm
halsen	throat
biter	biting
biter	bites
biter	pieces
saturn	saturn
southampton	southampton
seine	seine
uenig	disagree
avla	took
hinder	obstacle
blomstene	flowers
paraguay	paraguay
protester	protests
båret	carried
båret	borne
gress	grass
gress	weed
haag	hague
sahara	sahara
barndom	childhood
dedikert	dedicated
renessansen	renaissance
nagano	nagano
ulv	wolf
utmerkelse	awards
utmerkelse	award
medarbeidere	employees
medarbeidere	associates
farget	colored
ted	ted
dick	dick
oppvekst	upbringing
folkeavstemning	referendum
lidelse	suffering
territorier	territories
westminster	westminster
mislyktes	failed
sub	sub
kontrast	contrast
separat	separately
separat	separate
patriark	patriarch
konferansen	conference
økonom	economist
hunter	hunter
isabella	isabella
alberto	alberto
fan	fan
befolket	populated
sjøs	sea
motivet	motive
eter	eat
eter	ether
rase	breed
rase	race
kristendom	christianity
institusjon	institution
lena	lena
høydepunkt	highlight
nancy	nancy
keeper	keeper
keeper	goalie
bent	bent
protest	objection
protest	protest
court	court
endt	ended
nepals	nepali
troen	belief
konsentrert	concentrated
konsentrert	focused
verre	worse
slektskap	kinship
doktor	doctor
moldova	moldova
male	paint
romeo	romeo
ordbok	dictionary
danskene	danes
kanadisk	canadian
overlevd	survived
atlas	atlas
hud	skin
area	area
tirol	tyrol
olof	olof
innflytelsesrike	influential
sarajevo	sarajevo
eik	oak
bataljon	battalion
bologna	bologna
connecticut	connecticut
meksikansk	mexican
kristi	kristi
effektive	efficient
effektive	effective
søsken	siblings
filer	files
spredning	scattering
plasseringer	standings
plasseringer	locations
plasseringer	placements
holdeplass	station
manuskript	manuscript
run	run
vang	vang
femti	fifty
oppførsel	behaviour
oppførsel	behavior
oregon	oregon
beklager	sorry
unik	unique
innvandrere	immigrants
samarbeider	cooperating
vakker	beautiful
stiger	ladders
stiger	rising
kommunistisk	communist
kanten	edge
relasjoner	relationships
relasjoner	relations
bus	bus
besetning	crew
julian	julian
kobber	copper
rør	touch
rør	pipe
rør	pipes
kritiserte	criticized
edwin	edwin
vill	wild
antiokia	antioch
jagerfly	fighters
hale	tail
hale	hale
ireland	ireland
alexandra	alexandra
bebodd	inhabited
mestere	champions
intellektuelle	intellectuals
intellektuelle	intellectual
adrian	adrian
bosetninger	settlements
rydde	clean
prøvd	attempted
prøvd	tried
mtv	mtv
avgang	departure
carsten	carsten
pistol	pistol
pistol	gun
brigade	brigade
fisher	fisher
primær	primary
odense	odense
strategiske	strategic
rico	rico
tydeligvis	evidently
tydeligvis	apparently
tydeligvis	clearly
tydeligvis	obviously
skjell	shells
oppmerksom	attentive
blogg	blog
ansiktet	face
say	say
beat	beat
jomfru	virgin
jomfru	maiden
ferdige	finished
camilla	camilla
punk	punk
bagdad	baghdad
elst	elst
sum	sum
ruiner	ruins
fabrikk	factory
designer	designer
designer	designing
sjuende	seventh
viggo	viggo
jenssen	jenssen
tyskere	germans
religioner	religions
small	small
elektroniske	electronic
ronny	ron
ronny	ronny
myspace	myspace
skytter	shooter
familiene	families
inspirerte	inspired
rick	rick
düsseldorf	düsseldorf
düsseldorf	dusseldorf
perry	perry
oppføringer	listings
oppføringer	entries
helene	helene
helene	helen
hart	hart
opposisjon	opposition
seven	seven
farlige	dangerous
bachelor	bachelor
bokstav	letter
sean	sean
helle	helle
anmeldelse	review
konsekvens	consequence
konsekvens	consequences
konsekvens	consistency
hop	hop
gjest	guest
rise	rise
pater	father
aage	aage
pearl	pearl
negativt	negative
böhmen	bohemia
irish	irish
artilleri	artillery
hrsg	hrsg
johanne	johanne
oval	oval
fis	fart
lagre	save
arkansas	arkansas
kyst	coast
illustrasjon	illustration
deltagere	participants
oppfatter	perceive
orleans	orleans
splittet	divided
varm	hot
varm	warm
massakren	massacre
mekanisk	mechanical
helgen	weekend
helgen	saint
aston	aston
terreng	terrain
mason	mason
uro	unrest
miljøer	environments
striper	stripes
arkeologisk	archaeological
xiv	xiv
gatene	streets
gene	gene
tunisia	tunisia
annie	annie
ammunisjon	ammunition
ammunisjon	ammo
kiss	kiss
sigmund	sigmund
eriksson	eriksson
campus	campus
annonsert	announced
annonsert	advertised
balkan	balkans
balkan	balkan
kommersielt	commercial
stabile	stable
fangene	prisoners
christoph	christoph
berit	berit
parentes	bracket
parentes	brackets
fornøyd	satisfied
fornøyd	happy
nettverket	network
kaliber	caliber
gerais	gerais
holocaust	holocaust
cello	cello
mangfold	diversity
cover	cover
rolig	calm
rolig	easy
santo	santo
ryttere	horsemen
ryttere	riders
deltaker	contestant
deltaker	participant
hanssen	hanssen
filosofen	philosopher
gjenopprettet	recovered
gjenopprettet	restored
forent	unified
forent	united
utenlandsk	foreign
randi	randi
nedgang	decline
nedgang	decrease
grenland	grenland
federation	federation
agnes	agnes
isaac	isaac
skeptisk	skeptical
skeptisk	sceptical
symfoni	symphony
phillips	phillips
gata	street
powell	powell
samsvar	compliance
scotland	scotland
albumene	albums
klatre	climb
personlighet	personality
tidsskrifter	magazines
oberstløytnant	colonel
sjanse	chance
stanset	stopped
sakte	slowly
halve	half
skritt	step
skritt	steps
castilla	castile
castilla	castilla
organisk	organic
hundrevis	hundreds
amanda	amanda
nhm	nhm
søsteren	sister
paulsen	paulsen
bratt	steep
rot	mess
rot	clutter
rot	root
rot	rooted
palmer	palmer
jennifer	jennifer
kjerne	core
kjerne	kernel
dømte	convicted
dømte	judged
opplevd	experienced
made	made
skuespillerinnen	actress
olivier	olivier
tjue	twenty
eksport	export
eksport	exporting
sonja	sonja
institut	institut
roskilde	roskilde
mozart	mozart
opprettholdt	maintained
names	names
leon	leon
mater	mater
mater	feeding
jenny	jenny
tsjekkiske	czech
prinsen	prince
skulpturer	sculpture
skulpturer	sculptures
brekke	break
brekke	breaking
grey	grey
valencia	valencia
egenskap	trait
pastor	pastor
forandringer	changes
innsiden	inside
bryst	breasts
bryst	breast
pike	pike
analyser	breakdowns
analyser	analyze
analyser	analyse
analyser	analyses
hersket	ruled
sørger	mourn
sørger	mourning
sådan	such
sektor	sector
krysse	cross
låt	song
metamorfose	metamorphosis
ettertiden	posterity
strukturer	structures
montana	montana
serbiske	serbian
presenterer	introducing
presenterer	presenting
beleiret	besieged
ghana	ghana
forhindret	prevented
tallinn	tallinn
stafetten	relay
rapporter	report
rapporter	reports
romantisk	romantic
kosovo	kosovo
mind	mind
avansert	advanced
henviser	referencing
henviser	referring
henviser	refer
komponerte	composing
tórshavn	tórshavn
begrense	restrict
begrense	limiting
please	please
biologi	biology
søstre	sisters
bestemmelser	regulations
bestemmelser	provisions
munnen	mouth
verdensbasis	worldwide
cameron	cameron
rasende	furious
rasende	enraged
ofre	victims
siri	siri
isle	isle
sitteplasser	seating
kjøper	buyer
kjøper	buying
uka	week
offer	victims
offer	victim
fana	fana
plyndret	looted
hanna	hanna
avhenger	depends
pat	pat
holmes	holmes
columbus	columbus
leonardo	leonardo
testet	tested
lier	lier
inkludere	include
besøke	visit
væske	fluid
væske	liquid
graf	graph
materiell	material
materiell	materials
suite	suite
falske	false
stora	stora
sichuan	sichuan
aksel	aksel
ulrich	ulrich
fekter	fencer
fekter	swordsman
spirit	spirit
marsjerte	marched
odin	odin
variasjon	variation
variasjon	variety
mrs	mrs
husk	remember
macao	macao
macao	macau
spesialisert	specialized
skatter	treasure
skatter	treasures
skatter	taxes
plasseringen	placement
skillet	distinction
harvey	harvey
sosiologi	sociology
hestesport	equestrian
stipend	scholarships
stipend	scholarship
moses	moses
kairo	cairo
veiledning	guide
begrensninger	limitations
begrensninger	restrictions
begrensninger	limits
atferd	behaviors
atferd	behavior
padling	paddling
padling	canoeing
bakterier	bacteria
hand	hand
logo	logo
collett	collett
miami	miami
kalender	calendar
komposisjon	composition
dekk	tires
dekk	cover
dekk	deck
bomber	bombs
portretter	portraits
innspill	input
haiti	haiti
utløste	triggered
spesifikt	specific
spesifikt	specifically
uttrykt	expressed
pilot	pilot
mats	mats
sint	sint
sint	angry
sint	mad
iranske	iranian
kreta	crete
ønskelig	desired
ønskelig	desirable
child	child
progressiv	progressive
lært	learned
lært	learnt
luke	luke
bratte	steep
peters	peters
jules	jules
elseif	elseif
rammer	frames
kjennskap	familiarity
kapital	capital
kamera	camera
gibraltar	gibraltar
fullføre	complete
fullføre	completing
maine	maine
roberto	roberto
orig	orig
hen	hen
distribusjon	distribution
augusta	augusta
xiii	xiii
placid	placid
ankomst	arrival
ankomst	eta
ankomst	arrivals
høgskole	college
skriv	write
skriv	type
fyret	lighthouse
trives	thrive
hamsun	hamsun
babylon	babylon
fett	fat
betaling	payment
betaling	payments
hindret	prevented
roosevelt	roosevelt
blokkering	blocking
blokkering	block
vilkår	conditions
vilkår	terms
bølger	waves
gerd	gerd
glansvinger	lycaenidae
masters	masters
palass	palaces
palass	palace
moths	moths
banker	banks
begått	committed
milton	milton
ruta	route
problematisk	problematic
forsiktig	careful
forsiktig	gently
gyldig	valid
leire	clay
trekkspill	accordion
tykk	thick
talsmann	spokesman
naval	naval
vanskeligheter	difficulty
vanskeligheter	difficulties
kontroversielle	controversial
lin	lin
kraften	force
nba	nba
fylte	filled
fornuftig	sensible
fornuftig	reasonable
kanter	edges
bestefar	granddad
bestefar	grandpa
bestefar	grandfather
sony	sony
beskrivelsen	description
sverdrup	sverdrup
mesa	mesa
sevilla	seville
innspilling	recording
forklart	explained
trygg	safe
handle	shop
handle	act
heidi	heidi
avgrenset	confined
vern	vern
princeton	princeton
sitat	quote
register	register
knight	knight
vegas	vegas
bla	blah
aristoteles	aristotle
temperaturer	temperatures
avløst	relieved
lovlig	legal
lovlig	lawful
rovers	rovers
beslutning	decision
sainte	sainte
bengt	bengt
yuan	yuan
six	six
ward	ward
kjære	honey
kjære	dear
speed	speed
creek	creek
erlend	erlend
cole	cole
troll	troll
troll	trolls
iver	iver
iver	zeal
peak	peak
varierte	varied
sukker	sugar
note	note
ide	ide
ide	idea
behandler	processing
behandler	treats
ensemble	ensemble
disk	disk
ekstreme	extreme
skall	shell
flying	flying
angi	set
angi	enter
hoppe	jump
hoppe	hoppe
geologi	geology
seattle	seattle
geologiske	geologic
hjul	wheel
hjul	wheels
beskrivelser	descriptions
circuit	circuit
prinsipp	principle
prinsipp	principles
delhi	delhi
landevei	highway
fiende	enemy
fiende	foe
østlig	eastern
pensjon	pension
vitne	witnesses
vitne	witness
stange	stange
håndverk	craft
håndverk	crafts
ivrig	eager
västra	västra
heaven	heaven
avslo	declined
avslo	refused
yorkshire	yorkshire
undersøkt	investigated
undersøkt	examined
undersøkt	researched
sjøsatt	launched
konkluderte	concluded
gylne	golden
cdu	cdu
utgiver	publisher
utgiver	publishers
øyeblikk	moments
øyeblikk	moment
øyeblikk	instant
utfordringer	challenges
ordinær	ordinary
eksistere	exist
nora	nora
lei	lei
produksjoner	productions
uganda	uganda
blanke	shiny
samtaler	conversations
lorentzen	lorentzen
flatt	flat
elite	elite
teigen	teigen
seksten	sixteen
riga	riga
ahmed	ahmed
kjemiker	chemist
baptiste	baptiste
tegneserier	comics
woods	woods
nacional	nacional
andresen	andresen
representasjon	representation
stabil	stable
kjøp	purchase
kjøp	buy
kjøp	purchases
owen	owen
bretagne	brittany
bangladesh	bangladesh
bros	bros
herskere	rulers
tykke	thick
jiang	jiang
tomme	inch
tomme	empty
cat	cat
coast	coast
fyller	filling
fyller	fills
ketil	ketil
fortjener	deserve
fortjener	deserves
before	before
mektig	mighty
mektig	powerful
avslutte	finish
kontoret	office
sporene	spurs
markedsføring	marketing
eugene	eugene
maur	ant
maur	ants
bombefly	bomber
bombefly	bombers
boks	box
clarke	clarke
fattig	poor
segl	seals
segl	seal
mayer	mayer
fisker	fish
fisker	fisherman
våpenskjold	crest
mecklenburg	mecklenburg
floyd	floyd
århus	aarhus
tottenham	tottenham
opprettes	creates
opprettes	created
avlange	elongated
frø	seed
frø	seeds
mercury	mercury
vegetasjon	vegetation
policy	policy
utvist	expelled
maksimalt	maximum
paolo	paolo
massiv	massive
germain	germain
simpson	simpson
earl	earl
rogers	rogers
salget	sales
kobayashi	kobayashi
forsvarer	defender
forsvarer	defending
produsenten	producer
rafael	raphael
rafael	rafael
regime	regime
overrasket	surprised
any	any
kristine	kristine
opplevelser	experiences
tiger	tiger
dominerer	dominating
dominerer	dominates
ost	cheese
hoel	hoel
takt	tact
brygge	pier
brygge	jetty
muhammed	muhammad
ambassaden	embassy
eduard	eduard
carnegie	carnegie
intervjuer	interviews
intervjuer	interviewing
madison	madison
kvalifisere	qualify
survey	survey
konsekvent	consistently
konsekvent	consistent
village	village
gælisk	gaelic
imago	imago
elektrisitet	electricity
konkurrere	compete
same	same
glemt	forgot
glemt	forgotten
bue	bow
bokstavelig	literally
bokstavelig	literal
christen	christen
systems	systems
romantiske	romantic
sykler	bicycles
sykler	bikes
sykler	biking
claudius	claudius
fond	fund
pokémon	pokémon
pokémon	pokemon
johanna	johanna
johanna	joanna
philipp	philipp
kjemper	giants
montgomery	montgomery
slank	slim
alba	alba
uheldig	unlucky
uheldig	unfortunate
unesco	unesco
påstand	claim
påstand	allegation
hektar	acres
knust	shattered
knust	devastated
knust	crushed
knust	broken
seile	sail
solheim	solheim
oppfunnet	invented
konservativ	conservative
display	display
andorra	andorra
falsk	false
falsk	fake
munk	monk
munk	munk
clements	clements
ombygging	remodeling
ombygging	remodel
tomas	tomas
mali	mali
hals	throat
hals	neck
formue	fortune
fet	bold
fet	fat
summen	sum
inter	inter
spinner	spinning
spinner	spins
nikolai	nikolai
waters	waters
hydrogen	hydrogen
audun	audun
tester	tests
tester	testing
imdb	imdb
curtis	curtis
ukrainske	ukrainian
carlsen	carlsen
without	without
todd	todd
tove	tove
nøyaktige	accurate
castro	castro
himmel	heaven
himmel	sky
plasserer	placing
phoenix	phoenix
ibm	ibm
rob	rob
rca	rca
manuelt	manually
westwood	westwood
gudinne	goddess
arms	arms
urter	herbs
omgivelser	surroundings
filosofisk	philosophical
velkjent	familiar
erstatter	replacing
erstatter	replaces
erstatter	replacement
skarp	sharp
slåss	fighting
stanford	stanford
marcel	marcel
overgrep	abuse
rex	rex
gaver	gifts
gaver	presents
marseille	marseille
marseille	marseilles
player	player
mel	flour
mel	mel
lidelser	hardships
muntlig	oral
utah	utah
drøm	dream
auto	auto
lind	lind
uci	uci
edith	edith
utøverne	athletes
tilbudet	offer
kamerun	cameroon
ferguson	ferguson
ferdigheter	skills
fremmed	stranger
stjernene	stars
command	command
madsen	madsen
tolkes	interpreted
signal	signal
instrumental	instrumental
kaster	throwing
løpere	runners
oppdage	discovering
oppdage	detecting
oppdage	detect
oppdage	discover
tilnærming	approach
board	board
vogt	vogt
jylland	jutland
fairmaire	fairmaire
utslipp	emissions
busser	buses
zhou	zhou
verb	verb
verb	verbs
marina	marina
satse	bet
løve	lion
interesserte	interested
setninger	sentences
alpine	alpine
nattfly	noctuidae
grov	aggravated
margin	margin
dødelig	lethal
dødelig	deadly
dødelig	fatal
dødelig	mortal
krise	crisis
vurderte	rated
vinduer	windows
richmond	richmond
imo	imo
dong	dong
krogh	krogh
innsikt	insight
innsikt	insights
next	next
strømsgodset	strømsgodset
alessandro	alessandro
ideologi	ideology
salme	hymn
salme	psalm
modifisert	modified
ekstern	external
sofie	sofie
sammenslåingen	merge
sammenslåingen	merging
symboliserer	symbolizes
jefferson	jefferson
temple	temple
vellykkede	successful
shandong	shandong
internt	internal
internt	internally
søkt	applied
søkt	searched
due	pigeon
due	dove
krigene	wars
jung	jung
richards	richards
edda	edda
guyana	guiana
guyana	guyana
norfolk	norfolk
notert	noted
heyerdahl	heyerdahl
clara	clara
posthumt	posthumous
harper	harper
tunneler	tunnels
control	control
kid	kid
emmy	emmy
elin	elin
queens	queens
kulturelt	culturally
gun	gun
enger	pastures
solveig	solveig
yale	yale
ifk	ifk
brød	bread
ain	ain
aluminium	aluminium
aluminium	aluminum
kreis	kreis
bestilt	booked
bestilt	ordered
nebraska	nebraska
brakt	brought
cornelius	cornelius
skoger	woods
skoger	forests
slovakisk	slovakian
slovakisk	slovak
medley	medley
sirkel	circle
bensin	petrol
bensin	gas
bensin	gasoline
sapporo	sapporo
trenge	need
trenge	needing
stol	chair
viken	viken
mhz	mhz
midlertidige	temporary
omgivelsene	surroundings
bryllup	weddings
bryllup	wedding
bowie	bowie
registrering	registration
kiel	kiel
korrupsjon	corruption
stopp	stop
munnspill	harmonica
kontakter	contacts
norwich	norwich
newman	newman
størrelser	sizes
wimbledon	wimbledon
aviation	aviation
nevada	nevada
ulykke	accident
tillate	allowing
tillate	allow
tillate	permit
oddvar	oddvar
limited	limited
initiativet	initiative
legeme	body
nature	nature
thorvald	thorvald
mag	mag
lilla	purple
lilla	lilla
utlendinger	foreigners
eggen	eggen
hytte	cottage
hytte	cabin
religiøst	religiously
religiøst	religious
kaffe	coffee
hjemmesiden	homepage
skyldig	guilty
irene	irene
dam	pond
dam	checkers
dam	dam
heinz	heinz
nanjing	nanjing
gallia	gaul
operation	operation
keramikk	ceramic
keramikk	ceramics
fiendtlige	hostile
slektning	relative
nominerte	nominees
metropolitan	metropolitan
fogderi	bailiwick
volvo	volvo
guitar	guitar
sinn	mind
sinn	minds
restaurering	restoration
kampanjen	campaign
vogner	chariots
vogner	carriages
vogner	wagons
registrere	register
need	need
tobias	tobias
satset	bet
lam	lamb
lam	lam
lam	lambs
wade	wade
hedret	memorialized
hedret	honoured
hedret	honored
måles	measured
daily	daily
fenomener	phenomena
hyllest	tribute
hyllest	homage
betraktelig	considerably
betraktelig	significantly
lesning	reading
verdifulle	valuable
opus	opus
drivstoff	fuel
emanuel	emanuel
plast	plastics
plast	plastic
følelse	feeling
tonnasje	tonnage
visa	visa
åpnes	opens
hampshire	hampshire
utallige	countless
lorenzo	lorenzo
#dfffdf	#dfffdf
oppgjør	showdown
medium	medium
felder	felder
instruktør	instructor
beveget	moved
jubileum	anniversary
oppnevnt	appointed
hovedkvarteret	headquarters
batteri	battery
underliggende	underlying
monumentet	monument
bønn	praying
bønn	prayer
holdninger	attitudes
kriminelle	criminals
simpsons	simpsons
trust	trust
joel	joel
høyder	heights
tomt	empty
tomt	blank
ruud	ruud
påstått	alleged
pax	pax
auguste	auguste
must	must
steffen	steffen
benny	benny
garcía	garcía
essex	essex
presidenter	presidents
bangkok	bangkok
reform	reform
redaktører	editors
egon	egon
eli	eli
col	col
aux	aux
anmeldelser	reviews
prisene	prices
restauranter	restaurants
depresjon	depression
mus	mice
mus	mouse
norton	norton
amalie	amalie
ellevte	eleventh
ten	ten
amerikanere	americans
prestasjoner	achievements
marilyn	marilyn
scandinavian	scandinavian
prosjektene	projects
komponenter	components
born	born
xvi	xvi
reservoaret	reservoir
tretti	thirty
måne	moon
primitive	primitive
inviterte	invited
fat	fat
css	css
kirka	church
bella	bella
krag	krag
menigheter	parishes
guangzhou	guangzhou
hålogaland	hålogaland
davies	davies
anklager	accusations
bern	bern
bonn	bonn
ris	rice
ris	ris
meldinger	messaging
meldinger	messages
forårsaker	causes
halvkule	hemisphere
signatur	signature
akter	aft
olsson	olsson
helga	helga
myten	myth
datamaskin	computer
opprettelse	creation
duncan	duncan
alfonso	alfonso
sikt	aim
sikt	visibility
mother	mother
lagring	storage
lagring	saving
lettvekt	lightweight
fremtid	future
fremtid	futures
fattigdom	poverty
hekker	nesting
utsiden	outside
prefektur	prefecture
christ	christ
belønning	reward
eritrea	eritrea
begynnelse	beginning
intel	intel
salzburg	salzburg
borger	citizen
bryan	bryan
dragon	dragon
leveres	delivered
oppfinner	inventor
rothschild	rothschild
propaganda	propaganda
captain	captain
magic	magic
third	third
kartlagt	mapped
fossil	fossils
fossil	fossil
selvbiografi	autobiography
greg	greg
forbedringer	improvements
forbedringer	enhancements
leicester	leicester
haven	haven
nøytrale	neutral
perfekt	perfect
måner	moons
atmosfære	atmosphere
besatt	possessed
besatt	obsessed
utkast	draft
utkast	drafts
hannibal	hannibal
kommunistene	communists
preston	preston
sjekk	check
laos	laos
frue	madam
gjensidig	mutual
edit	edit
bis	bis
pradesh	pradesh
konsulent	consultant
konsulent	consulting
fjerner	removing
fjerner	removes
wessel	wessel
jessica	jessica
rachel	rachael
rachel	rachel
læring	learning
jong	jong
levninger	remains
centimeter	centimeters
centimeter	centimetre
igor	igor
krevende	demanding
karakterer	grades
marion	marion
kap	kap
grenoble	grenoble
islamsk	islamic
talk	talk
jakobsen	jakobsen
stade	stade
foreninger	associations
mineraler	minerals
lübeck	lübeck
tørr	dry
rykter	rumors
rykter	rumours
tilhørighet	affiliation
tilhørighet	affinity
diskuteres	discussed
mesopotamia	mesopotamia
genetisk	genetic
unix	unix
standarder	standards
teologisk	theological
gibson	gibson
mulighetene	possibilities
grafikk	graphics
grafikk	artwork
sjekket	checked
bearbeidet	processed
aksjon	action
søknad	application
finans	finance
reality	reality
ferge	ferry
trygt	safe
innehar	possesses
innehar	possess
omringet	surrounded
umeå	umeå
copa	copa
nominasjon	nominations
nominasjon	nomination
kriminalitet	crime
brt	brt
hengende	hanging
benedikt	benedict
benedikt	benedikt
beholder	keeping
beholder	container
hvile	rest
gotisk	gothic
avgjørelsen	decision
motors	motors
stasjonene	stations
bonaparte	bonaparte
folketinget	parliament
anonyme	anonymous
turer	rides
turer	trips
sans	sans
tante	auntie
tante	aunt
høylandet	highlands
ark	ark
hviler	resting
erobring	conquest
rikdom	wealth
hårete	hairy
argentinske	argentinian
moral	morals
verft	shipyard
plattformen	platform
hunt	hunt
dawn	dawn
langsomt	slowly
chuck	chuck
aspekter	aspects
emi	emi
budskap	messaging
budskap	message
winchester	winchester
murphy	murphy
canal	canal
ajax	ajax
fortsettelse	continued
omar	omar
robertson	robertson
bart	bart
bart	mustache
gjennomgang	review
kinoer	theaters
kinoer	cinemas
andrews	andrews
bryggeri	brewery
terror	terror
monster	monster
novgorod	novgorod
hentes	retrieving
hentes	retrieved
rein	rein
rein	clean
oppvarming	heating
oppvarming	warming
tibetansk	tibetan
pels	fur
framgang	progress
utrecht	utrecht
wei	wei
overskrift	headline
overskrift	header
tilpasse	customize
tilpasse	customise
tilpasse	adapt
kolonne	column
erfarne	experienced
kryss	intersection
kryss	cross
starr	starr
bureau	bureau
stuping	diving
word	word
fødselen	birth
forbedring	improvement
tau	rope
tau	tau
tau	ropes
andrej	andrej
andrej	andrey
andrej	andrei
lien	lien
guardian	guardian
sem	sem
diesel	diesel
bucurești	bucharest
oppfylt	fulfilled
brandt	brandt
tildeling	allocation
planlegger	scheduling
planlegger	planning
planlegger	plans
kledd	dressed
agency	agency
mohamed	mohamed
estimert	estimated
duke	duke
holmenkollen	holmenkollen
fuktig	humid
things	things
hjulpet	helped
nou	nou
mannlig	male
isu	isu
albrecht	albrecht
avslører	reveals
forberede	prepare
detaljerte	detailed
ivareta	protect
ivareta	safeguard
utenlands	overseas
utenlands	abroad
tegne	draw
tegne	drawing
bei	bei
aksjer	shares
percy	percy
kalmar	kalmar
liège	liege
liège	liège
antydet	hinted
varig	durable
varig	lasting
skyter	shoots
skyter	firing
cbs	cbs
ulrik	ulrik
kansler	chancellor
skarpe	sharp
papua	papua
klinisk	clinical
videoen	video
flytting	relocation
flytting	moving
aberdeen	aberdeen
rømme	escape
kraków	cracow
kraków	krakow
kraków	kraków
tinn	tin
shaw	shaw
bergman	bergman
psykologisk	psychological
irving	irving
cleveland	cleveland
målene	goals
målene	targets
vokaler	vowels
manuskripter	manuscripts
støy	noise
innstilling	attitude
labour	labour
helten	hero
hardy	hardy
frost	frost
raser	races
avslutning	ending
française	française
underholdning	entertaining
underholdning	entertainment
viborg	viborg
fotografi	photography
fotografi	photograph
engineering	engineering
farao	pharaoh
tetthet	density
kursiv	italic
dagbok	journal
dagbok	diary
ankommer	arrives
ankommer	arriving
ankommer	arrive
wings	wings
bevissthet	awareness
bevissthet	consciousness
rotterdam	rotterdam
mystiske	mystic
look	look
cato	cato
ekspansjon	expansion
yunnan	yunnan
kirkenes	kirkenes
forbød	banned
range	range
forbrytelser	crimes
landing	landing
toulouse	toulouse
intern	internal
utrolig	amazing
utrolig	unbelievable
utrolig	incredible
orlando	orlando
justin	justin
birkeland	birkeland
alliance	alliance
flyplasser	airports
antok	assumed
tyler	tyler
holger	holger
lucy	lucy
burton	burton
psykolog	psychologist
brenner	burning
brenner	brenner
brenner	burns
skandinavisk	scandinavian
prima	prima
ullevaal	ullevaal
dyre	expensive
elsket	loved
duck	duck
kontekst	context
tegneserie	comics
tegneserie	cartoon
huang	huang
glade	glade
alexandre	alexandre
purple	purple
oder	oder
likeledes	similarly
trim	trim
trim	exercise
somalia	somalia
bennett	bennett
topper	topper
topper	peaks
kritikker	reviews
signaler	signals
bakre	rear
discogs	discogs
hager	gardens
jakter	hunts
investeringer	investing
investeringer	investments
antonius	antony
tankene	thoughts
estiske	estonian
piper	piper
forutsetning	prerequisite
emmanuel	emmanuel
gynt	gynt
ulykker	misfortunes
ulykker	accidents
terminal	terminal
fravær	absence
vakt	guard
hengt	hung
hengt	hanged
ungdommer	kids
overføre	transfer
overføre	transferring
tenor	tenor
beyond	beyond
opplagt	obvious
håret	hair
vinkel	angle
bulgarske	bulgarian
very	very
leie	renting
leie	hire
leie	rent
walt	walt
glomma	glomma
federal	federal
tolvte	twelfth
forestilling	performance
mick	mick
indianere	indians
arkiver	archive
arkiver	archives
bekostning	expense
overordnede	superiors
honduras	honduras
henter	acquiring
henter	fetching
henter	getting
henter	retrieving
overveiende	predominantly
redaksjonen	newsroom
lexikon	lexikon
dynamisk	dynamic
kollega	colleague
leserne	readers
ørkenen	desert
hovedfag	majors
besittelse	possession
guddommelige	divine
massive	massive
spektrum	spectrum
forblir	remains
forblir	remain
forblir	stays
ska	ska
styring	governance
import	importing
import	import
trinidad	trinidad
omstendigheter	circumstance
omstendigheter	circumstances
skjule	hide
permanente	permanent
liechtenstein	liechtenstein
anatomi	anatomy
jemen	yemen
rømte	escaped
tilflukt	refuge
regjeringer	governments
enestående	exceptional
enestående	outstanding
moralsk	moral
jorge	jorge
fisken	fish
eksperimenter	experiments
magnusson	magnusson
something	something
håndbok	handbook
orknøyene	orkney
nassau	nassau
motion	motion
kompleks	complex
manhattan	manhattan
kopiert	copied
festivaler	festivals
detalj	detail
danse	dance
lokalene	premises
darwin	darwin
schloss	schloss
sel	sel
sel	seal
nation	nation
noenlunde	moderately
religionen	religion
won	won
maximilian	maximilian
