din	from
care	who
care	which
mai	mai
mai	more
pentru	for
lui	lui
lui	his
sunt	are
sit	site
după	after
ale	ale
lea	lea
prin	through
regiunea	region
mare	great
mare	big
mare	sea
anul	year
comună	common
are	has
externe	external
locuitori	inhabitants
locuitori	residents
legături	links
legături	connections
vezi	see
dar	but
cod	code
cod	cod
populație	population
bucurești	bucharest
bucurești	bucurești
fiind	being
românia	romania
jpg	jpg
lista	list
ucraina	ukraine
nume	name
ani	ani
ani	years
avea	had
între	between
până	till
până	until
comuna	municipality
comuna	common
poate	maybe
poate	perhaps
două	two
rege	king
sub	under
alte	other
când	when
regiune	region
anii	years
parte	part
județul	county
centura	seatbelt
centura	belt
dinastia	dynasty
septembrie	september
timp	time
despre	about
unde	where
majoritatea	most
majoritatea	majority
densitate	density
limbă	tongue
limbă	language
iunie	june
multe	many
prima	first
octombrie	october
august	august
sat	village
sat	sat
martie	march
biserica	church
fișier	file
decembrie	december
toate	all
ianuarie	january
latns	latns
latd	latd
longd	longd
adresă	address
noiembrie	november
cum	how
imagine	picture
imagine	image
statul	state
lor	their
avut	had
familia	family
numele	name
timpul	time
nord	north
nord	nord
principală	main
sud	south
aprilie	april
erau	were
loc	place
primul	first
iulie	july
doar	only
doar	just
editura	publisher
asteroid	asteroid
februarie	february
recensământului	census
listă	list
trei	three
asteroizi	asteroids
limba	tongue
limba	language
lats	lats
longm	longm
latm	latm
discuție	discussion
franța	france
partea	part
mult	much
fără	without
departamentul	department
foarte	very
raionul	aisle
data	date
data	data
departament	department
unul	one
apoi	then
grup	group
locul	place
oraș	town
oraș	city
pot	can
camp	camp
germania	germany
face	make
satul	village
național	national
note	notes
perioada	period
minoritate	minority
ucraineană	ukrainian
cadrul	framework
general	general
război	war
română	romanian
află	learn
început	started
început	beginning
iii	iii
duce	duke
duce	duce
român	romanian
provincia	province
existând	existing
vedere	view
wikipedia	wikipedia
specie	species
punct	dot
punct	point
stat	state
unite	united
moldova	moldova
file	tabs
atunci	then
aceste	these
secolul	century
una	one
aceasta	this
life	life
reședință	residence
orașul	city
tot	all
tot	still
chiar	even
făcut	made
cunoscute	known
film	movie
film	film
perioadă	period
vorbitori	speakers
date	dates
date	data
trebuie	must
cunoscută	known
decât	than
aici	here
mari	big
mari	mari
zile	days
față	front
față	face
club	club
componente	components
ulterior	subsequently
est	east
est	est
nou	new
ales	chosen
numai	only
având	having
ioan	john
ion	ion
rusă	russian
isbn	isbn
populația	population
doi	two
același	same
membru	member
dată	date
numit	named
numit	called
descrisă	described
oficial	official
oficial	officially
nici	neither
nici	nor
împotriva	against
deși	although
deși	though
saint	saint
împreună	together
specia	species
vest	west
vest	western
italia	italia
italia	italy
puțin	little
excentricitate	eccentricity
încă	still
descoperit	discovered
descoperit	uncovered
înainte	forward
înainte	before
lemn	wood
noi	new
nicolae	nicholas
nicolae	nicolae
națională	national
subspecii	subspecies
statele	states
roman	roman
roman	novel
drept	straight
mod	mode
mod	mod
american	american
fiecare	every
fiecare	each
prezent	present
casa	house
acestea	these
printre	among
categorie	category
text	text
cluj	cluj
bine	good
bine	okay
http	http
site	site
articole	articles
articole	items
alexandru	alexandru
alexandru	alexander
unele	some
milioane	million
milioane	millions
apă	water
doua	two
iași	iași
ori	ori
țară	country
sate	villages
târziu	late
istoria	history
maria	maria
cunoscut	known
patru	four
republica	republic
cca	approx
râul	river
formată	formed
paris	paris
gheorghe	gheorghe
gheorghe	george
tip	guy
tip	type
premiul	prize
premiul	award
putea	could
persoane	persons
persoane	people
constantin	constantin
constantin	constantine
etc	etc
exemplu	example
descriere	description
george	george
articol	article
născut	born
numărul	number
comitatul	county
harta	map
john	john
jos	down
marea	sea
deoarece	because
localitate	locality
aproape	almost
scris	written
raport	report
echipa	squad
echipa	team
diferite	different
baza	base
special	special
valea	valley
comune	joint
ele	they
stadium	stadium
svg	svg
zona	zone
zona	area
dat	given
slovenia	slovenia
americii	america
satului	village
împărat	emperor
localitatea	locality
resedinta	residence
viața	life
bun	good
cet	cet
format	formed
format	format
primit	received
președinte	president
președinte	chairman
lângă	near
oameni	people
istoric	historic
istoric	historian
istoric	historical
istoric	history
suprafață	surface
suprafață	area
europa	europe
europa	europa
universitatea	university
team	team
copii	kids
copii	children
aproximativ	approximate
aproximativ	approximately
aproximativ	roughly
lucru	thing
lucru	work
cazul	case
români	romanian
români	romanians
folosit	used
orice	any
ibn	ibn
mihai	mihai
mihai	michael
acum	now
recensământul	census
centrul	center
centrul	centre
reprezintă	represents
reprezintă	represent
san	san
teritoriul	territory
van	van
ungaria	hungary
număr	number
cauza	cause
bulgaria	bulgaria
engleză	english
serie	series
sua	usa
vechi	old
reședința	residence
munții	mountains
limbi	languages
fel	kind
apelor	waters
fotbal	soccer
fotbal	football
regele	king
fiul	son
anterior	previously
anterior	previous
nouă	new
nouă	nine
evoluția	evolution
viteză	speed
paul	paul
palomar	palomar
orașe	cities
institutul	institute
satele	villages
lansat	released
lansat	launched
istorice	historical
trecut	past
articolul	article
mulți	many
viață	life
informații	information
titlu	headline
titlu	title
goluri	goals
titlul	title
album	album
york	york
von	von
pagina	page
imperiul	empire
moartea	death
apare	appears
fața	face
armata	army
formă	shape
formă	form
color	color
color	colour
german	german
ștefan	stephen
ștefan	ștefan
ștefan	stefan
rolul	role
mică	small
mică	mica
des	des
des	often
transilvania	transylvania
epocă	vintage
începând	starting
principal	main
principal	principal
forma	shape
forma	form
carol	carol
mici	small
astăzi	today
robert	robert
apărut	appeared
eliberare	release
eliberare	liberation
european	european
mic	small
mic	little
mic	mic
minore	minor
câștigat	won
gen	gender
gen	genre
gen	genus
gen	gen
caracterizată	characterised
caracterizată	characterized
com	com
importante	important
der	der
aur	gold
luat	taken
murit	died
germană	german
kitt	kitt
orbită	orbit
rotație	rotation
pol	pol
pol	pole
lume	world
local	locally
local	local
fapt	fact
anglia	england
politică	policy
politică	politics
spacewatch	spacewatch
devine	devine
revista	magazine
asta	this
asta	that
vasile	vasile
vasile	basil
profesor	professor
profesor	teacher
planetelor	planets
cinci	five
acolo	there
lumea	world
muzică	music
situat	located
situat	situated
david	david
țara	country
vol	vol
etnică	ethnic
centru	center
centru	centre
alt	alt
istorie	history
austria	austria
districtul	district
altitudine	altitude
periheliu	perihelion
regatul	kingdom
conține	contains
activitatea	activity
sultan	sultan
afeliu	aphelion
inițial	initially
inițial	originally
inițial	initial
artă	art
descoperitor	discoverer
numeroase	numerous
body	body
imagini	images
imagini	pictures
rusia	russia
spune	say
domeniul	domain
școala	school
polonia	poland
succes	success
provincie	province
studii	study
studii	studies
inclusiv	including
primar	mayor
primar	primary
francez	frenchman
francez	french
privind	watching
scriitor	writer
jean	jean
sistemul	system
începe	start
ziua	day
sur	sur
single	single
urmat	followed
războiul	war
world	world
xix	xix
internațional	international
franceză	french
pare	seems
william	william
ministru	minister
important	important
familie	family
politic	politically
politic	political
chișinău	chișinău
țări	countries
funcția	function
jpl	jpl
lucrări	works
publicat	published
mircea	mircea
curs	course
probabil	probably
considerat	considered
sistem	system
politice	political
sudul	southern
sudul	south
vreme	weather
autor	author
mediu	environment
mediu	average
mediu	medium
prea	too
dezambiguizare	disambiguation
spania	spain
funcție	function
categoria	category
nivel	level
web	web
top	top
mihail	mikhail
mihail	michael
mihail	mihail
biserică	church
realizat	achieved
realizat	accomplished
cartea	book
filme	films
filme	movies
noua	new
căsătorit	married
png	png
muzeul	museum
city	city
afluent	tributary
construit	built
luptă	battle
luptă	fight
unit	united
luni	months
luni	monday
jucat	played
zone	zones
zone	areas
radio	radio
romano	romano
istorică	historic
istorică	historical
deja	already
monument	monument
europene	european
fac	doing
dreapta	right
moment	moment
componenta	component
cantonul	canton
vârsta	age
km²	km²
toți	all
bază	base
ultima	last
origine	origin
recensământ	census
actor	actor
literatură	literature
anderson	anderson
veche	old
timișoara	timișoara
les	les
participat	participated
guvernul	government
estul	east
total	total
total	totally
japonia	japan
sibiu	sibiu
petru	petru
petru	peter
conte	count
conte	conte
alba	alba
bavaria	bavaria
roma	rome
roma	roma
specii	species
cupa	cup
bătălia	battle
ceva	something
membri	members
calitate	quality
scrie	write
euro	euro
uniunii	union
scurt	short
scurt	brief
mama	mom
mama	mother
creat	created
campionatul	championship
del	del
locuri	places
locuri	seats
uri	uri
mănăstirea	monastery
america	america
produs	produced
produs	product
ultimul	last
condus	driven
președintele	president
andrei	andrey
andrei	andrei
radu	radu
brazilia	brazil
suceava	suceava
james	james
declarat	declared
surse	sources
obicei	habit
compania	company
etnic	ethnic
echipe	teams
sezonul	season
central	central
dan	dan
unii	some
liga	league
liga	liga
rol	role
loire	loire
india	india
construită	built
construită	constructed
uniunea	union
obținut	obtained
obținut	achieved
cărți	cards
cărți	books
opera	opera
rock	rock
zonă	zone
zonă	area
stil	style
pus	put
video	video
teatru	theater
teatru	theatre
ziarul	newspaper
www	www
militară	military
post	post
românesc	romanian
plus	plus
richard	richard
china	china
codul	code
administrația	administration
fiica	daughter
scopul	aim
scopul	purpose
scopul	goal
situată	situated
grupul	group
victor	victor
michael	michael
londra	london
insula	island
poziția	position
poziția	heading
charles	charles
forțele	forces
albumul	album
diverse	various
diverse	miscellaneous
intrat	entered
șase	six
director	director
director	directory
website	website
militar	military
originală	original
state	states
state	state
pop	pop
azi	today
uneori	sometimes
university	university
cultural	cultural
trimis	sent
bar	bar
henric	henry
folosite	used
jumătate	half
capitala	capital
fizice	physical
mexico	mexico
activitate	activity
mesa	mesa
sfântul	saint
științe	sciences
soția	wife
metri	meters
metri	metres
imperiului	empire
centrală	central
vii	vii
singur	alone
singur	single
singur	lonely
public	public
public	publicly
nevoie	need
nevoie	needed
oamenii	humans
oamenii	people
caz	case
televiziune	television
curtea	court
probleme	trouble
probleme	problems
probleme	issues
publice	public
regia	directed
plan	plan
naturale	natural
facultatea	college
facultatea	faculty
pământ	earth
pământ	land
viena	vienna
houten	houten
principale	main
prim	prime
prim	prim
arte	arts
alți	other
seria	series
dezvoltarea	development
dezvoltarea	developing
direct	straight
direct	direct
direct	directly
șef	chief
palatul	palace
termenul	term
altele	other
altele	others
carte	book
auto	auto
africa	africa
religie	religion
minor	minor
conducerea	management
conducerea	leadership
asia	asia
final	end
final	final
adus	brought
para	pear
para	para
următoarea	next
părți	parts
părți	parties
fratele	brother
membrii	members
acord	agreement
ambele	both
teatrul	theater
teatrul	theatre
stânga	left
catolici	catholics
press	press
traducere	translation
ludovic	louis
dumnezeu	god
momentul	moment
drumul	road
evenimente	events
district	district
und	und
luna	luna
luna	moon
luna	month
publică	public
publică	publish
arad	arad
poet	poet
peter	peter
victoria	victoria
fondat	founded
sovietică	soviet
nivelul	level
rus	russian
rus	rus
poartă	gate
poartă	wear
martin	martin
observatorul	observatory
observatorul	observer
europeană	european
adrian	adrian
dumitru	dumitru
https	https
romane	novels
continuat	continued
pas	step
pas	pas
spus	said
spus	told
united	united
păianjeni	spiders
biserici	churches
berlin	berlin
proiectului	project
lumina	light
haute	haute
elemente	items
elemente	elements
piatră	stone
piatră	rock
produse	product
produse	products
romania	romania
thomas	thomas
napoca	napoca
sec	sec
piese	tracks
piese	parts
piața	market
găsit	found
muzica	music
folosită	used
casă	house
casă	home
afaceri	business
vestul	west
legătură	link
grecia	greece
liber	free
înseamnă	means
pagini	pages
national	national
moscova	moscow
comunist	communist
britanic	british
linia	line
medie	average
medie	medium
sovietice	soviet
puterea	strength
puterea	power
puternic	strong
puternic	powerful
oficială	official
legea	law
pierdut	lost
colspan	colspan
afara	outside
afara	out
cariera	career
germani	germans
rezultat	result
structura	structure
rândul	row
nordul	north
nordul	northern
ușor	easy
ușor	slightly
putere	strength
putere	power
anumite	certain
adevărul	truth
xviii	xviii
black	black
ediția	edition
castelul	castle
fiu	son
naturală	natural
consiliului	council
importantă	important
cetatea	fortress
cetatea	citadel
poltava	poltava
suprafața	surface
premii	awards
premii	prizes
puncte	dots
puncte	points
prințul	prince
meteorologie	meteorology
lungime	length
social	socially
social	social
rapid	quick
rapid	fast
generalul	general
femei	women
international	international
descrierea	description
școală	school
original	original
șapte	seven
plante	plants
kiev	kiev
ediție	edition
hidrologie	hydrology
locale	local
bacău	bacău
ocupat	busy
ocupat	occupied
adesea	often
volumul	volume
louis	louis
australia	australia
continuă	continue
referințe	references
online	online
media	media
efectuat	performed
permite	allow
nimic	nothing
consiliul	council
încercat	tried
literară	literary
simplu	simple
imediat	immediately
canada	canada
punctul	point
superioară	superior
wilhelm	william
wilhelm	wilhelm
sociale	social
grigore	grigore
grigore	gregory
științifică	scientific
planet	planet
deasupra	above
joseph	joseph
arheologice	archaeological
case	case
case	houses
art	art
stabilit	established
politician	politician
scurtă	short
scurtă	brief
ortodoxă	orthodox
detalii	details
detalii	detail
trupele	troops
internet	internet
real	real
urss	ussr
cultura	culture
romanul	novel
problema	problem
volume	volumes
americană	american
țările	countries
mesaj	message
hartă	map
internațională	international
ciuda	spite
academia	academy
legate	linked
legate	related
persoană	person
complet	complete
complet	completely
major	major
totală	total
cultură	culture
obiective	objectives
obiective	goals
obiective	targets
actriță	actress
măsură	measure
existat	existed
abu	abu
catolică	catholic
superior	superior
deschis	open
joc	game
parcul	park
stare	status
stare	state
stare	condition
ferdinand	ferdinand
fizică	physics
fizică	physical
man	man
procesul	process
procesul	trial
unități	units
cale	path
cale	cale
rămâne	remains
rămâne	stays
ministerul	ministry
clasa	class
lipsa	lack
proiect	project
formează	dial
fotbalist	footballer
santa	santa
administrativ	administrative
devenind	becoming
pune	put
naștere	birth
calea	path
stadion	stadium
departe	away
semnat	signed
greacă	greek
roșu	red
articolele	articles
lupta	fighting
lupta	fight
neamț	neamț
văzut	seen
văzut	saw
niciodată	never
greco	greco
economice	economic
drosophila	drosophila
otoman	ottoman
împăratul	emperor
divizia	division
metal	metal
monumente	monuments
muhammad	muhammad
dezvoltare	development
cursul	course
construcție	construction
alb	white
bulgari	bulgarians
bulgari	bulgarian
verde	green
urmează	follow
maghiari	hungarians
debit	flow
debit	debit
hunedoara	hunedoara
arată	shows
arată	show
acțiune	action
saxonia	saxony
include	include
include	includes
obține	get
league	league
daniel	daniel
destul	enough
jurnalul	journal
jurnalul	diary
argeș	argeș
turistice	tourist
live	live
publicate	published
situația	situation
maghiară	hungarian
negru	black
omul	man
interes	interest
știință	science
acordat	granted
acordat	tuned
acordat	awarded
alții	others
teoria	theory
karl	karl
rând	row
folosește	use
valoare	value
civil	civil
civil	civilian
armată	military
armată	army
tudor	tudor
modul	mode
modul	module
modul	plugin
regizat	directed
albert	albert
sursă	source
lacul	lake
ocupă	occupy
per	per
italian	italian
schimb	exchange
schimb	swap
singură	alone
singură	single
confesional	confessional
craiova	craiova
culoare	color
culoare	colour
chitară	guitar
muncă	work
model	model
model	template
trece	passes
trece	pass
folosind	using
literare	literary
găsește	find
apropiere	closeness
studio	studio
materiale	material
materiale	materials
dezvoltat	developed
populară	popular
frederic	frederic
frederic	frederick
corpul	body
elena	elena
populare	popular
ideea	idea
autori	authors
diagrama	diagram
cercetare	research
actual	current
companie	company
crimeea	crimea
crimeea	crimean
controlul	control
california	california
minute	minutes
artist	artist
pace	peace
târgu	târgu
galați	galați
societatea	society
comitat	shire
evrei	jews
sens	sense
formula	formula
meci	match
contra	contra
contra	counter
contra	against
buzău	buzău
apariția	emergence
utilizator	user
suedia	sweden
locuitorii	residents
prințesa	princess
comunitatea	community
cap	head
cap	cap
echipă	team
cuvinte	words
colaborare	collaboration
colaborare	collaborative
jocurile	games
literatura	literature
mijlocul	mid
personal	personal
personal	personnel
personal	personally
personal	staff
regizor	director
albă	white
cine	who
star	star
inferioară	lower
inferioară	inferior
marie	marie
muzical	musical
muzical	musically
organizat	organised
organizat	organized
literar	literary
situl	site
publicată	published
antrenor	trainer
antrenor	coach
atac	attack
atac	assault
copil	baby
copil	child
discuri	discs
discuri	records
discuri	disks
port	port
numere	numbers
scrise	written
clubul	club
romi	roma
romi	romi
infanterie	infantry
pierre	pierre
pagină	page
considerată	considered
xvi	xvi
cineva	someone
cineva	somebody
olimpice	olympic
europei	europe
voce	voice
liberă	free
popescu	popescu
greu	heavy
greu	hard
greu	tough
crescut	grown
crescut	raised
rezoluție	resolution
proiectul	project
olanda	netherlands
olanda	holland
henry	henry
finală	final
israel	israel
intrarea	entry
intrarea	entrance
vară	summer
compozitor	composer
versiunea	version
prezența	presence
vladimir	vladimir
motiv	motive
motiv	reason
neagră	black
bihor	bihor
uefa	uefa
popular	popular
existența	existence
justificare	justification
papa	papa
papa	pope
cernigău	chernihiv
sport	sport
sport	sports
ministrul	minister
poloniei	poland
creșterea	growth
studiat	studied
plasa	net
vâlcea	vâlcea
mutat	moved
scrisă	written
noastre	our
generale	general
filip	philip
filip	filip
subiect	topic
subiect	subject
politica	policy
politica	politics
comitate	counties
zece	ten
insulele	islands
park	park
arta	art
bgcolor	bgcolor
pictor	painter
gradul	degree
gradul	rank
autorul	author
ora	ora
ora	hour
ora	time
posibil	possibly
posibil	possible
onoare	honour
onoare	honor
înalt	tall
mii	thousand
mii	thousands
sumî	sumy
joacă	play
cernăuți	chernivtsi
culturale	cultural
tom	tom
continuare	continuation
continuare	sequel
ore	hours
moarte	death
vremea	weather
monumentul	monument
forme	forms
forme	shapes
program	program
program	programme
program	schedule
susținut	supported
susținut	sustained
alegerile	elections
linie	line
lungă	long
producție	production
urban	urban
strada	street
viii	viii
drum	road
lung	lung
lung	long
festivalul	festival
alta	alta
zonele	areas
tipuri	types
primii	first
versuri	verses
versuri	lyrics
steaua	star
steaua	steaua
bistrița	bistrița
jucător	player
sursa	source
familii	families
christian	christian
west	west
distanță	distance
distanță	remote
clădirea	building
biblioteca	library
formate	formed
formate	formats
piatra	stone
piatra	rock
termen	term
valoarea	value
miniatura	miniature
miniatura	thumbnail
don	don
religioase	religious
calais	calais
rio	rio
alpi	alps
doctor	doctor
drepturile	rights
emir	emir
emir	amir
turnul	tower
washington	washington
nobel	nobel
economică	economic
gentile	gentile
adăugat	added
afară	outside
afară	out
decenii	decades
stilul	style
non	non
proces	process
proces	trial
aparține	belongs
domeniu	domain
han	han
cerut	requested
xiv	xiv
comanda	command
comanda	order
interior	inside
interior	inner
interior	interior
friedrich	friedrich
madrid	madrid
bani	money
xvii	xvii
secole	centuries
crearea	creation
crearea	creating
ron	ron
șah	chess
argint	silver
intră	enter
norvegia	norway
regina	regina
regina	queen
galerie	gallery
decis	decided
dnipropetrovsk	dnipropetrovsk
unitate	unity
unitate	unit
johann	johann
campania	campania
campania	campaign
dupa	after
compus	composed
compus	compound
partid	party
scop	purpose
moderne	modern
descrie	describe
condiții	conditions
energie	energy
schimbat	changed
extrem	extremely
extrem	extreme
tratatul	treaty
elveția	switzerland
eveniment	event
totul	everything
ana	ana
aer	air
standard	standard
mișcarea	movement
solid	solid
apa	water
sezon	season
traian	traian
stadionul	stadionul
stadionul	stadium
studiile	studies
anunțat	announced
cazuri	cases
sine	sine
latină	latin
munte	mountain
edward	edward
descoperă	discover
romană	roman
conducător	ruler
conducător	leader
evenimentul	event
poziție	position
masă	table
masă	mass
masă	meal
maritime	maritime
povestea	story
spațiu	space
bas	bass
bas	bas
opt	eight
coreea	korea
interne	internal
eugen	eugen
ionescu	ionescu
încearcă	try
reprezentat	represented
prahova	prahova
parlamentului	parliament
teren	field
teren	land
teren	terrain
burgundia	burgundy
serbia	serbia
marcat	scored
marcat	marked
canton	canton
vinnița	vinnytsia
london	london
utilizat	used
severin	severin
produce	produce
produce	produces
eminescu	eminescu
france	france
cult	cult
cult	worship
otto	otto
control	control
preot	priest
versiune	version
făcute	made
cristian	cristian
lorena	lorena
lorena	lorraine
fişier	file
păstrează	keep
iosif	joseph
pyrénées	pyrénées
vrea	wants
condițiile	conditions
emil	emil
bucovina	bukovina
pictură	painting
zilele	days
prezentat	presented
prezentat	submitted
folosirea	using
sala	sala
sala	gym
turcia	turkey
animale	animals
medicină	medicine
producător	producer
producător	manufacturer
relativ	relative
relativ	relatively
vecine	neighbour
vecine	neighbor
material	material
regiuni	regions
bogdan	bogdan
basarabia	bessarabia
dolari	dollars
înălțime	height
imaginea	image
parlamentul	parliament
statutul	status
statutul	statutes
umane	human
operă	opera
natural	natural
natural	naturally
planul	plan
textul	text
plecat	gone
medalia	medal
vârstă	age
înregistrat	recorded
înregistrat	registered
preluat	retrieved
serial	serial
administrative	administrative
turci	turks
turci	turkish
absolvit	graduated
münchen	münchen
münchen	munich
xiii	xiii
vara	summer
belgia	belgium
jack	jack
normandia	normandy
sora	sister
acțiuni	shares
acțiuni	actions
autoritățile	authorities
vine	comes
name	name
răspuns	answer
răspuns	reply
răspuns	response
rezultate	results
camera	room
anna	anna
discuții	discussion
discuții	discussions
poezie	poem
poezie	poetry
economic	economic
obiecte	objects
acasă	home
budapesta	budapest
consilier	adviser
consilier	counsellor
consilier	counselor
consilier	advisor
sfârșit	end
secolele	centuries
secretar	secretary
permis	allowed
permis	permitted
maxim	max
maxim	maxim
maxim	maximum
danemarca	denmark
transport	transportation
transport	transport
coasta	coast
vaslui	vaslui
menționat	mentioned
pavel	paul
pavel	pavel
lei	lei
lei	lions
petre	petre
exact	exactly
exact	exact
cronica	chronicle
grupuri	groups
studiu	study
florin	barry
florin	florin
socială	social
fier	iron
notă	note
motive	reasons
motive	pleas
mount	mount
pian	piano
păstrat	kept
ucis	murdered
ucis	killed
direcția	direction
știe	knows
comun	common
marne	marne
soldați	soldiers
administrativă	administrative
miliarde	billion
miliarde	billions
modelul	model
știu	know
ortodoxe	orthodox
necesare	required
necesare	necessary
comentariu	comment
king	king
actuală	current
vârful	tip
pag	pag
viitor	future
clar	clear
tânăr	young
subiectul	subject
notabilitate	notability
bronz	tan
bronz	bronze
gabriel	gabriel
anton	anton
episcop	bishop
lună	moon
lună	month
habsburg	habsburg
org	org
încheiat	completed
încheiat	ended
opere	operas
ultimele	last
ultimele	latest
rog	rog
retras	retired
retras	withdrawn
sofia	sofia
spațiul	space
sediu	headquarters
river	river
interpretat	interpreted
records	records
introdus	introduced
introdus	inserted
mișcare	motion
mișcare	movement
industria	industry
femeie	woman
femeie	female
franz	franz
medic	physician
medic	medic
comandant	commandant
comandant	commander
maramureș	maramureș
bărbați	men
utilizarea	using
utilizarea	use
tehnică	technical
tehnică	technique
adresa	address
dimitrie	dimitrie
documente	documents
inclus	included
satu	satu
volum	volume
muntenegru	montenegro
max	max
meciuri	matches
baia	baia
baia	bathroom
arthur	arthur
corp	body
servicii	services
servicii	service
colecția	collection
importanță	importance
lupte	fights
lupte	wrestling
victorie	win
scriitorilor	writers
prof	prof
walter	walter
veneția	venice
desfășurat	deployed
creștere	increase
creștere	growth
oradea	oradea
dacia	dacia
house	house
caracter	character
valign	valign
numără	count
teritoriu	territory
speciale	special
south	south
debutat	debuted
înlocuit	replaced
gehrels	gehrels
săptămâni	weeks
alias	alias
marin	marin
marin	marine
albume	albums
holmes	holmes
producția	production
css	css
oscar	oscar
conflict	conflict
organizarea	organisation
capul	head
ivan	ivan
nimeni	nobody
arheologic	archaeological
apărare	defence
apărare	defense
alexander	alexander
sensul	meaning
următor	next
jocuri	games
revoluția	revolution
smith	smith
rivne	rivne
categorii	category
categorii	categories
noapte	night
acces	access
matematică	maths
matematică	mathematics
matematică	math
specifice	specific
groeneveld	groeneveld
primește	receive
primește	receives
centrale	central
lee	lee
afl	afl
povestiri	stories
scor	score
red	red
comunități	communities
portugalia	portugal
wiki	wiki
vlad	vlad
guvern	government
occidental	occidental
occidental	western
anglo	anglo
propus	proposed
barcelona	barcelona
posibilitatea	possibility
adevărat	true
austro	austro
midi	midi
realizarea	realisation
realizarea	realization
copiii	kids
copiii	children
markgraf	margrave
google	google
studiul	study
cuvânt	word
făcută	made
armate	armies
dinamo	dinamo
dinamo	dynamo
construcții	construction
refuzat	denied
refuzat	declined
refuzat	refused
oferit	offered
regină	queen
independent	independent
independent	independently
kirovohrad	kirovohrad
terminat	finished
sprijinul	support
ali	ali
modernă	modern
calificat	qualified
sydney	sydney
pictura	painting
puternică	strong
volînia	volyn
foto	photo
ridicată	raised
jan	jan
brăila	brăila
xii	xii
scorul	score
bazat	based
relații	relationships
relații	relations
fifa	fifa
north	north
ordine	order
ordine	orders
democrat	democratic
democrat	democrat
democrat	democrats
html	html
italiană	italian
ternopil	ternopil
elisabeta	elizabeth
elisabeta	elisabeth
trăit	lived
seine	seine
pro	pro
pro	pros
milano	milan
milano	milano
parțial	partly
parțial	partial
parțial	partially
forța	force
modern	modern
largă	wide
critic	critic
critic	critical
programul	program
programul	programme
programul	schedule
formatul	format
asociația	association
spectatori	spectators
spectatori	viewers
personaje	characters
trupa	band
înaltă	high
înaltă	tall
olt	olt
formarea	formation
disc	disc
disc	disk
iulia	iulia
iulia	julia
participă	participates
participă	participate
activități	activities
suferit	suffered
prinț	prince
champagne	champagne
eric	eric
influența	influence
air	air
dunării	danube
comerciale	commercial
autonomă	autonomous
învins	defeated
marius	marius
premiu	prize
premiu	award
mark	mark
garonne	garonne
educație	education
coa	coa
recunoscut	acknowledged
recunoscut	recognised
recunoscut	recognized
așezare	settlement
legătura	link
dimensiuni	dimensions
dimensiuni	sizes
activ	active
hans	hans
grad	grade
grad	grad
grad	degree
grad	rank
interviu	interview
simon	simon
tratat	treated
tratat	treaty
maximă	maximum
sisteme	systems
indicativ	indicative
arbitru	referee
arbitru	ref
intre	between
jocul	game
încredere	confidence
încredere	trust
carl	carl
cântec	song
ajutor	help
titular	holder
foc	fire
lege	law
curent	current
funcții	functions
exterior	external
exterior	exterior
catedrala	cathedral
starea	status
maghiar	hungarian
frank	frank
închisoare	jail
închisoare	prison
scriitori	writers
ținut	kept
școli	schools
grand	grand
ilie	elijah
ilie	ilie
britanică	british
hitler	hitler
secțiunea	section
șterge	delete
premiera	premiere
elst	elst
construite	built
construite	constructed
personale	personal
istoricul	history
personaj	character
deținut	inmate
făcând	doing
cezar	caesar
cere	ask
relațiile	relationships
relațiile	relations
avioane	airplanes
avioane	aircraft
avioane	aeroplanes
avioane	planes
colegiul	college
securitate	security
catalina	catalina
raionului	rayon
originea	origin
muntele	mountain
muntele	mount
inginer	engineer
gura	mouth
datele	dates
datele	data
problemă	problem
problemă	issue
finlanda	finland
natură	nature
sovietic	soviet
anual	yearly
anual	annual
marginea	edge
luxemburg	luxembourg
cercetări	research
părăsit	forsaken
teritoriile	territories
titluri	headlines
titluri	titles
galeria	gallery
dovedit	proved
dovedit	proven
existente	existing
piesă	piece
matei	matthew
matei	matei
căsătorie	marriage
linii	lines
filozofie	philosophy
east	east
cauză	cause
litere	letters
locală	local
lipsă	missing
practic	practical
practic	basically
practic	practically
cam	cam
protejată	protected
noaptea	night
arabă	arab
arabă	arabic
părinții	parents
arhitectură	architecture
regiunile	regions
egipt	egypt
scenă	scene
feminin	feminine
feminin	female
considerate	considered
scădere	decrease
forță	force
soție	wife
drepturi	rights
cimitirul	cemetery
cimitirul	graveyard
contribuit	contributed
spaniolă	spanish
practică	practical
practică	practice
discuţie	discussion
sute	hundreds
magazine	stores
magazine	shops
clădiri	buildings
cotă	quota
unitatea	unity
unitatea	unit
leon	leon
lumină	light
regală	royal
act	act
lake	lake
editor	publisher
editor	editor
exemple	examples
aurel	aurel
alegeri	elections
alegeri	election
serviciul	service
crăciun	christmas
personală	personal
larg	wide
poezii	poems
poezii	poetry
viitorul	future
necesar	required
necesar	necessary
stalin	stalin
ofițer	officer
ben	ben
iarnă	winter
link	link
ruși	russians
zaporijjea	zaporizhia
roger	roger
frecvent	frequently
administrator	admin
administrator	administrator
civile	civil
catolic	catholic
bizantin	byzantine
piață	market
problemele	problems
natura	nature
columbia	columbia
columbia	colombia
polonez	polish
episcopul	bishop
cucerit	conquered
ministerului	ministry
cartierul	neighborhood
presă	press
presă	media
petrecut	spent
imperiu	empire
secret	secret
fondată	founded
ruse	ruse
oficiale	official
constă	consists
eure	eure
adam	adam
curând	soon
stația	station
închis	closed
element	item
element	element
roșii	tomato
roșii	tomatoes
munca	work
funcționează	works
persoana	person
str	str
localizare	location
localizare	localization
contact	contact
ordin	order
renania	rhineland
capacitate	capacity
capacitate	ability
arme	weapons
arme	guns
stele	stars
napoleon	napoleon
poiana	poiana
aparținând	belonging
instituții	institutions
cântece	songs
adoptat	adopted
federația	federation
istat	istat
windows	windows
comercial	commercial
crește	increase
crește	grow
rss	rss
calitatea	quality
antonio	antonio
jucători	players
trecerea	passing
varianta	variant
nova	nova
statuia	statue
profesorul	professor
tipul	type
liberal	liberal
pădurea	forest
contract	contract
croația	croatia
compusă	composed
repede	quick
repede	fast
repede	quickly
mary	mary
condamnat	condemned
condamnat	convicted
condamnat	doomed
podul	bridge
rău	bad
são	são
artistică	artistic
culturală	cultural
limbile	languages
descris	described
lungimea	length
mediul	environment
mîkolaiiv	mykolaiv
lucian	lucian
tronul	throne
ansamblul	ensemble
electric	electrical
electric	electric
rezultatul	result
recent	recently
recent	recent
înapoi	back
societate	society
protecție	protection
scoția	scotland
concert	concert
carieră	career
carieră	quarry
arena	arena
motor	engine
motor	motor
grupa	group
redactor	editor
proiecte	projects
canalul	channel
pirinei	pyrenees
obiect	object
ovidiu	ovidiu
ioana	joan
ioana	ioana
royal	royal
constituit	constituted
tineri	young
nordică	nordic
harry	harry
companii	companies
cartier	neighborhood
cartier	cartier
cartier	neighbourhood
specialitate	speciality
specialitate	specialty
aspect	appearance
aspect	aspect
clădire	building
creată	created
dealul	hill
determinat	determined
guvernator	governor
episod	episode
centre	centres
centre	centers
alpes	alpes
henri	henri
acțiunile	actions
crede	believe
josé	josé
noastră	our
acceptat	accepted
debut	debut
episodul	episode
religioasă	religious
praga	prague
critică	criticism
critică	critical
ține	keep
necesară	required
necesară	necessary
baden	baden
cambridge	cambridge
artiști	artists
regional	regional
americani	americans
georg	georg
ceaușescu	ceaușescu
regimentul	regiment
paginile	pages
înscris	scored
înscris	enrolled
utc	utc
net	net
francisc	francis
câmp	field
sigur	sure
faza	phase
alfred	alfred
laureat	laureate
atacat	attacked
memoria	memory
mâna	hand
will	will
dea	dea
rezultatele	results
presupune	assumes
geografice	geographic
geografice	geographical
domenii	domains
domenii	fields
domenii	areas
fondator	founding
fondator	founder
pădure	woods
pădure	forest
apele	waters
fosta	former
eduard	edward
eduard	eduard
asemănătoare	similar
asemănătoare	lookalike
pur	pure
document	document
evreilor	jews
concurs	competition
concurs	contest
sol	soil
sol	sol
sol	ground
proprii	own
viteza	speed
statut	status
nave	ships
nave	vessels
cat	cat
legat	bound
legat	tied
durata	duration
conduce	drives
lucruri	things
lucruri	stuff
austriac	austrian
locuit	inhabited
japonez	japanese
înconjurătoare	surrounding
mașini	cars
mașini	machines
liste	lists
cuza	cuza
constantinopol	constantinople
campion	champion
puține	few
masa	table
masa	mass
masa	meal
vândut	sold
ducele	duke
youtube	youtube
campionilor	champions
altul	another
dumneavoastră	your
dedicat	dedicated
incluse	included
relația	relationship
varșovia	warsaw
minim	minimum
minim	minimal
frații	siblings
frații	brothers
intrare	entrance
intrare	input
intrare	entry
străine	foreign
frumos	beautiful
frumos	nice
întotdeauna	always
giovanni	giovanni
pământul	earth
episoade	episodes
stea	star
remarcat	noticed
remarcat	noted
mereu	always
limita	limit
implicat	implicated
implicat	involved
districte	districts
thailanda	thailand
françois	françois
lot	batch
lot	lot
papă	pope
ordinea	order
jet	jet
denumire	name
poloneză	polish
jackson	jackson
născută	born
williams	williams
cer	sky
utilizate	used
regal	regal
regal	royal
tradus	translated
străinătate	overseas
străinătate	abroad
străinătate	foreign
sicilia	sicily
algeria	algeria
românii	romanians
utc+	utc+
comisia	commission
adevăr	truth
jacques	jacques
capitală	capital
trupe	bands
trupe	troops
vietnam	vietnam
angeles	angeles
luca	luke
luca	luca
hotărât	decided
marian	marian
scena	scene
științific	scientific
banat	banat
capacitatea	capacity
capacitatea	ability
economie	economics
economie	economy
temperatura	temperature
modificări	modifications
modificări	amendments
modificări	changes
profil	profile
mexic	mexico
intitulat	titled
software	software
soțul	spouse
soțul	husband
corect	right
corect	correct
corect	fair
dincolo	beyond
dans	dance
dans	dancing
independența	independence
val	val
val	wave
côte	côte
evoluat	evolved
last	last
scott	scott
angajat	employee
angajat	employed
angajat	hired
poarta	gate
tour	tour
rolurile	roles
big	big
hill	hill
rhin	alsace
lemmon	lemmon
apărarea	defence
apărarea	defense
durată	duration
comandantul	commander
leopold	leopold
rețea	network
utilizatori	users
spring	spring
voturi	votes
documentar	documentary
teritoriale	territorial
silver	silver
toamna	autumn
toamna	fall
texas	texas
situație	situation
valori	values
liviu	liviu
vânătoare	slayer
vânătoare	hunt
vânătoare	hunting
alex	alex
iacob	jacob
iacob	james
evenimentele	events
sectorul	sector
francisco	francisco
distrus	destroyed
grande	grande
may	may
back	back
scăzut	low
line	line
independente	independent
normal	normal
termină	finish
create	created
tone	tonnes
tone	tons
tone	tone
tone	tonne
football	football
aria	aria
rece	cold
insulă	island
similar	similar
similar	similarly
angajați	employees
irlanda	ireland
green	green
can	can
michel	michel
tehnice	technical
nostru	our
serviciu	service
romani	romans
romani	romani
râu	river
căsătoria	marriage
jones	jones
gol	naked
gol	goal
gol	empty
rar	rarely
rar	rare
reprezentând	representing
teodor	theodore
teodor	teodor
young	young
moare	dies
întinde	stretch
argentina	argentina
argentina	argentine
decizia	decision
lansarea	launching
lansarea	launch
eroilor	heroes
#aaa	#aaa
călătorie	travel
călătorie	journey
călătorie	trip
johannes	johannes
sorin	sorin
ajutat	aided
ajutat	helped
management	management
superioare	superior
ivano	ivano
formație	band
formație	formation
comitetul	committee
ran	ran
cont	account
structură	structure
banca	bank
dragoste	love
politici	policies
charente	charente
out	out
transformat	transformed
specială	special
con	cone
con	con
întoarce	turn
întoarce	returns
par	hair
simbol	symbol
bruno	bruno
clasamentul	rankings
clasamentul	standings
finala	finals
finala	final
arestat	arrested
sportiv	athlete
vin	coming
vin	vin
vin	wine
evoluează	evolve
rezistență	resistance
comisiei	commission
oxford	oxford
sri	sri
albastru	blue
regulă	rule
contribuții	contributions
influență	influence
disney	disney
fata	girl
fata	face
protejate	protected
regimul	regime
editare	edit
editare	editing
zbor	fly
zbor	flying
zbor	flight
discută	discuss
avion	airplane
avion	plane
vas	vessel
nava	ship
întreg	whole
anti	anti
agricole	agricultural
evident	obvious
evident	obviously
căutare	search
revistă	magazine
autoritatea	authority
lider	leader
arătat	shown
cruce	cross
vot	vote
vocal	vocals
vocal	vocal
pilot	pilot
carlos	carlos
realitate	reality
atins	achieved
atins	touched
atins	reached
spaniol	spanish
similare	similar
decedat	deceased
bucuresti	bucharest
chris	chris
luptat	fought
includ	include
dorit	desired
dorit	wanted
dorit	wished
directorul	directory
ohio	ohio
metode	methods
crucea	cross
participarea	participation
ortodox	orthodox
dublu	double
magazin	shop
magazin	store
frankivsk	frankivsk
ștergere	deletion
ștergere	delete
căzut	fallen
iisus	jesus
germanii	germans
urbană	urban
promovarea	promotion
promovarea	promoting
lansată	launched
fundația	foundation
patrimoniului	heritage
bazin	basin
turneu	tour
turneu	tournament
sex	gender
sex	sex
exclusiv	exclusive
exclusiv	exclusively
hall	hall
statistică	statistics
statistică	statistical
statistică	statistic
texte	texts
teme	themes
teme	homework
japoneză	japanese
sânge	blood
giurgiu	giurgiu
fete	girls
separat	separately
separat	separated
separat	separate
artilerie	artillery
păsări	birds
prieten	friend
ierusalim	jerusalem
ludwig	ludwig
marina	navy
marina	marina
imperial	imperial
inclusă	included
php	php
pri	pri
paralel	parallel
organizații	organizations
organizații	organisations
profile	profiles
înțeles	understood
spate	back
spate	rear
schimbarea	changing
schimbarea	change
universal	universal
high	high
indiferent	indifferent
indiferent	regardless
financiare	financial
villa	villa
song	song
următorul	next
torino	torino
torino	turin
bazele	bases
cursuri	courses
cursuri	classes
teritorii	territories
păduri	woods
păduri	forests
turn	tower
proprie	own
cucerirea	conquest
conținut	content
prefectura	prefecture
pod	attic
pod	bridge
deseori	often
bătrân	old
dinastie	dynasty
harghita	harghita
fiică	daughter
presa	media
museum	museum
cântăreață	singer
saxon	saxon
preotul	priest
usa	door
usa	usa
conformitate	compliance
conformitate	conformity
scurte	short
perioade	periods
creștin	christian
caracteristici	characteristics
caracteristici	features
ansamblu	ensemble
semn	sign
cerkasî	cherkasy
completă	complete
mulțumesc	thanks
mulțumesc	thank
kilometri	miles
kilometri	mileage
kilometri	kilometers
dvd	dvd
dunăre	danube
indică	indicates
indică	indicate
brown	brown
iancu	iancu
vorbește	speaks
vorbește	speak
călărași	călărași
purtat	worn
idei	ideas
îndeplinit	fulfilled
tron	throne
tron	tron
palatinat	palatinate
anterioare	previously
anterioare	previous
complex	complex
dorința	desire
simple	simple
umană	human
tema	theme
conțin	contain
organizate	organized
organizate	organised
militari	military
transferat	transferred
greutate	weight
organizația	organization
organizația	organisation
electrice	electrical
electrice	electric
primăvara	spring
programe	programmes
programe	programs
turneul	tournament
puteri	powers
câmpia	plain
electrică	electrical
electrică	electric
iran	iran
proprietatea	property
proprietatea	ownership
scară	ladder
scară	scale
grele	heavy
permanent	permanent
permanent	permanently
permanent	perm
gara	station
kim	kim
latin	latin
rudolf	rudolph
rudolf	rudolf
ligii	league
georgia	georgia
mănăstire	monastery
mănăstire	convent
economia	economy
aspecte	aspects
aspecte	issues
observat	noticed
observat	observed
principala	main
introducerea	introduction
introducerea	introducing
efect	effect
mărime	size
melodia	melody
rapidă	rapid
rapidă	fast
relație	relationship
della	della
nepal	nepal
interpretare	interpretation
ducesă	duchess
anne	anne
boli	diseases
boli	disease
simplă	simple
opus	opus
opus	opposite
matematician	mathematician
independență	independence
flandra	flanders
font	font
tradiția	tradition
atena	athens
biografie	bio
biografie	biography
adolf	adolf
împărțit	divided
împărțit	split
artistic	artistic
forțe	forces
adunarea	assembly
reprezentată	represented
pardosa	pardosa
căsătorită	married
organizată	organised
organizată	organized
adâncime	depth
mână	hand
săptămână	week
turda	turda
conducere	driving
conducere	leadership
culoarea	color
culoarea	colour
filosofie	philosophy
handbal	handball
traducerea	translation
times	times
contele	count
alegerea	choosing
alegerea	choice
libertatea	freedom
aisne	aisne
energia	energy
capitolul	chapter
inferior	inferior
reviste	magazines
solo	solo
specific	specific
comunitate	community
majoritate	majority
nominalizat	nominated
industriale	industrial
soare	sun
soare	sunshine
soare	sunny
bătălie	battle
poveste	story
cristina	cristina
fotografii	photos
bbc	bbc
fabrica	factory
măsuri	measures
holstein	holstein
premiile	awards
premiile	prizes
financiar	financially
financiar	financial
somme	somme
heinrich	heinrich
brandenburg	brandenburg
vie	alive
vie	vie
cântăreț	singer
romanian	english
paulo	paulo
metoda	method
araneus	araneus
comuniste	communist
chile	chile
audio	audio
digital	digital
marcel	marcel
conținutul	content
württemberg	württemberg
virginia	virginia
pierde	loses
pierde	lose
fizician	physicist
eliberat	liberated
eliberat	issued
eliberat	released
eliberat	freed
listele	lists
treptat	gradual
treptat	gradually
comercială	commercial
originale	original
originale	originals
record	record
promovat	promoted
medalii	medals
organizație	organization
organizație	organisation
masculin	male
masculin	masculine
hristos	christ
redus	reduced
octavian	octavian
sursele	sources
chicago	chicago
sfânt	saint
sfânt	holy
artistice	artistic
galben	yellow
activat	enabled
activat	activated
indian	indian
referință	reference
lac	lake
lac	lac
instrument	instrument
instrument	tool
valentin	valentin
valentin	valentine
corespunde	corresponds
uscat	dry
uscat	dried
posibilă	possible
francezi	french
realizări	achievements
realizări	accomplishments
scos	removed
prezentate	presented
jazz	jazz
journal	journal
cameră	room
uman	human
sun	sun
ernst	ernst
siguranță	safety
iucn	iucn
super	awesome
super	super
accesat	accessed
debutul	debut
liderul	leader
bad	bad
ușoară	mild
ușoară	slight
legi	laws
unesco	unesco
internă	internal
lotul	batch
declarată	declared
grade	degrees
tehnic	technical
tehnic	technically
theodor	theodor
theodor	theodore
colecție	collection
câmpul	field
barbu	barbu
prezentare	presentation
inspirat	inspired
sul	sul
tur	tour
joe	joe
dinastiei	dynasty
portul	port
vocea	voice
deal	hill
set	set
accesul	access
ochii	eyes
poezia	poetry
manchester	manchester
chimice	chemical
muzeu	museum
cererea	request
cererea	demand
bob	bob
instituție	institution
spitalul	hospital
extins	extended
extins	expanded
utilizare	usage
utilizare	use
atinge	touch
atinge	tap
cifra	digit
sănătate	health
francis	francis
leftarm	leftarm
alfonso	alfonso
orchestra	orchestra
locotenent	lieutenant
iso	iso
străini	strangers
străini	foreigners
flori	flowers
experiență	experience
dispărut	disappeared
legată	bound
legată	tied
legată	linked
picioare	feet
picioare	legs
femeilor	women
toma	toma
toma	thomas
anjou	anjou
das	das
chimie	chemistry
manuel	manuel
brian	brian
propunerea	proposal
scrisoare	letter
clasică	classical
clasică	classic
incluzând	including
cand	when
oise	oise
concerte	concerts
zid	wall
critice	critical
executat	executed
suprem	supreme
festival	festival
filmele	movies
birmania	burma
birmania	myanmar
metodă	method
impact	impact
impact	reach
buna	good
religia	religion
jurnalist	journalist
perfect	perfect
hun	hun
adaugă	add
jules	jules
majore	major
femeile	women
descoperirea	discovery
roluri	roles
obiectiv	objective
obiectiv	goal
hotel	hotel
izvor	spring
bourbon	bourbon
polonezi	poles
cehia	czech
trimite	send
scriitorul	writer
bruxelles	brussels
caragiale	caragiale
univers	universe
cântat	sang
cântat	sung
europeni	european
europeni	europeans
critici	criticism
critici	critics
religios	religious
misiunea	mission
antonescu	antonescu
motivul	motive
motivul	reason
ucraineni	ukrainians
credință	faith
creek	creek
parc	parc
parc	park
context	context
resurse	resource
resurse	resources
gaz	gas
gaz	gaz
părinți	parents
ebraică	hebrew
arhitectura	architecture
analiza	analysis
planurile	plans
regionale	regional
succesul	success
vorbe	words
zero	zero
canal	canal
canal	channel
specifică	specific
specifică	specifies
specifică	specify
înregistrare	recording
înregistrare	record
înregistrare	registration
influențat	influenced
convins	persuaded
convins	convinced
greci	greeks
greci	greek
sergiu	sergiu
acuzat	accused
acuzat	defendant
isus	jesus
calif	caliph
dance	dance
petersburg	petersburg
variantă	variant
instrumente	instruments
instrumente	tools
cronică	chronic
clasă	class
drumuri	roads
variante	variant
variante	variants
stephen	stephen
medicală	medical
creștină	christian
medicale	medical
conducători	rulers
conducători	leaders
inițială	initial
principiul	principle
mormântul	tomb
cantacuzino	cantacuzino
turism	tourism
bisericile	churches
alexandra	alexandra
traduceri	translations
petrescu	petrescu
frumoase	beautiful
bernard	bernard
loir	loir
modele	models
modele	templates
tulcea	tulcea
andré	andre
andré	andré
ardenne	ardenne
efectul	effect
decide	decides
decide	decide
ofițeri	officers
solar	solar
candidat	candidate
insecte	insects
insecte	bugs
corespondent	correspondent
federal	federal
constantinescu	constantinescu
curte	courtyard
curte	court
curte	yard
remix	remix
elevi	students
elevi	pupils
potențial	potential
potențial	potentially
mamă	mom
mamă	mother
lucrurile	things
coloana	column
ștergerea	erasing
ștergerea	deleting
poziții	positions
trasee	routes
trasee	trails
muzician	musician
comedie	comedy
tradițional	traditional
like	like
mijlocaș	midfielder
situații	situations
tancuri	tanks
steve	steve
acte	acts
acte	papers
acid	acid
colonel	colonel
automat	automatic
automat	automatically
bogat	rich
oceanul	ocean
repertoriul	repertoire
atras	drawn
atras	attracted
luate	taken
suma	sum
suma	amount
dorește	wishes
protecția	protection
cetate	fortress
cetate	citadel
bill	bill
căpitan	captain
scene	scenes
procesului	process
înțelege	understand
asociat	associated
asociat	associate
lanka	lanka
obținute	obtained
obținerea	getting
obținerea	obtaining
descoperite	discovered
hugo	hugo
ajută	help
samuel	samuel
margareta	margaret
margareta	daisy
firma	firm
denis	denis
domnia	reign
home	home
claude	claude
psd	psd
campanie	campaign
parlament	parliament
vârf	peak
mitologia	mythology
pacific	pacific
doamna	madam
doamna	lady
greșit	wrong
retragerea	retreat
retragerea	withdrawal
ferate	railways
street	street
hautes	hautes
armenia	armenia
definitiv	definitive
design	design
taylor	taylor
fire	yarn
fire	wires
fire	threads
situate	situated
virgil	virgil
jud	jud
mers	gait
frați	siblings
frați	brothers
așezat	seated
plin	full
raportul	report
land	land
directă	direct
cornel	cornel
planuri	blueprints
planuri	plans
den	den
servit	served
front	front
ochi	eyes
ochi	eye
senator	senator
cher	cher
aeroportul	airport
menționează	mentions
sebastian	sebastian
contextul	context
costa	costa
louise	louise
spencer	spencer
franco	franco
europe	europe
localizarea	locating
gospodării	households
mitologie	mythology
irina	irina
slovacia	slovak
slovacia	slovakia
continua	continue
profilul	profile
sankt	sankt
determină	determines
determină	determine
enciclopedia	encyclopedia
înmormântat	buried
medievală	medieval
implică	involve
implică	implies
implică	involves
open	open
iarna	winter
rhône	rhône
poetul	poet
fond	fund
absolut	absolutely
animalelor	animals
efecte	effects
calvados	calvados
deschide	open
culori	colours
culori	colors
savoia	savoy
evreii	jews
clasat	ranked
scara	ladder
enciclopedie	encyclopedia
old	old
slab	skinny
slab	weak
antice	ancient
mașină	machine
mașină	car
originar	originating
primă	premium
echipele	teams
diferit	different
teorie	theory
rezervă	spare
rezervă	backup
rezervă	reserve
navă	vessel
navă	ship
las	las
interesul	interest
utilizată	used
turul	tour
avocat	attorney
avocat	lawyer
inițiativa	initiative
utilizează	use
carolina	carolina
story	story
medici	physicians
medici	medici
medici	doctors
peninsula	peninsula
ahmad	ahmad
doctorat	doctorate
doctorat	phd
calcul	calculation
acoperit	covered
billboard	billboard
macedonia	macedonia
publicații	publications
vrut	wanted
reală	real
albe	white
kobayashi	kobayashi
japoneze	japanese
predat	taught
predat	surrendered
secol	century
arhangheli	archangels
vale	valley
vale	vale
presiunea	pressure
accident	accident
accident	crash
cuvintele	words
învățat	learnt
învățat	taught
învățat	learned
invitat	invited
invitat	guest
caracterul	character
poliție	police
colaborat	collaborated
datând	dating
iorga	iorga
eurovision	eurovision
private	private
atenție	attention
răsărit	sunrise
exil	exile
profesională	professional
fips	fips
melodii	melodies
melodii	tunes
melodii	songs
creează	create
lasă	let
agent	agent
încheie	conclude
contemporană	contemporary
scrierea	writing
conceptul	concept
corneliu	corneliu
vizitat	visited
linecolor	linecolor
network	network
etnie	ethnicity
emis	issued
emis	emitted
andrew	andrew
simbolul	symbol
căi	paths
cfr	cfr
voievod	voivode
eliberarea	release
eliberarea	liberation
soluție	solution
personajele	characters
patrimoniul	heritage
brătianu	brătianu
medii	average
medii	medium
poloneze	polish
grec	greek
congresul	congress
actul	act
câștigă	earn
sonoră	audible
vreau	want
aliate	allied
gaze	gas
gaze	gases
dinu	dinu
institute	institutes
sherlock	sherlock
var	var
var	lime
arabe	arab
iugoslavia	yugoslavia
spirit	spirit
min	min
comandă	command
comandă	order
golful	golf
golful	gulf
golful	bay
johnson	johnson
creștini	christians
zeci	tens
zeci	dozens
toscana	tuscany
mâinile	hands
duminică	sunday
project	project
unic	unique
british	british
lectură	reading
maior	major
siding	siding
decorat	decorated
separate	separated
separate	separate
felix	felix
carmen	carmen
bazinul	basin
distanța	distance
alan	alan
manual	manual
semnificativ	meaningful
semnificativ	significantly
semnificativ	significant
clasice	classics
maestru	master
mac	mac
hectare	hectares
hectare	acres
acordul	agreement
sprijin	support
rânduri	rows
microsoft	microsoft
membre	limbs
conrad	conrad
proprietate	property
proprietate	ownership
mecklenburg	mecklenburg
hot	thief
cercul	circle
sam	sam
free	free
sant	sant
devin	devin
devin	become
insule	islands
comparație	comparison
bosnia	bosnia
reale	real
wilson	wilson
mit	mit
mit	myth
mit	mlt
elector	elector
maine	tomorrow
maine	maine
ape	waters
ape	epa
cumpărat	purchased
cumpărat	bought
necesită	require
necesită	requires
arbore	shaft
arbore	tree
arbore	shafts
planeta	planet
idee	idea
chineză	chinese
pdf	pdf
sigismund	sigismund
marca	brand
marca	mark
actorii	actors
charlotte	charlotte
înregistrarea	recording
seara	evening
variază	vary
variază	varies
transportul	transportation
transportul	transport
termeni	terms
altar	altar
altar	shrine
individual	individually
individual	individual
dimineața	morning
serii	series
bogată	rich
plină	full
papal	papal
schimbări	changes
realitatea	reality
poeme	poems
stâng	left
încercare	test
schimbă	change
olimpic	olympic
versiuni	versions
arm	arm
bus	bus
constant	constantly
constant	constant
georges	georges
viorel	viorel
ray	ray
relief	relief
republică	republic
municipal	municipal
bulgară	bulgarian
natal	natal
desemnat	designated
desemnat	assigned
acoperă	cover
acoperă	covers
detaliu	detail
alice	alice
fondul	fund
înălțimea	height
lituania	lithuania
subiecte	topics
subiecte	subjects
sainte	sainte
regim	mode
regim	regime
inima	heart
francesco	francesco
sare	salt
guillaume	guillaume
redusă	reduced
congo	congo
languedoc	languedoc
sunet	sound
utilizatorii	users
florența	florence
tineret	youth
provence	provence
cursă	race
participanți	participants
participanți	attendees
verlag	verlag
congresului	congress
roussillon	roussillon
notabile	notable
lincoln	lincoln
christopher	christopher
anopheles	anopheles
boris	boris
ernest	ernest
comunistă	communist
urbane	urban
presiune	pressure
interviuri	interviews
hermann	hermann
păcate	sins
reprezentant	rep
reprezentant	representative
prezentă	present
substanțe	substances
secundare	secondary
manager	manager
alimentare	food
scenariu	screenplay
scenariu	scenario
scenariu	script
ducatul	duchy
numeroși	numerous
arhitect	architect
discul	disc
discul	disk
abd	abd
treime	trinity
flota	fleet
reguli	rules
testament	testament
carbon	carbon
dovezi	proof
dovezi	evidence
partide	parties
exprimat	expressed
ziare	newspaper
ziare	newspapers
ordonat	ordered
constituția	constitution
pierderi	loss
pierderi	losses
pierderi	casualties
global	global
fragmente	fragments
stradă	street
văzută	seen
sârbi	serbs
sârbi	serbian
fată	girl
activi	active
doresc	wish
funcțiile	functions
intra	enter
minas	minas
membră	member
secundar	secondary
frederick	frederick
aplicații	applications
aplicații	apps
dezvoltă	develops
dezvoltă	develop
licență	licence
licență	license
facebook	facebook
puterile	powers
comerț	commerce
comerț	trade
importanța	importance
componentă	component
inițiat	initiated
copilărie	childhood
long	long
spiritul	spirit
moștenitor	heir
prieteni	friends
secțiune	section
urgență	urgency
urgență	emergency
memorie	memory
studenți	students
lewis	lewis
josef	josef
difuzat	broadcast
parlamentare	parliamentary
earth	earth
clase	classes
schleswig	schleswig
ain	ain
amphoe	amphoe
siria	syria
prusiei	prussia
senior	senior
distribuție	distribution
rose	rose
schimbare	change
evreu	jewish
evreu	jew
entertainment	entertainment
câștigătoare	winning
stabilirea	establishment
imperiale	imperial
propune	propose
propune	proposes
proprietăți	properties
justiție	justice
orchestră	orchestra
mulțime	crowd
ocazie	occasion
ocazie	opportunity
albania	albania
calculator	calculator
calculator	computer
prefix	prefix
vertical	vertically
vertical	vertical
tehnica	technique
alege	choose
alege	pick
medical	medical
credința	faith
credința	belief
știri	news
brad	brad
operațiunea	operation
jucătorul	player
multiple	multiple
stefan	stefan
grea	heavy
ian	lan
ian	ian
aude	aude
libertate	freedom
libertate	liberty
pericol	hazard
pericol	danger
premier	premier
anca	anca
meuse	meuse
vienne	vienne
gustav	gustav
aspectul	appearance
belgrad	belgrade
bărbat	male
bărbat	man
sticlă	glass
sticlă	bottle
carlo	carlo
maximilian	maximilian
calabria	calabria
materialul	material
lățime	width
mobile	mobile
tvr	tvr
distrugerea	destroying
distrugerea	destruction
aleși	elected
schimbul	exchange
scenarist	screenwriter
grădina	garden
aparțin	belong
universul	universe
socialiste	socialist
festivalului	festival
temperatură	temperature
nato	nato
tradiție	tradition
interpretarea	interpretation
interpretarea	interpreting
industrial	industrial
suport	support
biroul	bureau
biroul	office
executiv	executive
soldat	soldier
antică	antique
antică	ancient
apel	appeal
apel	call
mesajul	message
exprimă	expresses
exprimă	express
șters	deleted
stan	stan
victime	casualties
victime	victims
pretutindeni	everywhere
scrierile	writings
way	way
mass	mass
mort	dead
manche	manche
dirijor	conductor
box	boxing
palestina	palestine
vreodată	ever
casele	houses
asemănător	similar
miniștri	ministers
actori	actors
capital	capital
fondatorul	founder
atlantic	atlantic
atacuri	attacks
atacuri	assaults
dovadă	evidence
dovadă	proof
gabriela	gabriela
sovietici	soviets
sovietici	soviet
ocupa	occupy
georgescu	georgescu
amsterdam	amsterdam
complexe	complexes
complexe	complex
respins	dismissed
respins	rejected
documentare	documentary
documentare	documentaries
canadian	canadian
explică	explain
explică	explains
poitou	poitou
humanitas	humanitas
suplimentare	additional
fenomen	phenomena
fenomen	phenomenon
coroana	crown
steagul	flag
campionat	championship
mike	mike
australian	australian
inc	inc
dumitrescu	dumitrescu
delta	delta
grave	serious
stone	stone
terestre	terrestrial
spital	hospital
găsite	found
florida	florida
break	break
arc	arc
arc	bow
comunicare	communication
frate	bro
frate	brother
semne	marks
semne	signs
caractere	characters
medalie	medal
scriere	writing
procese	trials
procese	processes
procese	lawsuits
dispărute	extinct
elizabeth	elizabeth
davis	davis
prizonieri	prisoners
power	power
frankfurt	frankfurt
ismail	ismail
arizona	arizona
tony	tony
consecință	consequence
schmidt	schmidt
aliații	allies
puy	puy
primară	primary
introducere	introduction
introducere	intro
dramaturg	playwright
propusă	proposed
confirmat	confirmed
cheile	keys
prințesă	princess
lacuri	varnishes
lacuri	lakes
dordogne	dordogne
administrație	administration
main	main
pedro	pedro
fox	fox
promovare	promotion
lansare	launching
lansare	launch
nepotul	nephew
nepotul	grandson
independentă	independent
secunde	seconds
încercarea	test
diploma	diploma
diploma	degree
ecaterina	catherine
teologie	theology
forțat	forced
organizează	organize
organizează	organise
kosovo	kosovo
traducător	translator
depinde	depends
temă	theme
evita	avoid
divizie	division
delia	delia
vase	vessels
vase	dishes
legile	laws
rurală	rural
frunte	forehead
cavalerie	cavalry
versurile	lyrics
valley	valley
risc	risk
auvergne	auvergne
editat	edited
numiți	appointed
nikolai	nikolai
nikolai	nikolay
solomon	solomon
intitulată	titled
ziar	newspaper
jiu	jiu
organizare	organisation
organizare	organization
complexul	complex
rang	rank
gheață	ice
acceptă	accepts
acceptă	accept
templul	temple
continuu	continuously
continuu	continuous
etapa	stage
turc	turk
turc	turkish
service	service
wang	wang
liniile	lines
semnificative	significant
sugerează	suggest
sugerează	suggests
alianța	alliance
lazăr	lazarus
lazăr	lazar
disponibile	available
monte	monte
anghel	anghel
recente	recent
cracovia	cracow
cracovia	krakow
cracovia	kraków
coordonate	coordinate
coordonate	coordinated
coordonate	coordinates
misiune	mission
mașina	car
dead	dead
creangă	branch
diferența	difference
coperta	cover
gold	gold
scriu	write
scriu	writing
caută	search
întâlnire	meeting
trăsături	traits
trăsături	features
philip	philip
dreptate	justice
cor	choir
cor	chorus
cor	cor
wolf	wolf
prezente	present
fruntea	forehead
douglas	douglas
modificat	altered
modificat	modified
modificat	amended
für	für
augustin	augustine
augustin	augustin
provocat	provoked
provocat	challenged
egal	equal
egal	equals
gironde	gironde
tarn	tarn
gerais	gerais
vioară	violin
stejar	oak
cavaler	knight
bucurat	enjoyed
operare	operating
istanbul	istanbul
patrick	patrick
banii	money
precedent	precedent
precedent	previous
biografice	biographical
studiază	study
sector	sector
isère	isère
conacul	mansion
structuri	structures
istorici	historians
deschiderea	opening
sală	gym
decizie	decision
amestec	mix
amestec	mixture
amestec	blend
geografică	geographic
geografică	geographical
corectă	correct
imperială	imperial
clasament	ranking
clasament	standings
clasament	rankings
jim	jim
castel	castle
castel	castel
câmpie	plain
socialist	socialist
înfrângerea	defeat
licența	licence
licența	license
milan	milan
scenariul	screenplay
scenariul	scenario
scenariul	script
pierderea	loss
teritorială	territorial
argento	argento
impus	imposed
stack	stack
fotografie	photo
fotografie	photography
principiu	principle
lombardia	lombardy
musulmani	muslims
musulmani	muslim
see	eea
medieval	medieval
răniți	injured
răniți	wounded
profesionist	professional
câștigător	winner
desen	drawing
interzis	forbidden
interzis	prohibited
interzis	banned
regulile	rules
irak	iraq
ideile	ideas
student	student
reacție	reaction
howard	howard
pre	pre
sprijinit	supported
topul	top
avansat	advanced
napoli	naples
napoli	napoli
activitățile	activities
contribuie	contribute
contribuie	contributes
cutremur	earthquake
castilia	castile
marte	mars
rare	rare
boală	illness
boală	disease
boală	sickness
indre	indre
blocat	stuck
blocat	locked
blocat	blocked
prusia	prussia
herbert	herbert
măsura	measure
rădulescu	rădulescu
sculptor	sculptor
avram	avram
avram	abram
întrebări	questions
intern	internally
intern	intern
intern	internal
intern	domestic
valorile	values
participa	participate
închisă	closed
completarea	completion
paginii	page
lupu	lupu
anuarul	yearbook
fabrică	factory
răspândit	spread
mica	mica
zeelandă	zealand
oră	hour
ionel	ionel
externă	external
naval	naval
stație	station
watson	watson
industrie	industry
cadru	frame
electronică	electronics
electronică	electronic
bay	bay
scria	wrote
generație	generation
ford	ford
conflictul	conflict
peretele	wall
doge	doge
ulei	oil
gordon	gordon
tehnici	techniques
acoperită	covered
acoperită	coated
maurice	maurice
illinois	illinois
apariție	occurrence
allen	allen
juridice	legal
electronic	electronic
electronic	electronically
prietenii	friends
channel	channel
observă	observe
asociate	associated
logo	logo
aprobarea	approval
genuri	genres
genuri	genera
curse	races
curse	racing
primi	receive
clasic	classical
clasic	classic
wittelsbach	wittelsbach
leipzig	leipzig
trupă	band
trupă	troop
trek	trek
personalitate	personality
basarab	basarab
ocupată	busy
ocupată	occupied
indiana	indiana
hollywood	hollywood
semnul	sign
corespunzătoare	appropriate
corespunzătoare	corresponding
dei	dei
anhalt	anhalt
spectacol	show
recunoaștere	recognition
wales	wales
animal	animal
clubiona	clubiona
douăzeci	twenty
mandat	warrant
mandat	mandate
efectele	effects
etapă	stage
estonia	estonia
supraviețuit	survived
modificarea	amendment
modificarea	modification
documentele	documents
mostră	sample
gheorghiu	gheorghiu
preda	teach
preda	teaches
enescu	enescu
desene	drawings
electronice	electronics
electronice	electronic
egală	equal
înregistrate	registered
înregistrate	recorded
responsabil	responsible
responsabil	maintainer
cai	horses
cai	cai
cetățeni	citizens
primind	receiving
vigoare	vigor
bustul	bust
tare	hard
tare	badass
tare	loud
aplică	apply
imaginile	images
dark	dark
distruse	destroyed
individuale	individual
condiția	condition
necunoscut	unknown
mala	mala
boala	illness
boala	disease
boala	sickness
secrete	secrets
secrete	secret
plastice	plastics
similară	similar
purta	wear
rezistența	resistance
tobe	drums
century	century
analiză	analysis
fază	phase
munteanu	munteanu
înregistrări	records
înregistrări	registrations
înregistrări	recordings
pomerania	pomerania
cântă	sing
cântă	sings
parma	parma
etape	stages
mută	move
invazia	invasion
guy	guy
milenii	millennia
dai	dai
sava	sava
interioară	inner
prezentată	presented
terenuri	lands
terenuri	land
profesori	professors
profesori	teachers
primare	primaries
primare	primary
primare	mayor
provincii	provinces
rurale	rural
publicist	publicist
cehoslovacia	czechoslovakia
drapelul	flag
societăți	corporations
societăți	companies
societăți	societies
satelit	satellite
diferită	different
regat	kingdom
atacant	striker
ponte	ponte
mario	mario
spectacole	performances
spectacole	shows
hamburg	hamburg
orléans	orléans
milion	million
massimo	massimo
transformă	transform
fundamentale	fundamentals
fundamentale	fundamental
pregătire	preparation
pregătire	training
spațială	spatial
ligă	league
obișnuit	regular
obișnuit	ordinary
argumente	arguments
wikimedia	wikimedia
nominalizări	nominations
orne	orne
aplicarea	application
tibet	tibetan
tibet	tibet
shakespeare	shakespeare
scrieri	writings
arab	arab
stabilește	set
laura	laura
medievale	medieval
mișcări	moves
mișcări	movements
tratament	treatment
franklin	franklin
capabil	able
capabil	capable
compoziție	composition
lansate	launched
regie	directing
queen	queen
via	via
jane	jane
monaco	monaco
ruinele	ruins
augustus	augustus
gray	gray
părea	seemed
hohenzollern	hohenzollern
informație	information
cantemir	cantemir
publicarea	publication
publicarea	publishing
compuse	composed
agricultură	farming
agricultură	agriculture
tehnologie	technology
computer	computer
strict	strict
strict	strictly
celule	cells
mecanică	mechanics
mecanică	mechanical
distrusă	destroyed
legal	legally
legal	legal
active	active
active	assets
primarul	mayor
depus	deposited
britanici	british
britanici	brits
minerale	minerals
minerale	mineral
business	business
boston	boston
toulouse	toulouse
mijloace	means
marco	marco
eroare	error
ghica	ghica
arhiva	archive
arhiva	archives
capturat	captured
marc	marc
anuală	yearly
anuală	annual
rosso	rosso
urme	tracks
urme	traces
expresia	expression
observator	observatory
observator	observer
gard	gard
gard	fence
administrarea	administration
băieți	boys
băieți	guys
antic	antique
antic	ancient
montana	montana
beijing	beijing
geografie	geography
războaie	wars
proiectat	designed
proiectat	projected
devreme	early
trecând	passing
cheie	key
concluzia	conclusion
conferința	conference
datorează	owes
varietate	variety
ramuri	branches
eseuri	essays
eseuri	touchdowns
calendarul	calendar
universală	universal
demonstrat	proven
demonstrat	demonstrated
transmite	transmit
aleasă	chosen
cercetarea	research
bot	snout
bot	bot
tânără	young
veneto	veneto
andrea	andrea
lost	lost
dezvoltate	developed
turcă	turkish
cluburi	clubs
table	backgammon
pești	fish
cerere	application
cerere	request
cerere	demand
cetățean	citizen
obiectul	object
animație	animation
domn	gentleman
practica	practice
cantități	quantities
aube	aube
fort	fort
anthony	anthony
army	army
intenția	intention
intenția	intent
civilă	civil
civilă	civilian
siret	siret
dialog	dialogue
dialog	dialog
navale	naval
limbaj	language
bank	bank
grafică	graphic
grafică	graphics
asistent	assistant
pacea	peace
bass	bass
vladislav	władysław
liverpool	liverpool
picturi	paintings
start	start
tel	tel
focul	fire
activează	enable
activează	activate
frunze	leaves
recenzii	reviews
turnu	turnu
giuseppe	giuseppe
proclamat	proclaimed
cătălin	cătălin
armatele	armies
nistru	dniester
asasinat	assassinated
asasinat	assassination
spoleto	spoleto
votat	voted
luis	luis
carne	meat
unchiul	uncle
tehnologia	technology
impune	impose
pasul	step
complete	complete
nisip	sand
specialist	specialist
motoare	motors
motoare	engines
stabilită	established
proba	sample
pietro	pietro
însoțit	accompanied
cipru	cyprus
soluții	solutions
bruce	bruce
excepție	exception
haut	haut
ardennes	ardennes
sculptură	sculpture
sculptură	sculpting
sculptură	carving
artistul	artist
azur	azure
azur	azur
parohia	parish
crezut	thought
crezut	believed
factor	factor
caracteristică	characteristic
caracteristică	feature
fantastic	fantastic
petrol	petrol
petrol	oil
petrol	petroleum
gata	ready
permit	allow
teoretic	theoretical
teoretic	theoretically
heidelberg	heidelberg
campioană	champion
tunuri	cannons
jurnal	journal
jurnal	diary
jurnal	log
party	party
rangul	rank
privat	privately
privat	private
monede	coins
monede	coin
andreea	andrea
andreea	andreea
cercetător	researcher
cercetător	scientist
asigurat	insured
asigurat	secured
portretul	portrait
judecată	judgement
judecată	judgment
fantasy	fantasy
concept	concept
golden	golden
dunărea	danube
zidul	wall
liderii	leaders
monedă	currency
monedă	coin
road	road
stara	stara
madonna	madonna
soarele	sun
lyon	lyon
lyon	lyons
experiența	experience
vincent	vincent
factori	factors
apollo	apollo
teorii	theories
gospodărie	household
off	off
monitorul	monitor
mesaje	messages
fara	without
marine	marine
normală	normal
strâns	tight
considerare	consideration
suveran	sovereign
miller	miller
limbajul	language
benzi	lanes
benzi	tapes
benzi	strip
stănescu	stănescu
rural	countryside
rural	rural
urmărit	watched
urmărit	followed
sufletul	soul
adams	adams
educația	education
oprit	stopped
ciclul	cycle
vorbită	spoken
decretul	decree
posibile	possible
isaac	isaac
memorial	memorialized
memorial	memorial
fapte	facts
preferat	favourite
preferat	favorite
preferat	preferred
alternative	alternative
alternative	alternatives
said	said
col	col
lateral	lateral
lateral	side
hârtie	paper
unică	unique
marmură	marble
cover	cover
phoenix	phoenix
emisiuni	shows
asistență	assistance
fizic	physically
fizic	physical
prins	caught
victoriei	victoria
camere	rooms
reduce	reduces
reduce	reduce
jersey	jersey
false	false
apreciat	appreciated
cehă	czech
peru	peru
alianță	alliance
refuză	decline
refuză	refuse
îndepărtat	removed
yonne	yonne
frumoasă	beautiful
vis	vis
vis	dream
florian	florian
alexandria	alexandria
commons	commons
fonduri	funds
fonduri	funding
limitată	limited
legenda	legend
lansează	launch
declară	declares
declară	declare
ghid	guide
verne	verne
altitudinea	altitude
heart	heart
michigan	michigan
coordonator	coordinator
dragostea	love
universitate	university
lama	blade
lama	lama
circulație	circulation
recunoscută	recognized
recunoscută	recognised
activă	active
dedicată	dedicated
agricultura	farming
agricultura	agriculture
dôme	dôme
descoperită	discovered
destinate	intended
alfabetul	alphabet
pronaos	narthex
speranța	hope
comentarii	comment
comentarii	comments
părere	opinion
scopuri	purposes
albastră	blue
periodic	periodical
periodic	periodic
periodic	periodically
monica	monica
pregătirea	preparation
pregătirea	preparing
căutat	searched
căutat	sought
pasageri	passengers
pasageri	passenger
hamilton	hamilton
edgar	edgar
watanabe	watanabe
diana	diana
gloria	gloria
cantitate	amount
cantitate	quantity
teza	thesis
planetă	planet
oct	oct
hotărârea	judgment
masiv	massive
masiv	massively
lingvistică	linguistics
lingvistică	linguistic
scrisori	letters
tratate	treaties
tratate	treated
diametru	diameter
geneva	geneva
reprezentanți	representatives
light	light
stuttgart	stuttgart
porto	porto
nucleare	nuclear
otomană	ottoman
rănit	injured
rănit	wounded
rănit	hurt
proprietar	owner
proprietar	landlord
wolfgang	wolfgang
cantitatea	quantity
misiuni	assignments
misiuni	missions
rândurile	ranks
reprezentate	represented
fauna	fauna
acoperite	covered
acoperite	coated
mix	mix
suferă	suffer
bis	bis
bis	encore
player	player
multi	many
multi	multi
practice	practical
târguri	fairs
privată	private
actorul	actor
deva	deva
poliția	police
conflicte	conflicts
conflicte	conflict
contribuția	contribution
compoziția	composition
oricare	any
lovit	hit
trecere	crossing
trecere	passing
atacurile	attacks
rev	rev
gers	gers
susținută	sustained
olandez	dutch
alternativ	alternatively
alternativ	alternative
alternativ	alternate
alternativ	alternately
warner	warner
industrială	industrial
lawrence	lawrence
arhiepiscop	archbishop
eva	eva
eva	eve
scriitoare	writer
disponibil	available
timpuri	times
străin	alien
străin	foreigner
străin	stranger
străin	foreign
kevin	kevin
moon	moon
stăpânirea	mastering
aeriană	aerial
prezentarea	presentation
suedez	swedish
suedez	swede
reforma	reformation
reforma	reform
victorii	wins
victorii	victories
sarcina	pregnancy
three	three
iliescu	iliescu
inventat	invented
răspunsul	response
venus	venus
avionul	plane
tokyo	tokyo
contemporane	contemporary
mărimea	size
agenția	agency
stuart	stuart
lès	lès
interioare	interior
onoarea	honour
onoarea	honor
supercupa	supercup
putin	putin
aparat	apparatus
aparținut	belonged
tiraspol	tiraspol
filosof	philosopher
prut	prut
ars	burned
ars	burnt
daula	daula
nasa	nasa
absolvirea	graduation
adormirea	dormition
ascuns	hidden
baterie	battery
provinciile	provinces
dave	dave
crime	crimes
crime	murders
tănase	tănase
capela	chapel
test	test
socialistă	socialist
simultan	simultaneous
simultan	simultaneously
menține	maintain
hong	hong
brigada	brigade
profund	deeply
profund	deep
profund	profound
spațiale	spatial
raymond	raymond
cuprinzând	encompassing
administrat	administered
richter	richter
grant	grant
portret	portrait
antologie	anthology
england	england
instalat	installed
reprezentanții	representatives
călătorii	travel
călătorii	travellers
negative	negative
negative	negatives
miron	miron
etnice	ethnic
coloane	columns
hills	hills
billy	billy
opoziție	opposition
nordic	nordic
caracterizează	characterise
url	url
empire	empire
frontiera	border
frontiera	frontier
interpretate	interpreted
mecanic	mechanically
mecanic	mechanic
mecanic	mechanical
erou	hero
argument	argument
cercetători	researchers
cercetători	scientists
conceput	conceived
conceput	designed
împrumut	loan
împrumut	borrowing
israelului	israel
electorale	electoral
viitoare	future
viitoare	upcoming
identificat	identified
dublă	double
flora	flora
utilizatorul	user
reducerea	reduction
reducerea	reducing
june	june
atrage	draws
atrage	attracts
atrage	attract
buget	budget
recunoaște	recognize
recunoaște	recognise
recunoaște	acknowledges
comerțul	trade
miguel	miguel
armă	weapon
armă	gun
tată	dad
tată	father
rom	rom
rom	rum
echivalent	equivalent
temporar	temporarily
temporar	temporary
tabăra	camp
lichid	fluid
lichid	liquid
inaugurat	inaugurated
schimba	change
oricine	anyone
oricine	anybody
sezoane	seasons
culturi	crops
culturi	cultures
fan	fan
criterii	criteria
pennsylvania	pennsylvania
marcate	marked
dispoziție	provision
dispoziție	disposition
încasări	proceeds
încasări	receipts
destinat	intended
destinat	destined
povești	tales
povești	stories
plecarea	departure
plecarea	leaving
secțiuni	sections
manifestă	manifests
principii	principles
națiuni	nations
înțelegere	understanding
opinii	opinions
jerry	jerry
performanță	performance
neapole	naples
neapole	napoli
tratamentul	treatment
cerc	circle
eseu	essay
eseu	touchdown
desemnate	designated
comportamentul	behaviour
comportamentul	behavior
momente	moments
sosirea	arrival
pozitiv	positive
asigurarea	insurance
eforturile	efforts
hainaut	hainaut
piemont	piedmont
transmis	transmitted
lenin	lenin
massachusetts	massachusetts
retrage	retract
retrage	withdraw
reduse	reduced
vândute	sold
dec	dec
ingrid	ingrid
novi	novi
serghei	sergei
serghei	sergey
sexuale	sexual
alto	alto
mail	mail
melodie	melody
melodie	tune
melodie	song
mormânt	tomb
mormânt	grave
investiții	investments
investiții	investment
nicolas	nicolas
vânători	hunters
punk	punk
vizita	visit
dezvoltată	developed
steven	steven
utilizatorilor	users
emisar	emissary
dragon	dragon
produc	produce
aplicat	applied
abandonat	abandoned
permanentă	permanent
jimmy	jimmy
austriacă	austrian
western	western
principiile	principles
fenomenul	phenomenon
bunicul	grandpa
bunicul	grandfather
înlocuibil	replaceable
adusă	brought
guvernare	governance
guvernare	government
rata	rate
jupiter	jupiter
kleť	kleť
raza	raza
scaun	chair
scaun	stool
scaun	seat
regent	regent
poe	poe
filologie	philology
varsă	spill
luând	taking
jacob	jacob
asediul	siege
hop	hop
portal	portal
pietre	stones
pietre	rocks
leonard	leonard
definit	defined
suedeză	swedish
ramură	branch
aliați	allies
azzurro	azzurro
trage	shoot
trage	pull
beach	beach
venezuela	venezuelan
venezuela	venezuela
soț	spouse
soț	husband
orient	orient
divizii	divisions
consiliu	council
alaska	alaska
ridicarea	lifting
magic	magic
magic	magical
revolta	uprising
revolta	revolt
revolta	mutiny
revolta	riot
ciprian	ciprian
celebru	famous
pozitive	positive
cetățenii	citizens
recunoașterea	recognition
păstrarea	keeping
păstrarea	retention
reacția	reaction
barbara	barbara
olga	olga
sardinia	sardinia
cristea	cristea
modificare	modification
modificare	amendment
turnee	tournaments
rasă	breed
rasă	race
demisia	resignation
pictat	painted
negativ	negative
frontieră	border
frontieră	frontier
row	row
extinderea	expansion
extinderea	enlargement
greutatea	weight
temple	temple
inspirație	inspiration
atlas	atlas
cal	horse
cal	cal
albatros	albatross
pregătit	ready
pregătit	prepared
magyar	magyar
succesiune	succession
icoane	icons
norman	norman
rețele	networks
extras	extracted
extras	excerpt
extras	extract
televiziunea	television
lucia	lucia
navele	ships
wild	wild
existență	existence
zice	says
aliat	allied
aliat	ally
colectiv	collectively
colectiv	collective
vehicule	vehicles
totalul	total
concertul	concert
clark	clark
fritz	fritz
erich	erich
deux	deux
moară	mill
războaiele	wars
geografic	geographically
geografic	geographic
geografic	geographical
philippe	philippe
timpuriu	early
coastă	rib
coastă	coastal
coastă	coast
formare	training
democrată	democratic
democrată	democrat
slatina	slatina
benevento	benevento
produsele	products
sfera	sphere
cancer	cancer
pește	fish
info	info
clasificare	categorisation
clasificare	classification
benjamin	benjamin
scrimă	fencing
palat	palace
law	law
tambon	tambon
premieră	premiere
placă	plate
placă	plaque
oxigen	oxygen
vice	vice
intervenția	intervention
izvoare	springs
logică	logical
logică	logic
stockholm	stockholm
inimă	heart
medicina	medicine
tenis	tennis
criza	crisis
direcție	direction
regi	kings
spații	spaces
specializat	specialised
specializat	specialized
antichitate	antique
antichitate	antiquity
răspunde	answer
răspunde	reply
răspunde	respond
nero	nero
posesia	possession
faptele	facts
deplasare	displacement
aprobat	approved
stoica	stoica
împrumutat	borrowed
materie	matter
evreiesc	jewish
transformarea	transformation
cinema	cinema
nazistă	nazi
atitudine	attitude
linux	linux
autoritate	authority
congres	congress
citat	quote
oțel	steel
baze	bases
căldură	heat
căldură	warmth
apus	sunset
diplomat	diplomat
coloană	column
decret	decree
campo	campo
eliminarea	disposal
eliminarea	elimination
băiat	boy
selecție	selection
romana	romana
studioul	studio
criticii	critics
folclor	folklore
verona	verona
întrebarea	question
operații	operations
sarah	sarah
baroc	baroque
xxi	xxi
newton	newton
locuințe	housing
criză	crisis
criză	seizure
observații	comments
observații	observations
observații	remarks
köln	cologne
fair	fair
adaptare	adaptation
turcii	turks
incendiu	fire
filosofia	philosophy
inter	inter
sultanul	sultan
canale	channels
occident	west
ecran	screen
astronom	astronomer
filmat	filmed
deschidere	openness
deschidere	opening
supus	submissive
clasificată	classified
voluntari	volunteers
evoluție	evolution
culorile	colors
beton	concrete
declarația	statement
declarația	declaration
friuli	friuli
expresie	expression
angela	angela
emilia	emilia
engleza	english
kitami	kitami
mănăstiri	monasteries
tetragnatha	tetragnatha
scoate	remove
pronunțat	pronounced
spirituală	spiritual
sudic	southern
caracteristicile	characteristics
walker	walker
salerno	salerno
auzit	heard
prince	prince
jeff	jeff
strat	layer
interesat	interested
semi	semi
interpretează	interpret
plastic	plastics
plastic	plastic
malik	malik
eseist	essayist
blaga	blaga
dispus	willing
arnold	arnold
procesele	processes
probe	samples
probe	evidence
vizită	visiting
vizită	visit
limitat	limited
expus	exposed
operațiuni	operations
operațiuni	transactions
johnny	johnny
traseul	route
mile	mile
mile	miles
soții	husbands
soții	spouses
kent	kent
continuarea	continuation
continuarea	sequel
israelian	israeli
ghirardi	ghirardi
introduse	introduced
santiago	santiago
kelly	kelly
bei	bei
bei	eib
voievodatul	voivodeship
critica	criticism
critica	critical
nelson	nelson
pozițiile	positions
aviv	aviv
gazdă	host
timpurile	times
declanșat	triggered
declanșat	tripped
pan	pan
grupe	groups
biologie	biology
sârbă	serbian
atmosfera	atmosphere
reflectă	reflect
reflectă	reflects
institut	institute
fructe	fruit
fructe	fruits
italieni	italians
rezolvat	resolved
rezolvat	solved
sarthe	sarthe
adunare	gathering
adunare	assembly
piele	leather
piele	skin
conferințe	conferences
temperaturi	temperatures
rachete	missiles
rachete	rockets
distruge	destroy
constantă	constant
transnistria	transnistria
definiție	definition
dos	dos
colegii	colleagues
lat	lat
chimic	chemical
chimic	chemically
înaintat	forwarded
particule	particles
particule	particulates
particule	particle
titlurile	titles
expuse	exposed
dif	diff
spunând	saying
criticat	criticized
criticat	criticised
igor	igor
prost	stupid
costin	costin
identitatea	identity
râuri	rivers
müller	müller
orhei	orhei
înconjurat	surrounded
kong	kong
sexuală	sexual
dificil	difficult
contesă	countess
revoluție	revolution
leo	leo
păstrate	kept
păstrate	preserved
marcus	marcus
durează	lasts
stylidium	stylidium
dimensiune	dimension
dimensiune	size
vânzări	sales
vânzări	sale
sfatul	advice
necesitatea	necessity
forum	forum
combustibil	fuel
sin	sin
copyright	copyright
arabia	arabia
rugby	rugby
pădurile	forests
firme	firms
jonathan	jonathan
distins	distinguished
patriarhul	patriarch
unelte	tools
ucide	kill
ucide	slay
distribuția	distribution
csm	csm
propunere	proposal
propunere	proposition
nucleară	nuclear
conservator	conservatory
conservator	conservative
numerele	numbers
dispozitiv	device
zei	gods
annonaceae	annonaceae
terra	terra
nota	note
adoptată	adopted
încercând	trying
începuturile	beginnings
atitudinea	attitude
semnarea	signing
monografia	monograph
portalul	portal
dimensiunile	dimensions
limitele	boundaries
limitele	limits
însemnat	meant
cade	cade
cade	falls
soarta	fate
moore	moore
cornelis	cornelis
dulce	sweet
istván	istván
luterani	lutherans
convenția	convention
chinez	chinese
domnie	reign
côtes	côtes
viziunea	vision
familiile	families
comunismului	communism
bayern	bayern
unu	one
trofeul	trophy
marshall	marshall
dimensiunea	dimension
dimensiunea	size
luată	taken
diferă	differs
diferă	differ
hassan	hassan
seară	evening
antiohia	antioch
mini	mini
menținerea	maintaining
combinație	combination
atestat	attested
irlandei	ireland
angel	angel
alternativă	alternative
coburg	coburg
mixt	mixed
harris	harris
marchează	mark
coada	queue
coada	tail
regională	regional
janeiro	janeiro
îndoială	doubt
ross	ross
înregistrată	registered
înregistrată	recorded
clasele	classes
corporation	corporation
punerea	putting
reprezentare	representation
serios	serious
serios	seriously
determina	determine
dramatic	dramatic
dramatic	dramatically
leonardo	leonardo
alla	alla
corespunzător	appropriate
corespunzător	corresponding
mali	mali
contribuție	contribution
contribuțiile	contributions
vină	guilt
girls	girls
hesse	hesse
veronica	veronica
fernando	fernando
amos	amos
bowell	bowell
jordan	jordan
african	african
cunoștințe	knowledge
cuba	cuba
hai	hai
lászló	lászló
plata	payment
masivul	massif
kennedy	kennedy
robin	robin
dorin	dorin
turnuri	towers
sabie	sword
bandă	tape
bandă	gang
nick	nick
desert	dessert
desert	desert
afectat	affected
prime	prime
prime	premiums
jucătorii	players
efectiv	effectively
acționează	act
harvard	harvard
mariana	mariana
dialectul	dialect
dick	dick
morgan	morgan
roci	rocks
viata	life
plasat	placed
ibrahim	ibrahim
albi	white
charlie	charlie
chemat	summoned
filozof	philosopher
sturdza	sturdza
eugenia	eugenia
eugenia	eugenics
definește	define
definește	defines
dublat	doubled
belarus	belarus
belarus	belarusian
politicile	policies
uniune	union
intens	intense
salonul	salon
încercări	trials
încercări	tests
aplicată	applied
cărămidă	brick
sexual	sexual
sexual	sexually
fred	fred
april	april
astra	astra
diplomatice	diplomatic
axa	axis
decizii	decisions
grupă	group
grupă	squad
zur	zur
definită	defined
chimist	chemist
diferență	difference
eliade	eliade
sky	sky
extremitatea	extremity
preț	price
lisabona	lisbon
islam	islam
hrană	food
redenumit	renamed
voci	voices
cauzat	caused
securitatea	security
shortsummary	shortsummary
solare	solar
produsul	product
börngen	börngen
aparate	devices
aparate	apparatus
eliminat	eliminated
eliminat	removed
inițiale	initial
herțegovina	herzegovina
oferite	offered
cuplul	couple
statistici	statistics
statistici	stats
statistici	insights
derivat	derivative
derivat	derived
traduse	translated
arabi	arabs
andy	andy
saturn	saturn
citate	quotes
bulgar	bulgarian
stanley	stanley
resursele	resources
elaborat	elaborate
île	île
britanicii	brits
sugerat	suggested
soluția	solution
atmosferă	atmosphere
andreas	andreas
nil	nil
nil	nile
extreme	extremes
extreme	extreme
bunuri	goods
comportament	behaviour
comportament	behavior
stade	stade
acumulare	accumulation
laborator	laboratory
laborator	lab
moldovan	moldovan
htm	htm
egale	equal
termenii	terms
precis	precise
russell	russell
plantă	plant
operator	operator
clară	clara
vremuri	times
magnitudinea	magnitude
motorul	engine
vorbit	spoken
vorbit	talked
consum	consumption
perspectiva	perspective
kurt	kurt
perechi	pairs
sumă	sum
sumă	amount
purtând	wearing
obligatoriu	required
obligatoriu	mandatory
obligatoriu	compulsory
înfrângere	defeat
endate	endate
amintiri	memories
hidrogen	hydrogen
bell	bell
depășit	exceeded
donald	donald
ferestre	windows
campaniei	campaign
masive	massive
interpretată	interpreted
tim	tim
made	made
uitat	forgot
uitat	forgotten
însemna	meant
motivele	reasons
nuclear	nuclear
magnus	magnus
clarke	clarke
iubire	baby
iubire	love
economist	economist
feat	feat
romanele	novels
aragon	aragon
diego	diego
oliver	oliver
klein	klein
separată	separate
înlocuită	replaced
mississippi	mississippi
financiară	financial
mtv	mtv
profesionale	professional
blues	blues
episcopiei	bishopric
ille	ille
prețul	price
ltd	ltd
colaborarea	collaboration
îndreptat	pointing
mamifere	mammals
mamifere	mammal
romancier	novelist
linnaeus	linnaeus
galbenă	yellow
identitate	identity
generații	generations
expediție	expedition
adn	dna
acordarea	granting
frecvente	common
senatului	senate
secretă	secret
ocupate	busy
ocupate	occupied
fizica	physics
comandat	commissioned
comandat	commanded
comandat	ordered
cooperare	cooperation
tunisia	tunisia
trimise	sent
mountain	mountain
zilnic	daily
altarul	altar
altarul	shrine
rezolvarea	solving
jurist	jurist
aux	aux
constituție	constitution
decat	than
gotha	gotha
efort	effort
criteriile	criteria
catherine	catherine
juniori	juniors
juniori	junior
turcilor	turks
churchill	churchill
dând	giving
uciderea	killing
acordată	granted
exploatarea	exploitation
exploatarea	exploiting
silviu	silviu
maternă	maternal
antoine	antoine
academy	academy
eroi	heroes
animalele	animals
match	match
olandeză	dutch
drôme	drôme
instituțiile	institutions
echipamente	equipment
succesorul	successor
identificarea	identification
scufundare	diving
scufundare	dive
vineri	friday
mixtă	mixed
inginerie	engineering
picioarele	feet
picioarele	legs
wayne	wayne
cross	cross
înregistrează	register
înregistrează	record
suficiente	sufficient
colonii	colonies
restaurare	restore
restaurare	restoration
reprezentarea	representation
tren	train
sous	sous
alimente	food
alimente	foods
acordate	granted
ceară	waxes
ceară	wax
clima	climate
dej	dej
ucrainean	ukrainian
diplomă	diploma
diplomă	degree
acidul	acid
străzi	streets
portar	doorman
portar	goalkeeper
portar	goalie
austriece	austrian
missouri	missouri
playstation	playstation
nominalizare	nomination
simboluri	symbols
antrenorul	coach
landes	landes
margaret	margaret
limită	limit
sărbătoare	holiday
sărbătoare	feast
sărbătoare	celebration
obiectele	objects
solist	soloist
origini	origins
erik	erik
exploatare	exploitation
observa	observe
rosetti	rosetti
hip	hip
ziduri	walls
matt	matt
suflet	soul
turingia	thuringia
retragere	retreat
retragere	withdrawal
eficient	efficient
eficient	effective
vilaine	vilaine
programare	programming
programare	appointment
călători	travellers
folk	folk
legale	legal
regula	rule
organism	body
organism	organism
deces	death
sarcină	pregnancy
sarcină	load
sarcină	task
emigrat	emigrated
emigrat	immigrated
hit	hit
pui	chicken
revoltă	uprising
revoltă	revolt
revoltă	mutiny
revoltă	riot
dedicate	dedicated
capete	heads
sărat	salty
sărat	salted
puțini	few
spiritual	witty
spiritual	spiritual
spiritual	spiritually
primite	received
neo	neo
imam	imam
automobile	automobiles
automobile	automobile
modă	fashion
utricularia	utricularia
viu	alive
rămase	remaining
orientare	guidance
orientare	orientation
cazurile	cases
arhiepiscopul	archbishop
allier	allier
mări	seas
câine	dog
trecutul	past
balcani	balkans
balcani	balkan
votul	voting
categoriile	categories
maroc	morocco
fiii	sons
extinde	extend
extinde	expand
interese	interests
interese	interest
herman	herman
rené	rené
rené	rene
interesant	interesting
interesant	exciting
introdusă	introduced
traduce	translate
considerând	considering
corpuri	bodies
succesor	successor
pete	pete
garda	guard
garda	garda
figuri	figures
ceramică	pottery
ceramică	ceramic
ceramică	ceramics
anexarea	annexation
sound	sound
distribuit	shared
metropolitană	metropolitan
cinstea	honesty
salvat	saved
anunță	announce
anunță	announces
biblia	bible
alina	alina
auguste	auguste
cupru	copper
îmbunătățirea	improving
continentală	continental
continentală	mainland
niculescu	niculescu
suprafețe	surfaces
construi	build
directe	direct
câștiga	win
cimitir	cemetery
cimitir	graveyard
situri	sites
bologna	bologna
republican	republican
interval	range
interval	interval
picior	foot
picior	leg
considerabil	considerably
considerabil	considerable
explicit	explicitly
explicit	explicit
caroline	caroline
modena	modena
florea	florea
dramă	drama
drama	drama
angelo	angelo
ein	ein
regulat	regularly
regulat	regular
conținând	containing
călinescu	călinescu
ghost	ghost
colorado	colorado
sèvres	sèvres
wright	wright
bolyai	bolyai
dori	dori
werner	werner
hérault	hérault
profit	profit
triburi	tribes
editorial	editorial
republici	republics
shoemaker	shoemaker
respect	respect
constituită	constituted
orbita	orbit
sper	hope
închisoarea	jail
închisoarea	prison
summer	summer
grafice	charts
grafice	graphs
grafice	graphics
alese	chosen
dealurile	hills
proteja	protect
intersectează	intersect
gregorian	gregorian
descrise	described
fabrici	factories
marcu	mark
drosera	drosera
robot	robot
principatul	principality
luigi	luigi
platforma	platform
gary	gary
consens	consensus
stații	stations
ambasador	ambassador
mulțimea	crowd
absolută	absolute
kanem	kanem
bonaparte	bonaparte
clasificarea	classification
reacții	reactions
semnificativă	significant
însemnând	meaning
discurs	speech
materialele	materials
valencia	valencia
prietenie	friendship
călugări	monks
echilibru	balance
paolo	paolo
bornu	bornu
repetate	repeated
aus	aus
ileana	ileana
dem	dem
legendă	legend
arbori	trees
incinta	enclosure
magnetic	magnetic
tablou	painting
excelență	excellence
închise	closed
respectă	comply
aruncat	discarded
dificilă	difficult
tehnologii	technologies
tehnologii	technology
anuale	annual
juridic	legal
julius	julius
imposibil	impossible
eagle	eagle
ocupând	occupying
fântâna	fountain
diferențe	differences
mars	mars
graham	graham
sfântă	holy
contemporan	contemporary
navy	navy
flotei	fleet
deceniu	decade
deutsche	deutsche
substanță	substance
prevăzute	stipulated
loiret	loiret
interesele	interests
biografia	bio
biografia	biography
copilăria	childhood
urcat	climbed
weimar	weimar
lanț	chain
poem	poem
introduceți	enter
bibliotecă	library
greșeală	mistake
cetăți	strongholds
elementul	element
tabelul	table
zăpadă	snow
transfer	transfer
jose	jose
vecinătatea	vicinity
muzicieni	musicians
iowa	iowa
self	self
juventus	juventus
asociații	associations
propuneri	proposals
numărat	counted
efectuează	perform
util	useful
util	helpful
etaj	floor
criticilor	critics
managementul	management
gene	eyelashes
gene	gene
bach	bach
ardèche	ardèche
zürich	zürich
zürich	zurich
portugheză	portuguese
mozart	mozart
ipoteza	hypothesis
aventurile	adventures
neapărat	necessarily
întrebare	question
calculatoare	computers
diametrul	diameter
capua	capua
caracterizat	characterised
caracterizat	characterized
blood	blood
monumentele	monuments
genova	genoa
tipic	typical
laterală	lateral
dana	berth
dana	dana
legislative	legislative
abraham	abraham
slabă	weak
curentul	current
pat	pat
pat	bed
grecii	greeks
daniela	daniela
paralele	parallel
paralele	parallels
copa	copa
mar	mar
mar	apple
fischer	fischer
islamic	islamic
elev	pupil
elev	student
bridge	bridge
posedă	possesses
posedă	possess
unită	united
nervos	nervous
mâncare	food
lorenzo	lorenzo
hardy	hardy
campanii	campaigns
federale	federal
extinsă	extended
extinsă	expanded
realizare	realization
realizare	achievement
servește	serves
finanțe	finance
ban	ban
venituri	revenue
venituri	income
planete	planets
figura	figure
invadat	invaded
demisionat	resigned
blog	blog
continent	mainland
continent	continent
alain	alain
secretarul	secretary
autorii	authors
muzee	museums
parțială	partial
exterioare	exterior
heavy	heavy
forest	forest
fragment	fragment
fragment	snippet
densitatea	density
botez	baptism
botez	christening
indonezia	indonesia
menținut	maintained
soul	soul
coarde	strings
coarde	chords
animate	animated
acceptată	accepted
geschichte	geschichte
our	our
early	early
imi	imi
participare	participation
utile	useful
specializată	specialised
specializată	specialized
obiectivele	objectives
obiectivele	goals
bătălii	battles
nazist	nazi
șir	string
colonie	colony
rea	bad
cruz	cruz
ryan	ryan
wwe	wwe
engl	engl
egiptul	egypt
mori	die
amintit	remembered
moise	moses
helin	helin
încoronat	crowned
atribuit	attributed
atribuit	assigned
bulevardul	boulevard
pereche	pair
marină	navy
marină	marine
călătorit	travelled
călătorit	traveled
vechime	seniority
nokia	nokia
bucăți	chunks
bucăți	pieces
dispariția	disappearance
înlocuite	replaced
cifre	digits
cifre	figures
construiește	construct
ființe	beings
rafael	raphael
rafael	rafael
implicate	involved
morală	moral
morală	morals
valois	valois
ville	ville
bin	bin
brazilian	brazilian
florile	flowers
noțiunea	notion
field	field
gimnastică	gymnastics
executarea	execution
ieșire	output
ieșire	exit
jason	jason
angiosperme	angiosperms
legende	legends
desfășurarea	deployment
accent	accent
benin	benin
alberto	alberto
aplicate	applied
implicit	default
cairo	cairo
anime	anime
nassau	nassau
alcool	alcohol
titus	titus
remarcabile	remarkable
promova	promote
slave	slavic
moduri	ways
moduri	modes
complexă	complex
academic	academic
prelucrare	processing
nobil	noble
plătit	paid
kansas	kansas
conducătorii	rulers
marcată	marked
descoperiri	discoveries
descoperiri	discovery
fundal	background
calificare	qualifications
calificare	qualification
full	full
paralela	parallel
organele	organs
tratează	treat
tratează	treats
dispută	dispute
lazio	lazio
popoare	peoples
fișiere	files
califatul	caliphate
programele	programs
greșeli	mistakes
autonomie	autonomy
câini	dogs
pin	pine
pin	pin
predominant	predominant
predominant	predominantly
jános	jános
reparații	repair
reparații	repairs
piciorul	leg
reluat	resumed
romulus	romulus
administratori	administrators
administratori	admins
groază	horror
groază	dread
opinie	opinion
contrast	contrast
baker	baker
asasinarea	assassination
claudiu	claudiu
salzburg	salzburg
simțit	felt
server	server
aerul	air
globul	globe
lideri	leaders
lux	lux
lux	luxury
cia	cia
cia	cla
finalizat	completed
ceremonia	ceremony
roberto	roberto
extern	externally
extern	external
arii	arias
arii	areas
lumi	worlds
apostol	apostle
curge	flows
curge	flowing
tha	tha
localnici	locals
dezvăluie	disclose
dezvăluie	reveal
dezvăluie	reveals
virtual	virtual
plural	plural
găzduit	hosted
înțelegerea	understanding
echipajul	crew
dispozitive	devices
riscul	risk
asociată	associated
asociată	associate
ofensiva	offensive
nunta	wedding
jefferson	jefferson
protest	protest
minte	mind
contractul	contract
wettin	wettin
electoral	electoral
parlamentar	parliamentary
carter	carter
agenții	agents
agenții	agencies
recunoscute	recognized
recunoscute	recognised
ariège	ariège
politehnica	politehnica
politehnica	polytechnic
frecvență	frequency
mont	mont
traversat	crossed
penal	criminal
penal	penal
ochiul	eye
colonia	colony
recomandă	recommends
recomandă	recommend
feroviar	rail
învață	learn
agenți	agents
transformată	transformed
verzi	green
marcă	brand
adoptarea	adoption
harrison	harrison
dell	dell
explicat	explained
supremă	supreme
