rené	rené
shannon	shannon
kapamilya	đình
pueblo	pueblo
oso	gấu
violin	violin
narciso	narciso
mph	mph
kuru	kuru
tail	đuôi
perth	perth
mie	mie
cry	khốc
cry	cry
cry	khóc
pagsusuka	nôn
veronica	veronica
helicopter	helicopter
helicopter	thăng
pure	sạch
bahaghari	rainbow
rudolph	rudolph
rudolph	rudolf
prayer	nguyện
indio	indio
nicole	nicole
chuck	chuck
makiling	makiling
caceres	caceres
rowling	rowling
onna	onna
kabibe	seashell
gag	gag
kuneho	thỏ
fans	fans
fans	fan
cherry	cherry
diet	diêt
wen	wen
wen	văn
chalcedon	chalcedon
taxa	taxa
mabasa	đọc
magbayad	trả
whitney	whitney
qui	qui
amalia	amalia
fra	fra
res	res
malakanyang	malacañang
fontsize	fontsize
nadagdagan	tăng
masedonya	macedonia
android	android
paggaling	recovery
deal	deals
deal	thuận
eli	eli
iono	ion
alexis	alexis
dinagat	dinagat
mya	mya
joachim	joaquim
joachim	joachim
dion	dion
nakatago	phone
nakatago	ẩn
ind	ind
manetho	manetho
glacier	glacier
gulf	vịnh
puri	puri
parserfunctions	parserfunctions
hominidae	hominidae
amazon	amazon
uwak	quạ
uwak	crows
uwak	quạ
uwak	corvus
uwak	quạ
uwak	raven
desert	mạc
ekstrang	chừa
chamber	vẹn
precious	precious
precious	quý
manatiling	stay
molina	molina
vietnamese	vietnamese
elvis	elvis
kent	kent
luwalhati	vinh
yamanashi	yamanashi
razon	razon
talahanayan	bảng
talahanayan	bàn
jam	jam
jam	mứt
tochigi	tochigi
logic	luận
logic	logic
gilmore	gilmore
verde	verde
sato	sato
kwarto	phòng
kwarto	phòng
maurice	maurice
email	email
wakayama	wakayama
shopping	sắm
shopping	shopping
subspecies	subspecies
arend	arend
kaiser	kaiser
hold	giữ
mayang	chestnut
irene	irene
herrera	herrera
jehova	jehovah
ape	khỉ
eiffel	eiffel
tip	mẹo
pagtatagumpay	triumph
shinkansen	shinkansen
côte	côte
cream	kem
cream	cream
archives	archives
nakatali	chủa
pertilidad	fertility
transmitter	phái
apache	apache
toni	toni
gamboa	gamboa
cabanatuan	cabanatuan
tulog	ngủ
tulog	ngự
prusisyon	rước
ivoire	ivoire
naririnig	thuộc
naririnig	tít
naririnig	nghe
naririnig	spring
malacañang	malacañang
shinichi	shinichi
hoon	hoon
pagtatanong	inquiry
indus	indus
hangad	vicious
dee	dee
gamutin	chữa
gamutin	cure
gamutin	đãi
ust	ust
kalasag	shield
kalasag	khiên
levy	levy
imp	imp
vinci	vinci
paraguay	paraguay
gerard	gerard
meteor	meteor
dynamic	động
ecuador	ecuador
yui	yui
geo	geo
boeing	boeing
hinulaan	đoán
calvin	calvin
malawi	malawi
athena	athene
athena	athena
ted	ted
alamang	dán
alamang	dã
evil	xấu
evil	ác
volga	volga
gibbon	gibbon
gibbon	vượn
palestino	palestin
atp	atp
córdoba	córdoba
app	app
hermosa	hermosa
masarap	ngon
saud	saud
vaccine	vaccine
habilis	habilis
sid	sid
fabian	fabian
rush	rush
jedi	jedi
umatake	thải
umatake	đuổi
caussols	caussols
inihambing	so
collapsible	collapsible
ipasok	nhập
ipasok	enter
amazing	amazing
louvre	louvre
martha	martha
reproduksiyong	asexual
uniform	uniform
senegal	senegal
lacey	lacey
wojtyła	wojtyła
eukaryote	eukaryote
muramatsu	muramatsu
barretto	barretto
snak	snak
meme	meme
ipadala	gửi
ipadala	gởi
npov	npov
cris	cris
autosomal	autosomal
periodical	periodical
sophia	sofia
sophia	sophia
liberia	tuyến
liberia	liberia
daddy	bố
earnhardt	earnhardt
shinto	shinto
zoo	thú
zoo	zoo
hinog	chín
kalamidad	họa
nadine	nadine
janeiro	janeiro
morpolohiya	morphology
katatawanan	hài
katatawanan	hài
kahihiyan	nhục
evening	tối
plate	đĩa
plate	dĩa
zip	zip
uncle	chú
uncle	bác
baguhang	rookies
inn	inn
melanie	melanie
alaminos	alaminos
pangit	xấu
pangit	xau
pangit	xí
avatar	thịnh
avatar	avatar
eigenmann	eigenmann
ambassador	sứ
kyle	kyle
senyas	vẽ
phu	phú
phu	phu
sitcom	sitcom
getparent	getparent
cal	cal
kirot	đau
hardy	hardy
tagamasid	observer
retval	retval
itinago	phone
itinago	ẩn
radiation	xạ
len	len
zion	zion
zion	sion
rhea	rhea
direksyon	hướng
hillary	hillary
hillary	hilary
dumadami	modi
bocaue	bocaue
lilith	lilith
nicaragua	nicaragua
warren	warren
neurotransmitter	neurotransmitter
rainbow	rainbow
stamp	stamp
stamp	tem
glenn	glenn
cervantes	cervantes
mapagmahal	yêu
divina	divina
mapait	đắng
palawakin	bung
ahura	ahura
kagat	bit
kagat	đớp
kagat	táp
kagat	cắn
kagat	cắn
diyeta	diêt
cayetano	cayetano
morgan	morgan
paparating	sắp
corona	corona
boxer	boxer
pref	pref
lumakas	mạnh
bing	bing
batch	đợt
batch	batch
batch	mẻ
batch	bó
tristan	tristan
mayon	mayon
ren	ren
ren	nhâm
tokyopop	tokyopop
loyola	loyola
keiko	keiko
bara	bara
cabuyao	cabuyao
baltazar	baltazar
mazda	mazda
saw	cưa
mananatiling	stay
gerardo	gerardo
amelia	amelia
gear	gear
gear	ten
soledad	soledad
nakikinig	nghe
toulouse	toulouse
pako	fern
malate	malate
sodium	natri
tinik	thorn
tinik	torn
aksyon	hành
legion	legion
lynch	lynch
bravo	bravo
cause	chi
noah	noah
charm	charm
ajax	ajax
superman	superman
sinturon	đai
keltiko	celtic
tadeo	tadeo
famicom	famicom
zoroaster	zoroaster
aboveclass	aboveclass
duwende	lùn
duwende	phơ
pons	pons
sarsa	ngao
sarsa	sốt
yamashita	yamashita
gandhi	gandhi
joyce	joyce
tonga	tonga
basal	basal
yume	yume
bayaran	trả
wilaya	wilaya
playoffs	playoffs
tokushima	tokushima
labrador	labrador
vanuatu	vanuatu
norfolk	norfolk
ahmed	ahmed
apatnapu	forty
chiu	chiu
balang	locust
hon	hon
dinamika	dynamics
valenciano	valenciano
lynn	lynn
rei	rei
rescue	cứu
ashoka	ashoka
toyama	toyama
usc	usc
dot	chấm
dot	dot
pumasa	qua
pumasa	đèo
pumasa	pass
dylan	dylan
labuyo	partridge
icd	icd
hermaniko	germanic
supernatural	supernatural
honolulu	honolulu
plaridel	plaridel
prado	prado
lente	lens
sabon	xà
yorkshire	yorkshire
dapitan	dapitan
québec	quebec
gumana	mổ
annie	annie
mami	mami
chin	chin
chin	cằm
fly	fly
fly	ruồi
fly	bay
pahinga	nghỉ
alkali	alkali
maximo	maximo
aalinlangan	dằng
bright	sáng
bright	mẻ
terni	terni
vida	vida
chess	chiếu
ubod	lõi
ubod	hạt
ubod	nhân
akma	fits
akma	hợp
akma	khớp
drop	giọt
drop	bỏ
drop	thả
izumi	izumi
yin	âm
yin	yin
jenny	nghiện
jenny	jenny
austin	austin
pumutok	đê
pumutok	nứt
aoi	aoi
twilight	twilight
strings	chuỗi
strings	strings
elder	elder
michel	michel
estonian	estonia
hanoi	hanoi
gal	gal
kashmir	kashmir
gondwana	gondwana
zte	zte
chiaki	chiaki
johannes	johannes
kalapati	dove
andre	andre
andre	andré
pagod	trau
pagod	mệt
aswang	fatal
hui	huệ
hui	hui
hui	hủi
hui	huy
rté	rté
newfoundland	newfoundland
mohammad	mohammad
cameron	cameron
jungle	rừng
jungle	jungle
alveolar	alveolar
session	phiên
session	phiên
katrina	katrina
usd	usd
usd	vnd
ballad	ballad
masayuki	masayuki
tagiliran	bên
tagiliran	phe
tagiliran	trang
kawit	hook
kawit	móc
kawit	kawit
guatemala	guatemala
guatemala	gua
pepe	pepe
denis	denis
dolly	dolly
manchu	manchu
utada	utada
montano	montano
vanessa	vanessa
carla	carla
étude	étude
gibbs	gibbs
nino	nino
paso	đốt
paso	cháy
paso	burn
steam	steam
steam	lết
polynesia	polynesia
regina	regina
magbabago	đổi
magbabago	thay
elektra	electra
butiking	lằn
trap	bẫy
trap	tráp
laser	laser
laser	laze
pasta	pasta
pasta	mì
trinity	trinity
libertad	libertad
kusina	bếp
nagulat	sốc
idaho	idaho
coubertin	coubertin
noriko	noriko
noriko	nori
richmond	richmond
gnp	gnp
boiling	sôi
adonis	adonis
fiber	fiber
fiber	sợi
delphi	delphi
nebraska	nebraska
conde	conde
solis	solis
yip	diệp
bubalus	bubalus
rap	sub
rap	rap
dreams	mơ
dreams	dreams
xinglong	xinglong
roble	roble
patutunguhan	đích
anting	bùa
marvin	marvin
suspek	nghi
buenaventura	buenaventura
nestor	nestor
baliw	khùng
baliw	điên
bao	bao
bao	bảo
broken	gãy
broken	vỡ
broken	hỏng
broken	hư
okayama	okayama
edipo	oedipus
bosco	bosco
import	nhập
import	danh
pinutol	khối
bodystyle	bodystyle
iniiwasan	ngăn
eritrea	eritrea
arcade	arcade
abalos	abalos
pagdagdag	thêm
duterte	duterte
bumabagsak	falling
bumabagsak	rơi
sipon	lạnh
canterbury	canterbury
tawad	thầu
tawad	bid
thee	thee
riemann	riemann
claire	claire
barbuda	barbuda
umatras	ngược
sukatin	gauge
sukatin	đo
berry	berry
audition	audition
lubid	dây
prussia	phổ
tezuka	tezuka
mahmoud	mahmoud
woong	woong
mohamed	mohamed
pagkatuklas	discovery
kilogramo	kilogram
seen	thấy
mcrae	mcrae
viejo	viejo
duran	duran
oshima	oshima
portland	portland
kinunan	mắng
endangered	endangered
itunes	itunes
peralta	peralta
teamb	teamb
itayo	pitch
nasugbu	nasugbu
leone	leone
bryan	bryan
manzano	manzano
enki	enki
mono	mono
hoshi	hoshi
higante	giant
higante	toshiba
churchill	churchill
atienza	atienza
lana	len
lana	lana
este	este
gutom	đói
gutom	đói
dao	dao
creek	lạch
creek	creek
makatwiran	irrational
otaku	otaku
muscle	muscle
antilles	antilles
laoag	laoag
squad	squad
squad	đội
utong	vú
networking	mạng
baki	baki
pse	pse
naik	suburb
naik	naik
jessie	jessie
pinky	pinky
sysop	sysop
pateros	pateros
hands	tay
dual	kép
dual	dual
amen	amen
sukdulan	orgasm
belmonte	belmonte
dms	dms
ccd	ccd
mabilisan	mau
mabilisan	nhanh
mabilisan	rapid
mabilisan	instant
mabilisan	tức
beer	beer
beer	bia
yumi	yumi
otherparty	otherparty
yusuke	yusuke
magpakailanman	forever
magpakailanman	mải
payne	payne
dsm	dsm
hilera	hàng
itanong	bảo
itanong	hỏi
sundan	theo
nikki	nikki
jing	jing
jing	tinh
beth	beth
café	café
freestyle	freestyle
cortes	cortes
lavender	lavender
nepomuceno	nepomuceno
sapilitan	induced
tyler	tyler
marks	marks
jorgensen	jorgensen
urong	recession
kamara	vẹn
claudia	claudia
roland	roland
retrieve	retrieve
medes	medes
pagadian	pagadian
homes	nhà
hottest	hottest
share	chia
share	share
shaider	shaider
malaysian	malaysia
lindsay	lindsay
tribune	tribune
mazinger	mazinger
hominin	hominin
boom	hụt
boom	bùm
boom	boom
liechtenstein	liechtenstein
gutenberg	gutenberg
brussels	bruxelles
brussels	brussels
diyaryo	báo
baroque	baroque
lucio	lucio
lucio	lucius
epifanio	epifanio
inanyayahan	mời
degrees	độ
ned	ned
pagsanjan	pagsanjan
hungarian	hung
hungarian	hungary
suikoden	suikoden
inosente	tội
urinary	urinary
kmt	kmt
sofia	sofia
maldives	maldives
puntod	mộ
puntod	tomb
puntod	mộ
puntod	mồ
zacarias	zechariah
ronaldo	ronaldo
taya	cược
creation	tạo
shogun	shogun
pasok	hạng
virgil	virgil
frs	frs
ascii	ascii
ismael	ishmael
taxobox	taxobox
kobe	kobe
channels	kênh
tira	tira
rally	rally
clone	clone
r}}}}	r}}}}
apela	khiếm
pat	pat
pat	vỗ
bye	bye
djibouti	djibouti
mesosoiko	mesozoic
magturo	dạy
trutsa	trout
leonor	leonor
ugarit	ugarit
sobra	thụ
nicanor	nicanor
basura	junk
basura	phế
basura	chấy
basura	rác
basura	rác
iris	iris
pinahintulutan	phép
sinira	phản
sinira	bội
sinira	hỏng
sinira	xì
lily	lily
shueisha	shūeisha
itigil	dừng
itigil	ngừng
finalist	finalist
wells	wells
wells	giếng
spell	spell
unique	unique
okay	ok
pac	pac
pagsakay	surf
pantalan	neo
pantalan	dock
pantalan	pier
louie	louie
mit	mit
donkey	donkey
donkey	lừa
sandra	sandra
salome	salome
salonga	salonga
erwin	erwin
linaw	clarity
pulso	nhịp
pulso	mạch
emil	emil
ver	ver
sariwa	tươi
panthera	panthera
ebanghelista	evangelist
adventist	adventist
leopold	léopold
leopold	leopold
gaddafi	gaddafi
manx	manx
venecia	venecia
abydos	abydos
pack	gói
pack	packs
pack	gói
pack	quấn
pack	pack
lan	lan
kendi	kẹo
kendi	candy
nazareth	nazareth
spencer	spencer
jaworski	jaworski
nama	nama
alegre	alegre
nat	nat
nacional	nacional
suriname	suriname
sumira	băm
sumira	hash
sumira	hỏng
sumira	xì
euripides	euripides
boyer	boyer
naantala	hoãn
naantala	trễ
theresa	theresa
bonobo	bonobo
higgs	higgs
gaul	gaulois
gaul	gaul
caroline	caroline
sook	sook
nilagay	chua
nilagay	norad
nilagay	đặt
nilagay	bot
marsh	lầy
marsh	marsh
hammurabi	hammurabi
prieto	prieto
carpio	carpio
paghanap	tìm
sonic	sonic
rahman	rahman
takagi	takagi
fukui	fukui
gent	gent
herman	herman
neal	neal
payat	mỏng
payat	skinny
payat	gầy
payat	nhẹ
payat	mỏng
payat	gầy
payat	thin
paglalahat	generalization
nobunaga	nobunaga
maggie	maggie
pangangati	ngứa
miracle	diệu
elite	elite
nagkita	trúng
nagkita	met
nabasa	đọc
blade	blade
katakana	katakana
kit	kit
stdinchi	stdinchi
kosmolohiya	cosmology
kish	kish
caracas	caracas
papyrus	papyrus
holland	holland
pagsalin	dịch
ego	ego
lala	lala
zheng	trịnh
zheng	zheng
maasim	chua
ike	eisenhower
ike	ike
alcamo	alcamo
patatas	khoai
kambriyano	cambrian
nagtitinda	bán
aviation	aviation
digimon	digimon
kushida	kushida
mozart	mozart
kosai	kosai
valentine	valentine
perla	perla
enoch	enoch
lorraine	lorraine
amag	mốc
stdinchikey	stdinchikey
negro	negro
hood	mui
hood	hood
kopa	cup
kopa	cốc
kopa	tách
balo	góa
balo	widow
webster	webster
paniki	bat
paniki	dơi
ati	ati
mangga	xoài
mangga	mango
ibrahim	ibrahim
pulubi	beggar
kaba	kaba
indoor	indoor
kaon	kaon
ami	ami
windsor	windsor
kenji	kenji
toei	toei
filter	lọc
talong	dập
ishida	ishida
kiev	kiev
oslo	oslo
vulgata	vulgate
pangaea	pangaea
yamada	yamada
edwards	edwards
canaveral	canaveral
chance	hội
rika	rika
tumayo	đứng
lay	lay
lay	nằm
showtime	showtime
s}}	s}}
sans	sans
carey	carey
vergara	vergara
crush	crush
crush	đê
crush	bể
suweldo	lương
dominican	dominican
yaya	yaya
cielo	cielo
sikmura	bụng
#cc	#cc
ayano	ayano
robo	robo
ave	ave
oxide	oxit
oxide	ôxít
oxide	oxide
kinansela	hủy
kinansela	hủy
teddy	teddy
amenhotep	amenhotep
sanay	hanh
claudio	claudio
tuvalu	tuvalu
encyclopædia	encyclopædia
drew	lê
drew	drew
risa	risa
tangkad	cao
pusit	mực
correct	đúng
rom	rom
tigers	tigers
tigers	hổ
musashi	musashi
hirohito	hirohito
transistor	transistor
katy	katy
mangkukulam	hunt
mangkukulam	săn
serif	serif
namibia	namibia
josef	josef
lydia	phuong
lydia	lydia
chiyoda	chiyoda
takumi	takumi
zen	zen
asami	asami
bint	bint
huila	huila
sumerian	sumer
coliseum	coliseum
higashi	higashi
perpekto	hảo
holocaust	holocaust
juliana	juliana
enrico	enrico
elton	elton
pautang	vay
antoine	antoine
myung	myung
coulomb	coulomb
familycolor	familycolor
español	español
umm	umm
manolo	manolo
relay	relay
lope	lope
yogurt	yogurt
tobago	tobago
fungus	fungus
fungus	nấm
nagpalit	converts
months	tháng
abruzzo	abruzzo
romo	romo
npc	npc
lacus	lacus
tottori	tottori
calcium	calcium
calcium	canxi
pearson	pearson
natutunaw	soluble
makakita	xem
andreas	andreas
simeon	simeon
nagorno	nagorno
vie	vie
juliet	juliet
mahuli	bắt
isabella	isabella
cole	cole
belize	be
belize	belize
sili	ớt
sili	chili
sili	ớt
sili	capsicum
paramore	paramore
luya	ginger
luya	gừng
gin	gin
georges	georges
dugtong	tham
sigmund	sigmund
hussein	hussein
keiji	sheriff
pabahay	nhà
barnabas	barnabas
cafe	cafe
cafe	café
cafe	café
kimura	kimura
bison	bison
load	nạp
load	tải
mickey	mickey
ulam	dish
ulam	món
serbesa	beer
serbesa	bia
elmer	elmer
bamboo	bamboo
bamboo	tre
gmt	utc
gmt	gmt
maja	maja
swing	vung
swing	đu
swing	swing
mascot	mascot
zobel	zobel
espesyalista	chuyên
sant	sant
hash	băm
hash	hash
lumulutang	lỏng
sutra	kinh
beverly	beverly
hayato	hayato
nevis	nevis
lovers	lovers
kira	kira
scandal	scandal
severe	nặng
hime	hime
levi	levi
quintanilla	quintanilla
seleucus	seleukos
takeshi	takeshi
greenwich	greenwich
pagdududa	reo
yuga	yuga
nakakatakot	spooky
meyer	meyer
teenage	teenage
inferior	inferior
epiphanius	epiphanius
tunis	tunis
mckinley	mckinley
hopkins	hopkins
carson	carson
peña	pena
peña	peña
theravada	theravada
taro	taro
makatakas	thoát
makatakas	escape
greenland	greenland
arai	arai
yue	yue
yue	nguyệt
comoros	comoros
centennial	centennial
brief	briefs
katuwaan	fun
katuwaan	ké
katuwaan	vui
mariel	mariel
guyana	guyana
palaisipan	đố
palaisipan	puzzle
palaisipan	tuệ
severino	severino
guild	guild
kepler	kepler
charter	charter
ely	ely
videos	video
videos	videos
marseilles	marseille
marseilles	marseilles
romanian	rumani
pion	pion
leslie	leslie
barbados	barbados
jules	jules
gui	gui
umasa	mong
umasa	xoa
porsche	porsche
pesce	pesce
haruka	haruka
quan	quan
crash	crash
crash	crashes
screenwriter	screenwriter
gonzález	gonzález
taasan	tăng
taasan	nâng
taasan	nuôi
taasan	nhôm
corregidor	corregidor
lorentz	lorentz
nagtutulak	dồn
patria	patria
ines	ines
elisa	elisa
metcalf	metcalf
gibson	gibson
ore	quặng
diablo	diablo
pol	pol
pol	pool
pol	lưu
pol	bích
pol	cứu
geoffrey	geoffrey
champions	champions
stay	stay
kabukiran	quê
jeju	jeju
asero	thép
ragnarok	ragnarok
shoten	shoten
socrates	socrates
yoshida	yoshida
eon	eon
sawyer	sawyer
makatotohanan	tế
connection	hã
munggo	đậu
asiatic	asiatic
isara	close
isara	đóng
isara	gần
isara	kín
isara	đóng
isara	cận
jesse	jesse
christoph	christoph
goto	goto
thomson	thomson
naghahatid	giao
baldwin	baldwin
heisenberg	heisenberg
lions	lions
caraga	caraga
asno	đít
asno	mông
asno	donkey
asno	lừa
pnr	pnr
montilla	montilla
easter	easter
kathleen	kathleen
kiribati	kiribati
cleopatra	cleopatra
medyebal	medieval
hair	tóc
vasquez	vasquez
barong	barong
antibody	antibody
akiko	akiko
layout	layout
spongebob	spongebob
cash	cash
bea	bea
battlefield	battlefield
cool	ngầu
cool	tuyệt
cool	mát
cool	cool
brazilian	brazil
brazilian	brazilian
kitts	kitts
matingkad	saxon
hazel	hazel
hur	hur
olbia	olbia
dun	diệu
dun	fabulous
dun	dun
prof	prof
chua	chùa
chua	chua
rubia	rubia
hermann	hermann
ven	ven
queens	queens
pagbenta	bán
pagbenta	lô
sint	sint
litro	lít
litro	lít
natatakot	sợ
natatakot	ex
natatakot	sợ
mason	mason
alano	alano
baging	vine
hor	hor
tiberius	tiberius
melissa	melissa
tamad	lat
tamad	biếng
tamad	lazy
tamad	lười
connor	connor
othername	othername
nagbabayad	trả
nagbabayad	trả
quang	quang
cave	cave
cave	hang
vidal	vidal
trenčín	trenčín
banco	banco
sobre	bì
valois	valois
sertipiko	chứng
rafflesia	rafflesia
wonderland	wonderland
unity	unity
fricative	fricative
dino	dino
makabago	stylish
dali	mau
dali	nhanh
dali	dali
sandwich	sandwich
grid	lưới
bronx	bronx
subtemplate	subtemplate
leipzig	leipzig
takashi	takashi
switch	switch
switch	chuyển
weimar	weimar
umiinog	rotary
dumaguete	dumaguete
aga	aga
tingga	dẫn
tingga	chì
magdadala	mang
hyo	hyo
lapis	chì
kegg	kegg
suite	suite
cake	bánh
colin	collin
colin	colin
benin	benin
loren	loren
tutankhamun	tutankhamun
fullmetal	fullmetal
adolfo	adolfo
méxico	méxico
méxico	mêxico
arafat	arafat
anemia	anemia
jolo	jolo
stuttgart	stuttgart
heidelbergensis	heidelbergensis
cyrus	cyrus
canis	canis
serviceyears	serviceyears
prokaryote	prokaryote
nagkasakit	bệnh
nagkasakit	ốm
nagkasakit	cúm
iliada	iliad
arrow	arrow
tagapangalaga	guardian
mangkok	bát
batik	batik
maanghang	cay
moran	moran
kojima	kojima
eid	eid
stanford	stanford
sarang	sarang
pakete	gói
pakete	gói
pāli	pāli
crawford	crawford
umar	umar
palm	palm
palm	sên
palm	cọ
incheon	incheon
roc	roc
roc	róc
nagtatagal	taking
baltiko	baltic
melody	giai
melody	melody
mussolini	mussolini
antonino	antonino
magkahalong	võ
tnt	tnt
gpl	gpl
seth	seth
grosseto	grosseto
nakatagong	phone
nakatagong	ẩn
ipil	ipil
moz	moz
tube	ống
fitzgerald	fitzgerald
shop	shop
halili	halili
pabango	perfume
dyesebel	dyesebel
quintana	quintana
tagapagsalin	dịch
maxim	maxim
bilhin	mua
bilhin	mua
lil	lil
andré	andre
andré	andré
tukso	temptation
drum	drum
drum	trống
drum	trống
britney	britney
sleep	ngủ
sleep	ngự
klinika	clinic
ibm	ibm
coa	coa
maiden	maiden
nagtatago	trốn
vermont	vermont
cyborg	cyborg
nalang	chỉ
nalang	funny
shah	shah
kasinungalingan	lies
kasinungalingan	nằm
bohemia	bohemia
rebulto	tượng
kant	kant
moment	lát
mexicana	mexicana
alden	alden
otoko	otoko
sec	sec
sec	giây
hara	hara
tatanggap	receiver
polyvios	polybius
schmadel	schmadel
lebesgue	lebesgue
famous	nổi
huxley	huxley
dancer	dancer
cologne	cologne
cologne	köln
judo	judo
tropiko	tropics
versailles	versailles
reed	reed
duo	duo
tokusatsu	tokusatsu
strauss	strauss
morena	morena
radar	radar
radar	rađa
tarawa	tarawa
diesel	diesel
pascal	pascal
flynn	flynn
cork	cork
tetrapoda	tetrapod
reagan	reagan
poste	trục
poste	đăng
poste	cực
poste	pole
poste	cột
basel	basel
joker	joker
marilyn	marilyn
taksi	taxi
kenyon	kenyon
matutunan	ngộ
matutunan	học
pron	pron
natividad	natividad
chargers	chargers
ikeda	ikeda
velez	velez
osama	osama
barry	barry
pmid	pmid
xxx	xxx
wikitable	wikitable
otel	inn
otel	hotel
riyadh	riyadh
erik	erik
gateway	cổng
gateway	gateway
delaware	delaware
shoujo	shoujo
donetsk	donetsk
lumot	mose
lumot	rêu
farra	farra
kitty	kitty
ptolomeo	ptolemaios
ptolomeo	ptolemy
milwaukee	milwaukee
marguerite	marguerite
sakai	sakai
kota	kota
surah	surah
linares	linares
pride	ngạo
ashur	ashur
escudero	escudero
nihon	nihon
nasusunog	cháy
nagdesisyon	quyết
hideyoshi	hideyoshi
fermion	fermion
draco	draco
ara	ara
pagharang	chặn
kenshin	kenshin
beda	beda
gaius	gaius
suarez	suarez
lesbian	lesbian
pinapayagang	phép
fajardo	fajardo
hidalgo	hidalgo
eng	eng
mill	mill
tiyo	chú
tiyo	bác
danao	danao
sonny	sonny
bissau	ni
bissau	bissau
ishtar	ishtar
libis	dốc
flat	phẳng
edith	edith
bertrand	bertrand
makasama	hại
serial	serial
ryu	ryu
wesley	wesley
yaoi	yaoi
swimming	bơi
tumalon	nhảy
fetus	fetus
artemis	artemis
barbarossa	barbarossa
hilda	hilda
payong	umbrella
upo	seating
upo	ngồi
burundi	burundi
finn	tìm
finn	finn
dominikano	dominican
pagkaubos	ozone
colonel	đại
colonel	tá
instant	instant
instant	tức
naghanap	tìm
toki	toki
fortune	fortune
fortune	lường
creta	crete
thor	tor
thor	thor
nguyễn	nguyễn
defensor	defensor
trainer	trainer
trainer	hlv
latte	latte
hito	catfish
canvas	canvas
allison	allison
sulayman	sulayman
mesopotamya	mesopotamia
panoorin	xem
panoorin	pass
kwon	kwon
kilo	kilo
#eee	#eee
roh	roh
infoboxes	infoboxes
receiver	receiver
eds	eds
samson	samson
lebadura	yeast
lebadura	men
linus	linus
hina	hina
salo	salo
glen	glen
pandora	pandora
kawan	flock
judith	judit
judith	judith
rhode	rhode
mare	mare
mamahaling	đắt
nakakulong	confined
blumentritt	blumentritt
ying	ying
tethys	tethys
wto	wto
calabarzon	calabarzon
phillip	phillip
aida	aida
ramsey	ramsey
merry	merry
lyons	lyons
m}}	m}}
karate	karate
ida	lda
ida	ida
feat	feat
hassan	hassan
rivero	rivero
bugso	intermittent
shuttle	shuttle
surat	surat
rocco	rocco
pamimili	marketing
pamimili	sắm
pamimili	shopping
ipv	ipv
cincinnati	cincinnati
sterling	sterling
mapalad	phước
tissue	mô
artemio	artemio
das	das
abel	abel
abel	able
igorot	igorot
pad	pad
mauritania	mauritania
richter	richter
paleo	paleo
translate	dịch
nashville	nashville
lilia	lilia
dipolog	dipolog
paranthropus	paranthropus
prenomen	prenomen
lesser	lesser
rich	vương
rich	giàu
rich	rich
hominid	hominid
traffic	tê
honda	honda
siberian	oanh
siberian	siberian
nasaktan	đau
nasaktan	hại
nasaktan	thương
severus	severus
wallis	wallis
madison	madison
maalat	mặn
masukat	đo
userbox	userbox
tinedyer	teen
tinedyer	teens
romy	romy
lina	lina
gallus	gallus
casno	casno
fisher	fisher
hay	hay
magtanong	bảo
magtanong	hỏi
ipamahagi	chia
ipamahagi	share
unranked	unranked
pagtayo	cương
saki	saki
botswana	botswana
carvajal	carvajal
cheng	ting
cheng	đình
cheng	trịnh
cheng	thành
cheng	cheng
luy	luy
barako	hog
sickle	liềm
sickle	sickle
turuan	dạy
turuan	educating
bas	bas
daet	daet
noc	noc
brassica	brassica
andromeda	andromeda
hagdan	kịch
hagdan	thang
hagdan	ladder
hagdan	dục
ryo	ryo
appointer	appointer
poseidon	poseidon
ravenna	ravenna
malus	malus
che	che
kidney	thận
kidney	cật
deficiency	deficiency
brunswick	brunswick
analog	analog
backstreet	backstreet
mawalan	thua
cosmic	cosmic
bernardino	bernardino
mei	mai
mei	mei
kalibo	kalibo
saba	saba
sagutin	tời
reno	thừa
reno	reno
kōchi	kōchi
cheonan	cheonan
diff	diff
scan	quét
scan	quét
scan	scan
shades	shades
katahimikan	tiet
valerie	valerie
pagputol	cutting
pagputol	cắt
hulaan	đoán
kampong	kampong
numa	numa
rus	rus
feliciano	feliciano
metadata	siêu
rouge	rouge
trouble	rối
ling	ling
ling	linh
yatsura	yatsura
cronus	cronus
imf	imf
cabrini	cabrini
prometheus	prometheus
primo	primo
potassium	kali
phelps	phelps
nielsen	nielsen
balbas	râu
balbas	beard
dad	bố
harper	harper
grove	grove
grove	thô
boluntaryo	nguyện
aruba	aruba
pay	trả
pantalon	quần
gon	gòn
gon	gon
paghuhugas	rửa
laplace	laplace
babel	babel
panonood	xem
panonood	view
lani	lani
kandahar	kandahar
oclc	oclc
savoy	savoy
boss	sếp
boss	boss
rubio	rubio
histoire	histoire
alpes	alps
alpes	anpơ
alpes	alpes
caridad	caridad
franca	franca
koreo	mail
koreo	evolution
koreo	thư
klein	klein
dash	dash
mumbai	mumbai
dress	váy
dress	áo
pinangyarihan	cảnh
dario	darius
dario	dario
sonata	sonata
#fdfdfd	#fdfdfd
uniporme	uniform
galen	galen
hyung	hyung
aisha	aisha
combat	combat
galicia	galicia
creole	creole
keith	keith
alu	alu
cordova	cordova
burns	cháy
kamakura	kamakura
butterfly	butterfly
butterfly	bướm
densetsu	densetsu
hagonoy	hagonoy
troyano	trojan
bakufu	bakufu
nue	nue
sybil	sybil
rodríguez	rodríguez
selling	bán
pagdinig	thính
uminom	uống
uminom	ly
meshname	meshname
madaliang	instant
madaliang	tức
madaliang	hasty
compact	compact
compact	nén
compact	gọn
satoshi	satoshi
gideon	gideon
taytay	taytay
malvar	malvar
reichstag	reichstag
inferno	thoa
oryentasyon	hướng
djoser	djoser
butler	butler
ambrosio	ambrose
duc	duc
rhodesia	rhodesia
shake	lắc
shake	rung
organ	organ
pinirmahan	ký
pagsagip	cứu
hejaz	hejaz
psn	psn
kristine	kristine
akson	axon
shining	brilliant
qtv	qtv
avelino	avelino
belle	belinda
manning	manning
nationalteam	nationalteam
shiga	shiga
viet	việt
bolt	bolt
malcolm	malcolm
malcolm	malcom
cocos	cocos
palaiologos	palaiologos
erika	erika
mika	mika
aqua	aqua
thyroid	thyroid
revival	revival
berdeng	lục
ceti	ceti
pila	lining
breaking	phá
breaking	breaking
gising	haaa
gising	tỉnh
avex	avex
herzl	herzl
drake	drake
tobias	tobias
midori	midori
rho	rho
sullivan	sullivan
velarde	velarde
rings	nhẫn
altai	altai
loire	loire
drugs	vải
selebrasyon	lễ
urdaneta	urdaneta
tuba	tuba
