sugar	sugar
hades	hades
terorismo	terrorism
monogatari	monogatari
kings	kings
hepe	chief
robinson	robinson
dingding	wall
slayers	slayers
charge	charge
charge	charged
ballet	ballet
expressway	expressway
propaganda	publicity
propaganda	propaganda
belen	belen
belen	bethlehem
manchester	manchester
kelly	kelly
mababasa	readable
apayao	apayao
inside	inside
minimum	minimum
pakikibaka	struggle
sinehan	theater
sinehan	cinema
kinukuha	fetching
galileo	galileo
kyung	kyung
iginawad	awarded
samu	samu
ariano	ariano
dalai	dalai
pagtatalaga	assignment
pagtatalaga	inauguration
mouse	mouse
humiling	requested
humiling	request
mutya	mutya
arkansas	arkansas
electronic	electronic
ong	ong
pinalaki	enlarged
kumpanya	company
kumpanya	companies
fine	fine
qaeda	qaeda
tau	tau
emi	emi
maligayang	merry
murphy	murphy
dallas	dallas
josephus	josephus
velasquez	velasquez
westlife	westlife
desc	desc
palayok	pottery
palayok	pot
linux	linux
iminumungkahi	suggested
iminumungkahi	suggest
evolution	evolution
pyramid	pyramid
mano	mano
songwriter	songwriter
snapper	snapper
independence	independence
granada	granada
aliw	consolation
dae	dae
lagusan	fallopian
koi	koi
paggunita	visualization
unibersal	universal
pagpapatunay	authentication
pagpapatunay	validation
julie	julie
imbakan	storage
imbakan	reservoir
athens	athens
keyboard	keyboard
franco	franco
pikachu	pikachu
marcion	marcion
athanasius	athanasius
kuta	fort
masahiro	masahiro
sosyolohiya	sociology
pagpapalitan	exchanges
kabihasnang	mycenaean
tagasuporta	supporter
tagasuporta	supporters
sugihara	sugihara
tres	tres
tinalakay	discussed
morocco	morocco
liberty	liberty
makikilala	recognize
makikilala	recognizable
hukay	pit
tong	tongs
tong	tong
canon	canon
rex	rex
inamin	admitted
kalabaw	buffalo
kalabaw	carabao
bavaria	bavaria
barrel	barrel
shakespeare	shakespeare
patnubay	guide
pagsasara	closure
pagsasara	locking
gagamba	spider
joshua	joshua
eugene	eugene
sinapupunan	womb
kababalaghan	phenomenon
kababalaghan	wonders
titanic	titanic
corp	corp
pagtalakay	discussing
lutjanus	lutjanus
paghihiganti	revenge
pagong	turtle
gamma	gamma
beatles	beatles
resort	resort
devil	devil
alalahanin	commemorate
alalahanin	concerns
alalahanin	concern
plan	plan
andorra	andorra
pinatunayan	proved
norma	norma
magpadala	send
sahara	sahara
sapi	stock
request	request
sahig	floors
sahig	flooring
sahig	floor
sakramento	sacrament
pagbibitiw	resignation
cecilia	cecilia
blanco	blanco
soberanya	sovereignty
hampshire	hampshire
naiwan	left
patak	drops
huminto	abort
huminto	stop
wan	wan
fiji	fiji
schmidt	schmidt
hiragana	hiragana
marte	mars
laboratory	laboratory
iowa	iowa
selection	selection
bambang	bambang
smart	smart
sinusuri	evaluated
namespaces	namespaces
pabrika	factory
tangkay	stem
kahinaan	weakness
kahinaan	cons
timeline	timeline
pagsuporta	supporting
kahapon	yesterday
lin	lin
subukan	try
subukan	test
pastoral	pastoral
porsyento	percentage
fauna	fauna
interesado	interested
nancy	nancy
predicted	predicted
apps	apps
puki	pussy
puki	vagina
imagesize	imagesize
belluno	belluno
par	par
seattle	seattle
imus	imus
turkmenistan	turkmenistan
pandinig	hearing
ipinatupad	implemented
galaxy	galaxy
vancouver	vancouver
sabah	sabah
marketing	marketing
palo	palo
hapunan	dinner
hapunan	supper
lagda	signature
bakr	bakr
doc	doc
jess	jess
cycle	cycle
kosovo	kosovo
ruiz	ruiz
supot	bag
active	active
teng	teng
stuart	stuart
limited	limited
ludwig	ludwig
mythical	mythical
gaza	gaza
mikrobyo	germany
butuan	butuan
graduate	graduate
orasan	clock
nakaharap	facing
marc	marc
delgado	delgado
narrator	narrator
bartolome	bartholomew
edu	edu
crystal	crystal
bert	bert
defensive	defensive
robles	oak
robles	robles
angela	angela
estrella	estrella
diskriminasyon	discrimination
ubo	cough
specimen	specimen
evans	evans
strike	strike
pagpapalagay	assumptions
liza	liza
panghalip	pronoun
ccp	ccp
hadlang	barriers
hadlang	obstacle
hadlang	barrier
cfc	cfc
mental	mental
herodotus	herodotus
bernadette	bernadette
alay	sacrifice
rob	rob
referee	referee
imdb	imdb
omar	omar
sumatra	sumatra
tabako	tobacco
minus	minus
ming	ming
obj	obj
learning	learning
undef	undef
magpakita	show
romulo	romulo
manhattan	manhattan
sermon	sermon
bulletin	bulletin
paco	paco
command	command
kennedy	kennedy
files	files
paggasta	expenditure
ibaraki	ibaraki
atlas	atlas
cola	cola
luigi	luigi
abdul	abdul
ulus	ulus
tamil	tamil
headquarters	headquarters
batanes	batanes
miriam	miriam
wong	wong
neon	neon
huang	xun
huang	huang
sirkulasyon	circulation
czechoslovakia	czechoslovakia
bulgaria	bulgaria
zoroastrianismo	zoroastrianism
herodes	herod
alala	worry
alala	worried
pagpunta	going
cmd	cmd
bond	bond
tiger	tiger
pinaikling	abbreviated
yokohama	yokohama
commerce	commerce
shall	shall
lila	purple
lila	lila
mapapansin	noted
madoka	madoka
agila	eagle
htm	htm
although	although
kristal	kristal
inayos	fixed
karibal	rival
karibal	rivals
elaeocarpus	elaeocarpus
malupit	cruel
helianthus	helianthus
positive	positive
tacloban	tacloban
troy	troy
pamana	heritage
royalty	royalty
letters	letters
salot	plague
salot	epidemic
pagtutuli	circumcision
shaman	shaman
aviv	aviv
hockey	hockey
shot	shot
trak	towing
trak	truck
nationwide	xfinity
bahagya	hardly
bahagya	barely
bahagya	slightly
tumawag	call
bubuyog	bees
bubuyog	bee
fujiwara	fujiwara
fungi	fungi
musa	musa
zamora	zamora
gallery	gallery
buwaya	crocodile
buwaya	crocodiles
joy	joy
kapareho	similar
mila	mila
transgender	transgender
lukas	lukas
milk	milk
binabago	modifying
vocal	vocal
pangangaso	hunting
sinasadyang	accidentally
sinasadyang	accidental
sinasadyang	intentionally
pagpipilian	choice
rene	rene
dakota	dakota
ralph	ralph
medya	thirty
edge	edge
flora	flora
magkakahiwalay	individually
akademikong	academic
caribbean	caribbean
orchestra	orchestra
temporal	temporal
harrison	harrison
settlement	settlement
utc+	utc+
cbs	cbs
mississippi	mississippi
mori	mori
cerro	cerro
fuentes	fuentes
antigens	antigens
kapal	shameless
kapal	thickness
turn	turn
pamilyar	familiar
pagdami	escalation
tuwiran	indirectly
kagoshima	kagoshima
euclidean	vector
tambol	drum
pagdadala	delivery
pagdadala	smuggling
pagdadala	shipping
madagascar	madagascar
libing	burial
libing	funeral
edmund	edmund
utah	utah
columbus	columbus
nakakaranas	experiencing
leonard	leonard
nagkakahalaga	valued
tali	rope
suk	suk
syriac	syriac
lev	lev
magdala	bring
matsumoto	matsumoto
pacquiao	pacquiao
payagan	allow
tract	tract
strip	strip
madrigal	madrigal
detroit	detroit
nariño	nariño
variety	variety
binagong	amended
chiang	chiang
tigil	stopping
tigil	stop
pagtatanggal	deletion
pagtatanggal	removal
holmes	holmes
aichi	aichi
parke	parks
neumann	neumann
willie	willie
josephine	josephine
karugtong	extended
kuala	kuala
monthly	monthly
mon	mon
xavier	xavier
parin	still
parin	parin
suwesya	syria
suwesya	sweden
paghahatid	transmission
paghahatid	delivery
belt	belt
basa	wet
lobong	parietal
masigasig	enthusiastic
masigasig	motivated
apog	limestone
pagbati	wishes
pagbati	greetings
pagbati	greeting
cameroon	cameroon
tumatawag	caller
tumatawag	calling
katatagan	stability
karboniperoso	carboniferous
agos	flowing
luz	luz
subic	subic
massa	massa
panghuli	ultimate
francesco	francesco
nabawasan	decreased
nabawasan	reduced
bahá	bahá
noel	noel
aayos	fixing
aayos	adjustments
aayos	organizing
dick	dick
anton	anton
nagasaki	nagasaki
heights	heights
somalia	somalia
nbc	nbc
hiroshima	hiroshima
curtis	curtis
polusyon	pollution
kapitbahay	neighbors
kapitbahay	neighbor
hispano	hispano
nakatutok	dedicated
nakatutok	focused
steven	steven
istanbul	istanbul
macabeo	maccabees
issues	multicultural
emedicinesubj	emedicinesubj
nakaayos	configured
nakaayos	sorted
lit	lit
everest	everest
jerome	jerome
mikoto	mikoto
anchor	anchors
anchor	anchor
axis	axis
beast	beast
fiesta	fiesta
barack	barack
ratchasima	ratchasima
evangelion	evangelion
roster	roster
sheikh	sheikh
mia	mia
ipahayag	announce
ipahayag	express
ipahayag	declare
makatwirang	reasonable
gini	gini
instruksiyon	instruction
gonzalez	gonzalez
kamukha	lookalike
viz	viz
luma	old
oregon	oregon
ultimate	ultimate
yale	yale
pagtigil	cease
yolanda	yolanda
akita	akita
moda	fashion
brain	brain
espn	espn
claudius	claudius
kalinangang	nok
samoa	samoa
piloto	pilot
pundasyong	foundation
rosalinda	rosalinda
sui	sui
pagkakahati	breakdown
mao	mao
bali	bali
bali	fracture
nars	nurses
nars	nurse
nars	nanny
pagboto	voting
cia	cia
tagapagtanggol	advocate
amo	boss
natutunan	learned
kuwait	kuwait
itatag	establish
summit	summit
matuklasan	discover
context	context
makatanggap	receive
nakaupo	sitting
kastilyo	castle
patent	patent
slam	slam
magnetic	magnetic
tiya	aunt
cha	cha
mozambique	mozambique
kasaganaan	prosperity
taglagas	autumn
taglagas	fall
nagsusuot	wear
panggagahasa	rape
gonzaga	gonzaga
françois	françois
caesarea	caesarea
tiago	tiago
nato	nato
dale	dale
gate	gate
bula	bubbles
bula	foam
soon	soon
athina	athina
eugenio	eugenio
eugenio	eugene
kawanihan	bureau
bokan	bokan
orlando	orlando
latina	latina
asuka	asuka
tagapamagitan	moderator
tagapamagitan	mediator
awtonomong	autonomous
mister	mister
magpakasal	marry
blason	blason
angola	angola
syrian	syrian
haru	haru
aomori	aomori
giant	giant
bawasan	trim
bawasan	reduce
bawasan	decrease
lightsteelblue	lightsteelblue
magnitude	magnitude
giuseppe	giuseppe
tigre	tiger
ipinasok	input
ipinasok	inserted
miki	miki
tuberculosis	tuberculosis
phone	phone
baghdad	baghdad
duel	duel
konduktor	conductor
thermal	thermal
pangkalakal	commercial
mole	mole
tora	tora
sinulid	thread
suka	vinegar
suka	vomit
albania	albania
kontrolin	control
regal	regal
led	led
configuration	configuration
agoncillo	agoncillo
gates	gates
forbes	forbes
matapat	truthful
matapat	honestly
matapat	honest
trapiko	traffic
nagbabawal	prohibits
ferrer	ferrer
concepción	concepción
sabaw	soup
sabaw	broth
paikot	radial
ruben	ruben
leopoldo	leopoldo
pal	pal
paradise	paradise
bianca	bianca
lampas	beyond
dewey	dewey
magnanakaw	burglar
magnanakaw	thief
download	download
download	downloads
nagtataguyod	advocating
nagtataguyod	promotes
wii	wii
warriors	warriors
doble	double
mammalia	mammalia
cynthia	cynthia
montreal	montreal
ini	ini
supply	supply
teresita	teresita
respeto	respect
britannica	britannica
quebec	quebec
romantiko	romantic
nicomedia	nicomedia
bernal	bernal
lapid	lapid
miyagi	miyagi
italic	italic
gfdl	gfdl
classic	classic
lepton	lepton
apektado	affected
shizuoka	shizuoka
inline	inline
tessie	tessie
copenhagen	copenhagen
plataporma	platform
alumni	alumni
lumalaking	growing
paghawak	handling
scottish	scottish
emblem	emblem
tadhana	destiny
canal	canal
kasabihan	sayings
kasabihan	proverb
gulo	mess
gulo	confrontation
gulo	slash
alba	alba
midnight	midnight
aki	aki
halal	halal
harvick	harvick
fusion	fusion
mcdonald	mcdonald
cortex	cortex
keys	keys
sumagot	respond
sumagot	replied
sumagot	reply
sumagot	responded
nagpakilala	introduced
paalala	reminder
impeachment	impeachment
ahmad	ahmad
integrated	integrated
manirahan	reside
selyo	postage
patricia	patricia
demand	demand
teacher	teacher
hawakan	handle
hawakan	touching
hawakan	hold
nanumpa	sworn
pahalang	horizontal
maximus	maximus
digit	digits
digit	digit
athletic	athletic
metapisika	metaphysics
donasyon	donation
donasyon	donations
heinrich	heinrich
stack	stack
quarter	quarter
ipinapalagay	assumed
grado	grades
buddy	buddy
ipagtanggol	defend
ipagtanggol	defence
disk	disk
georgian	georgian
mat	mat
minsa	sometimes
marinig	hear
quest	quest
mixed	mixed
mortal	mortal
matugunan	meet
nagamit	used
dublin	dublin
tinamaan	hit
malusog	healthy
natutulog	sleeps
natutulog	sleeping
ernst	ernst
sarangani	sarangani
negima	negima
panggatong	firewood
pagbaybay	spelling
titan	titan
moske	mosques
ground	ground
yap	yap
dagdagan	increase
virtual	virtual
ran	ran
esperanto	esperanto
pagsasayaw	dancing
antiochus	antiochus
josh	josh
cpu	cpu
educational	educational
kuweba	cave
maine	maine
paputok	fireworks
león	león
enriquez	enriquez
nerbiyos	nervousness
nerbiyos	nerves
digits	digits
bandalismo	graffiti
bandalismo	vandalism
parker	parker
interwiki	interwiki
hardware	hardware
hugo	hugo
toledo	toledo
amado	amado
kenneth	kenneth
iwate	iwate
anino	shadows
anino	shadow
anino	reflex
core	core
propesyon	profession
estadistikang	descriptive
silva	silva
piliin	select
formation	formation
formation	formations
orleans	orleans
malubha	severe
prague	prague
sira	broken
sison	sison
tinuruan	taught
sumasalamin	resonate
pumipigil	limiting
masigla	energetic
teologo	theologian
transition	transition
pagbomba	bombing
recent	recent
esteban	stephen
esteban	esteban
ishikawa	ishikawa
makinis	smooth
kodansha	kodansha
arc	arc
bug	bug
coalition	coalition
alien	alien
alien	aliens
walker	walker
denominasyon	denomination
oil	oil
pulbos	powder
pagpapatakbo	operational
zambia	zambia
owen	owen
bonus	bonus
trigo	wheat
kaliwanagan	clarity
banner	banners
banner	banner
spider	spider
nagkakaiba	differs
composer	composer
tang	tang
tōhoku	tōhoku
siko	elbow
moore	moore
pormang	trinitarian
sinusubukan	trying
sinusubukan	testing
pasulong	forward
nagpapatakbo	runs
alahas	jewelry
wasakin	destroy
xbox	xbox
marcelino	marcelino
creator	creator
oman	oman
aux	aux
path	path
otomo	otomo
doo	doo
sapin	strata
lea	lea
hell	hell
kyrgyzstan	kyrgyzstan
alternate	alternate
gorilla	gorilla
langaw	flies
rachel	rachel
corpus	corpus
bulak	cotton
aristotle	aristotle
tibetan	tibetan
palau	palau
honduras	honduras
wiktionary	wiktionary
aid	aid
hating	hating
uruguay	uruguay
magtatag	establish
movies	movies
maki	maki
aaron	aaron
magpatuloy	continue
magpatuloy	proceed
conrad	conrad
humarap	faced
mayayaman	rich
pilit	strained
sensei	sensei
pondong	fund
matalino	wise
matalino	clever
matalino	smart
charts	charts
connecticut	connecticut
hudson	hudson
pananatili	dwell
bote	bottle
katapangan	courage
hepburn	hepburn
badyet	budget
pagsuko	surrendering
click	click
click	clicks
percentage	percentage
lino	lino
lino	linen
lino	linus
lucy	lucy
sexy	sexy
emmy	emmy
candelaria	candelaria
kawani	staff
aus	aus
sinauna	music
kalinisan	hygiene
kalinisan	sanitation
membranong	mucous
lumipad	fly
lumipad	flown
lumipad	takeoff
romansa	romance
tuyo	dry
tuyo	dried
construction	construction
kopff	kopff
taliban	taliban
hubog	trained
stanley	stanley
nucleotide	nucleotide
edinburgh	edinburgh
jeong	jeong
shadow	shadow
oceania	oceania
lemmon	lemmon
aalala	concern
pageant	pageant
superior	superior
planta	plant
ella	ella
asahi	asahi
cooper	cooper
paggana	functionality
matanggap	receive
kakayanan	competence
lam	lam
glandula	glands
sayaka	sayaka
labintatlong	thirteen
anglo	anglo
fatima	fatima
botohan	polls
botohan	poll
lozada	lozada
ibenta	sell
geisha	geisha
gardens	gardens
timothy	timothy
pagkanta	singing
whole	whole
josue	joshua
soccer	soccer
buksan	open
katalan	catalan
sarado	closed
tab	tab
hwan	hwan
sword	sword
inaprubahan	approved
ekolohiya	ecological
ekolohiya	ecology
ekolohiya	computers
psp	psp
opus	opus
amanda	amanda
denver	denver
wikibase	wikibase
pinagsasama	combines
tatlumpung	thirty
isis	isis
kumbinasyon	combination
quote	quote
pagsasahimpapawid	broadcast
pagsasahimpapawid	broadcasting
premyo	prize
premyo	prizes
siksik	dense
jefferson	jefferson
tumutol	disputed
ebolusyong	divergent
driver	drivers
driver	driver
chūō	chūō
calabria	calabria
siberia	siberia
oportunidad	opportunities
dosis	dosage
dosis	dose
luke	luke
kulog	thunder
khmer	khmer
pornograpiya	pornography
pornograpiya	pornographic
electronics	electronics
winds	winds
sistematikong	systematic
gerald	gerald
raha	raja
donald	donald
gumalaw	move
gumalaw	stir
maestro	maestro
plantae	plantae
claus	claus
graphic	graphic
bukal	inherent
paumanhin	sorry
steel	steel
tiyuhin	uncle
rolando	rolando
etikal	ethical
dome	dome
claude	claude
honey	honey
ramirez	ramirez
meaning	meaning
nagbebenta	sell
nagbebenta	selling
nagbebenta	seller
earl	earl
pagpayag	approval
pagpayag	willingness
judy	judy
inuyasha	inuyasha
lumikas	evacuate
nagustuhan	liked
harris	harris
betty	betty
styles	styles
karayom	needles
makinarya	machinery
katherine	katherine
laden	laden
ridge	ridge
cinderella	cinderella
franchise	franchise
ragusa	ragusa
campo	campo
ezekiel	ezekiel
infanta	infanta
pantasya	fantasy
berkeley	berkeley
partial	partial
pagpoproseso	processing
#ff	#ff
baker	baker
inter	inter
pansit	noodles
kandila	candle
kandila	candles
bonaparte	bonaparte
kadiliman	darkness
akala	thought
akala	imagine
ernesto	ernesto
sites	sites
alone	alone
loki	loki
anu	anu
anu	what
anatolia	anatolia
wolfgang	wolfgang
split	split
vampire	vampire
bohr	bohr
tangent	tangent
ending	ending
margarita	margarita
hermes	hermes
eta	eta
jet	jet
panel	panels
panel	panel
pilot	pilot
diktador	dictator
smile	smile
burton	burton
vishnu	vishnu
designer	designers
carter	carter
pinal	final
pino	pino
pino	pine
lucky	lucky
kanto	corner
kanto	intersection
magtayo	build
bawang	garlic
saya	sorrow
saya	saya
saya	happiness
notre	notre
trial	trial
smiles	smiles
banayad	mild
gaia	gaia
tsubasa	tsubasa
isports	sports
glory	glory
financial	financial
naglalakad	walking
lunar	lunar
sinasakop	covers
naghihintay	waiting
botante	voter
produces	produces
toreng	tower
binabantayan	supervision
nyo	nyo
suborder	suborder
advertising	advertising
yesno	yesno
kinopya	copied
matuto	learn
salvi	salvi
income	income
selena	selena
hen	hen
penelope	penelope
matatapos	ends
matatapos	expire
matatapos	end
petty	petty
charity	charity
gunma	gunma
griffin	griffin
diwata	goddess
buwanang	monthly
span	span
provence	provence
tagapagbatas	legislature
holdings	holdings
nakararami	majority
hilario	hilario
nagsalita	spoke
pinapalitan	converts
furuta	furuta
cleveland	cleveland
prix	prix
jeanne	attacker
jeanne	jeanne
etimolohiya	etymology
boulevard	boulevard
kimiko	kimiko
mormon	mormon
niyebe	snow
mara	mara
hubble	hubble
megumi	megumi
pst	pst
wallace	wallace
lawin	hawk
janet	janet
accountancy	accountancy
kawad	wire
estate	estate
kurt	kurt
inihanda	prepared
warsaw	uprising
nagpapadala	sends
metabolismo	metabolism
kapatiran	brotherhood
nakulong	imprisoned
nakulong	trapped
jets	jets
baywang	waist
daisy	daisy
formula	formula
galilea	galilee
dub	dub
delporte	delporte
putol	slices
gabriela	gabriela
rugby	rugby
konstelasyon	constellation
jensen	jensen
punta	punta
ipatupad	implement
hatinggabi	midnight
deposito	deposit
easy	easy
sylvia	sylvia
imbento	invented
imbento	invention
photon	photon
tagapakinig	listener
tagapakinig	listeners
enzyme	enzyme
shirley	shirley
ultra	ultra
sibilisasyon	civilization
sibilisasyon	civilizations
westminster	westminster
praga	prague
kid	kid
lingua	lingua
gibraltar	gibraltar
sto	sto
touch	touch
gautama	gautama
lingayen	lingayen
dubai	dubai
emosyonal	emotional
emosyonal	emotionally
mexican	mexican
ciro	ciro
elepante	elephant
pandiwang	verbal
mananatili	remain
sport	sport
itago	hide
sunflower	sunflower
null	null
pete	pete
tekstuwal	textual
kalat	scattered
kalat	messy
kasu	joints
togo	togo
armstrong	armstrong
constitution	constitution
pagkakasulat	capitalisation
admiral	admiral
chu	chu
xiv	xiv
winasak	broke
lyon	lyon
iranian	iranian
richards	richards
homme	homme
jeremy	jeremy
foster	foster
ching	ching
nero	nero
tsokolate	cocoa
tsokolate	chocolate
napagmasdan	examined
masakit	painful
masakit	hurts
kahel	orange
flor	flor
memphis	memphis
nutrisyon	nutrition
nagpasiya	decides
hacienda	hacienda
crispa	crispa
kahaliling	alternate
yuan	yuan
config	config
joseon	joseon
carrara	carrara
deboto	devotee
prc	prc
montana	montana
falcon	falcon
nguyen	nguyen
dean	dean
tadyang	rib
fourth	fourth
kanino	whom
basil	basil
dolores	dolores
tommy	tommy
kaligayahan	happiness
candidate	candidate
levant	levant
delete	deleted
delete	delete
pagsikat	rising
ncaa	ncaa
pinasok	entered
hayti	haiti
yard	yards
paglulunsad	launch
hadith	hadith
pekeng	imitation
konserbatibo	conservative
effect	effect
talo	loser
palasyong	buckingham
nuoro	nuoro
astrolohiya	astrology
athletics	athletics
sumuporta	support
diocese	diocese
sibuyas	onions
sibuyas	onion
fighting	fighting
makakamit	achieve
itinalagang	designated
pambahay	household
ruby	ruby
mura	mura
mura	cheap
lata	tin
pansamantala	temporarily
pansamantala	temporary
pansamantala	tentative
datavalue	datavalue
ash	ash
hana	hana
ronnie	ronnie
pagkakaibigan	friendship
morong	morong
sicilia	sicily
nextel	nextel
maintindihan	understand
prizes	prizes
estratehiya	strategies
estratehiya	strategy
magkaibigan	friends
yano	yano
pakikisalamuha	socializing
abnormal	abnormal
mabait	kind
mabait	good
mabait	obedient
probinsya	province
turo	pointing
sinai	sinai
frances	frances
miyazaki	miyazaki
dam	dam
comments	comments
fantasy	fantasy
nararanasan	experiencing
nararanasan	encounter
boku	boku
pagtanda	ageing
deutsche	deutsche
fernández	fernández
pagbibilang	counting
secretarial	secretarial
pon	pon
republican	republican
ceo	ceo
stroke	stroke
idinisenyo	designed
eri	eri
makasalanan	sinful
makasalanan	sinner
makasalanan	sinners
chain	chain
palgrave	palgrave
hun	hun
hun	huns
kohoutek	kohoutek
kinokontrol	controlled
kinokontrol	controls
pusong	beats
pusong	rogue
pusong	clown
malabo	blurry
malabo	blurred
armenian	armenian
factory	factory
sunshine	sunshine
kumamoto	kumamoto
cortez	cortez
api	api
paleolitiko	paleolithic
reklamo	complaints
reklamo	complaint
yoko	yoko
cut	cut
tinitingnan	checking
tinitingnan	viewing
falls	falls
rutherford	rutherford
seconds	seconds
balot	wrapped
juda	juda
tapusin	finish
tapusin	end
tapusin	conclude
coco	coco
montes	montes
tiket	tickets
tiket	ticket
romulus	romulus
phi	phi
pagpapatayo	drying
naghahanda	preparing
semifinals	semifinals
sima	sima
ariel	ariel
knights	knights
euler	euler
siracusa	syracuse
tenga	ears
tenga	headphones
binuhay	raised
nickelodeon	nickelodeon
thompson	thompson
pasasalamat	gratitude
pasasalamat	thanksgiving
kasalan	marriage
kasalan	wedding
pamamaril	shooting
goodbye	goodbye
kaori	kaori
gasolina	fuel
gasolina	gasoline
humanap	finds
pagkakahawig	resemblance
sumakay	ride
sumakay	rode
reign	reign
publish	publish
publish	published
konektado	connected
geneva	geneva
mood	mood
puhunan	investment
architecture	architecture
ram	ram
cet	cet
kapakinabangan	usefulness
grey	grey
biyahe	trip
capitol	capitol
harbor	harbor
challenge	challenge
ichigo	ichigo
morris	morris
lehitimong	legitimate
makoto	makoto
banga	banga
vacant	vacant
parade	parade
pagmimina	mining
weekend	weekend
inuugnay	associating
inuugnay	connects
cyber	cyber
harina	flour
lantad	exposure
gamecube	gamecube
edgardo	edgardo
alternatibo	alternative
alternatibo	alternatives
ones	ones
conversion	conversion
tanghali	noon
tanghali	afternoon
magaspang	rough
ildefonso	ildefonso
tambalang	tandem
yeon	yeon
humina	weakened
marduk	marduk
combo	combo
jamaica	jamaica
negosyong	business
mirror	mirror
ligaya	happiness
mauritius	mauritius
natupad	fulfilled
bolivia	bolivia
coffee	coffee
coordinate	coordinate
coordinate	coordinates
tenerife	tenerife
singular	singular
osorkon	osorkon
idea	idea
shine	shine
komentaryo	commentary
mikhail	mikhail
salamangka	magic
processing	processing
dharma	dharma
egyptian	egyptian
balbal	slang
maeda	maeda
duet	duet
goals	goals
hinalal	elected
battles	battles
hokkien	hokkien
estonia	estonia
rovigo	rovigo
listahang	list
extension	extensions
extension	extension
hwang	hwang
komplikasyon	complication
komplikasyon	complications
porto	porto
sai	sai
jojo	jojo
lagay	tract
lyrics	lyrics
kalipa	caliph
enlil	enlil
chung	chung
kenny	kenny
hipon	shrimp
zhang	zhang
nida	nida
pittsburgh	pittsburgh
bronze	bronze
mask	mask
baltimore	baltimore
counter	counter
leroy	leroy
lotus	lotus
edo	edo
json	json
hiwaga	mysteries
nakakain	edible
marangal	noble
marangal	dignified
chopin	chopin
kongkreto	concrete
tapang	courage
less	less
planck	planck
mikroskopyo	microscope
phantom	phantom
christine	christine
ergaster	ergaster
mahayana	mahayana
ebolusyonaryong	evolutionary
nachi	nachi
torneo	tournaments
alvarado	alvarado
konsulado	consulate
aphrodite	aphrodite
garcía	garcía
ninakaw	stolen
magna	magna
pagtatrabaho	working
nakalista	listed
malik	malik
ladies	ladies
linnaeus	linnaeus
daytona	daytona
pagsamahin	merge
pagsamahin	combine
pagsamahin	merged
mandaragat	sailor
taxon	taxon
terorista	terrorist
pagdarasal	praying
dengeki	dengeki
tribunal	tribunal
itakda	set
wright	wright
numeric	numeric
usui	usui
gifu	gifu
romanization	romanization
candy	candy
tigdas	measles
komplikado	complicated
sense	sense
warrior	warrior
aalay	holds
sapa	cove
sapa	sapa
lara	lara
direct	direct
manchuria	manchuria
ekonomista	economists
abstract	abstract
jericho	jericho
uss	uss
ester	ester
ester	esther
donna	donna
thanh	thanh
turner	turner
ask	ask
kilometrong	kilometer
dai	dai
paquito	paquito
speech	speech
sagana	abundant
willy	willy
eve	eve
voiceless	voiceless
eiji	eiji
karma	karma
reperendum	referendum
liu	liu
wawa	wawa
agnes	agnes
nandito	here
ortega	ortega
binhi	seeds
coca	coca
danilo	danilo
pindutin	press
speaker	speaker
ichiro	ichiro
katapat	counterpart
sumpa	curse
wedding	wedding
bitak	cracks
wake	wake
nakakaalam	knows
mapabuti	improve
patellar	patellar
ionization	ionization
nakakamit	achieved
clarissa	clarissa
equivalent	equivalent
cap	cap
shear	shear
arezzo	arezzo
heswita	jesuits
patpat	stick
inalok	offered
mohammed	mohammed
mohammed	sharif
natanggal	deleted
mapayapang	peaceful
langgam	ant
langgam	ants
pietro	pietro
maxwell	maxwell
inchi	inchi
wings	wings
chun	chun
fushigi	fushigi
neptuno	neptune
worldwide	worldwide
maisagawa	perform
scholarship	scholarship
nalalapit	imminent
ppp	ppp
sepc	sepc
pusod	navel
buntala	comets
genoa	genoa
benz	benz
circa	circa
nominal	nominal
wanted	wanted
abaya	abaya
lenin	lenin
tinta	ink
mechanics	mechanics
sulo	torch
nationalist	nationalist
harvey	harvey
lives	lives
maihahambing	comparable
sensor	sensor
ayat	ayat
dolphy	dolphy
estimulasyon	stimulation
sigaw	shouting
portable	portable
nabucodonosor	nebuchadnezzar
frankfurt	frankfurt
pintura	paint
passing	passing
spin	spin
lua	lua
nasyonal	national
obligasyon	obligations
obligasyon	obligation
inakala	thought
nike	nike
diary	diary
iskedyul	schedule
maps	maps
princeton	princeton
rossi	rossi
ibc	ibc
vigan	vigan
pier	pier
suportado	supported
stockholm	stockholm
prostitusyon	prostitution
madlax	madlax
katuparan	realization
espirituwal	spiritual
cathy	cathy
pabilog	radial
tabak	sword
palestine	palestine
spot	spot
spot	spots
corps	corps
bethlehem	bethlehem
transfer	transfer
cosplay	cosplay
masiglang	buzzy
dilim	dark
multo	ghost
multo	ghosts
bipolar	bipolar
seksyon	section
pinaikli	shortened
ernest	ernest
malapad	wide
emilia	emilia
antiquark	antiquark
