amp	amp
แลป	ল্যাবে
แลป	ল্যাব
ขี้เหร่	কুৎসিত
พรีเมียม	প্রিমিয়াম
aru	আরু
uri	uri
uri	uri
เทด	টেড
มีดโกน	খুর
sophie	সোফি
ลูกเห็บ	শিলা
ลูกเห็บ	শিল
อุ้งเท้า	থাবা
อุ้งเท้า	পাও
อุ้งเท้า	থাবা
ลิปสติก	লিপস্টিক
ronaldo	রোনালদো
casa	কাসা
reptilia	reptilia
sos	এসওএস
ฮวา	hwa
อายัด	হিমায়িত
อายัด	আবদ্ধ
ซุซุ	জিউস
tabernaemontana	টগর
มุทะลุ	বেপরোয়া
สังเกตุ	বিজ্ঞপ্তি
สังเกตุ	খেয়াল
สังเกตุ	নোটিশ
visa	ভিসা
ขนตา	বেত
ddr	ddr
อาร์กิวเมนต์	আর্গুমেন্ট
uhf	uhf
crush	পিষে
crush	ক্রাশ
reg	reg
ซอฟแวร์	সফটওয়্যার
ซอฟแวร์	সফ্টওয়্যার
ocinsoutput	ocinsoutput
แฟนซี	অভিনব
เงินปันผล	লভ্যাংশ
alignbars	alignbars
concepts	ধারণাগুলি
smes	ছাড়া
skill	দক্ষতা
โลชั่น	লোশন
มอเตอร์เวย์	motorway
ลาเวนเดอร์	ল্যাভেন্ডার
ฟีด	ফিড
ฟีด	ফিড
บัซ	গুঞ্জন
บัซ	বাজ
viva	viva
viva	ভিভা
sql	sql
meshname	meshname
bodystyle	bodystyle
ตรรก	যৌক্তিক
ตรรก	লজিক্যাল
ตรรก	যৌক্তিক
ตรรก	লজিক
ตรรก	যুক্তি
lte	এলটিই
passive	প্যাসিভ
dao	দাও
pascal	প্যাসকেল
ขยะแขยง	বিরক্তিকর
ขยะแขยง	অসহ্য
ขยะแขยง	জঘন্য
kitty	কিটি
มัสตาร์ด	সরিষা
hood	হুড
autoconfirmed	autoconfirmed
ร่ำไห้	কাঁদো
alam	আলম
โปรไฟล์	প্রোফাইল
โปรไฟล์	বৃত্তান্ত
โปรไฟล์	প্রোফাইল
sais	sais
cheese	cheese
cheese	চিজ
จู๊ด	জুড
moe	মো
เบลโล	বেলো
เบลโล	বেল্লো
ing	ing
ctrl	ctrl
pac	প্যাক
nums	nums
รปภ	নিরাপত্তা
รปภ	সুরক্ষা
emma	এমা
หัวนม	নিপল
หัวนม	নিপল
หัวนม	স্তন
plc	পিএলসি
แล็ปท็อป	ল্যাপটপ
แล็ปท็อป	ল্যাপটপ
เบลก	ব্লেক
lucy	লুসি
gnis	gnis
กานพลู	লবঙ্গ
โป๊กเกอร์	পোকার
nfl	এনএফএল
lip	ঠোঁটের
lip	লিপ
lip	ঠোট
moss	মস
ปลอกคอ	কলার
โฮล์มส์	হোমস
ไมลส์	মাইলস
ไมลส์	মাইল
passeriformes	passeriformes
civic	নাগরিক
leiden	লাইডেন
tlc	টিএলসি
carmen	কার্মেন
ท็อปส์	টপস
ตื้นๆ	অগভীর
retval	retval
ลินซ์	লিঞ্চ
bce	অব্দে
คีท	কেইথ
คีท	কিথ
elephas	elephas
dubai	দুবাই
กระวนกระวาย	উদ্বিগ্ন
tao	টাও
tao	তাও
opentheme	opentheme
สวยๆ	সুন্দর
สวยๆ	সুন্দরী
สวยๆ	প্রশংসনীয়
สวยๆ	বেশ
sdtv	sdtv
ภาพยนต์	চলচ্চিত্র
ภาพยนต์	সিনেমা
ภาพยนต์	মুভি
ภาพยนต์	চলচ্চিত্র
ภาพยนต์	চলচ্চিত্রগুলি
ภาพยนต์	মুভি
cma	সিএমএ
spec	spec
asa	asa
rue	রু
mou	মৌ
นํ้า	পানির
นํ้า	পানিতে
นํ้า	পানি
นํ้า	জল
นํ้า	জলে
psr	psr
slim	পাতলা
slim	স্লিম
scaleminor	scaleminor
stp	stp
templatedata	templatedata
zonal	জোনাল
rft	rft
exp	exp
det	det
orientalis	orientalis
loaddata	loaddata
osprey	মাছমুরাল
directx	ডাইরেক্টএক্স
merriam	মেরিয়াম
รัดรูป	রুড
miocene	miocene
luca	লুকা
familycolor	familycolor
evergreen	এভারগ্রিন
ใคร่ครวญ	প্রতিফলিত
titleclass	titleclass
nic	নিক
rubiaceae	rubiaceae
คังนัม	গ্যাংনাম
rae	রে
tls	tls
wmf	wmf
idn	idn
ucla	ucla
เอทีเอ็ม	atm
omniglot	omniglot
นมวัว	গরু
sdn	sdn
เมนเฟรม	মেইনফ্রেম
จรจัด	ট্রাম্প
จรจัด	গৃহহীন
pizza	পিৎজা
pizza	পিজা
rem	rem
เซรามิค	সিরামিক
cis	সিআইএস
flop	ফ্লপ
nrt	nrt
bhd	bhd
cotton	তুলো
cotton	কটন
cotton	তুলা
cze	cze
ipod	ipod
emerg	emerg
setmetatable	setmetatable
ips	ips
ips	আইপিএস
ole	ওলে
domesticpartner	domesticpartner
chennai	চেন্নাই
peng	পেং
solaris	solaris
สุขารมณ์	hedonism
ดีซ่าน	জন্ডিস
บาร์บีคิว	কাবাব
บาร์บีคิว	কাবাব
hcl	hcl
baba	baba
baba	বাবা
เทียนไข	মোমবাতি
บู้	বুয়েট
บู้	বু
subfamilia	subfamilia
tidal	জোয়ারের
เพียซ	পিয়ার্স
pdp	পিডিপি
เมก	মেগ
shtml	shtml
sue	মামলা
emerald	পান্না
bas	bas
percussion	সঙ্ঘাত
แฮ็ค	হ্যাক
รีซ	রিজ
จอร์น	জন
plantae	plantae
lccn	lccn
oecd	ওইসিডি
subclassis	subclassis
disp	disp
ตูด	গাধা
ตูด	ass
ตูด	বাট
racer	রেসার
linecolor	linecolor
วิสกี้	হুইস্কি
วิสกี้	হুইস্কি
benth	benth
basestyle	basestyle
afp	এএফপি
ฟอร์แมต	বিন্যাস
ฟอร์แมต	ফরম্যাট
lycodon	lycodon
คิงสตัน	কিংস্টন
ไดร์ฟ	ড্রাইভ
lpg	এলপিজি
bacillus	bacillus
wifi	wifi
wifi	ওয়াইফাই
getcurrenttitle	getcurrenttitle
ambox	ambox
ipad	ipad
ipad	আইপ্যাড
สำลัก	চোক
cmos	cmos
เบรค	ব্রেক
เบรค	ব্রেক
ดอท	বিন্দু
ดอท	ডট
marksize	marksize
กลมๆ	গোলাকার
กลมๆ	রাউন্ড
mcdonald	ম্যাকডোনাল্ড
nist	nist
มัดจำ	ডিপোজিট
trigramme	trigramme
vhs	ভিএইচএস
asst	অ্যাসিস্ট
wikibooks	উইকিবই
alternativemap	alternativemap
อีเมล์	ইমেইল
อีเมล์	ইমেল
ไนลอน	নাইলন
ทะลึ่ง	নির্লজ্জ
lopez	লোপেজ
gre	gre
squalus	squalus
ลินช์	লিঞ্চ
datastyle	datastyle
apa	apa
ต้อกระจก	ছানি
ifpi	ifpi
gpa	জিপিএ
gpa	gpa
lightsteelblue	lightsteelblue
อินเตอร์เฟส	প্রেক্ষাপট
อินเตอร์เฟส	ইন্টারফেস
stardust	stardust
sao	সাও
aol	aol
ลอเรล	লরেল
perrow	perrow
factsheet	factsheet
ก๊าด	কেরোসিন
hon	hon
hon	হন
rss	আরএসএস
rss	rss
แบส	ব্যাস
ฝักบัว	গোসল
ฝักบัว	বর্ষণ
ฝักบัว	ঝরনা
ฝักบัว	শাওয়ার
ฝักบัว	বর্ষণ
คลัสเตอร์	ক্লাস্টার
คลัสเตอร์	গুচ্ছ
คลัสเตอร์	স্তবক
คลัสเตอร์	স্তবক
nom	নম
kmc	kmc
อีสุกอีใส	জলবসন্ত
อีสุกอีใส	pox
nano	ন্যানো
casting	ঢালাই
casting	কাস্টিং
iss	iss
bamboo	বাঁশ
nigra	nigra
miq	miq
gmail	মেইলার
gmail	জিমেইল
cyworld	cyworld
itf	আইটিএফ
geoffroy	geoffroy
byp	byp
เนด	নেড
เหยือก	মগ
เหยือก	কলসী
monobook	monobook
fips	fips
โปรโมชัน	প্রোমো
โปรโมชัน	প্রচার
โปรโมชัน	প্রমোশন
editpage	editpage
eka	eka
dodge	ডজ
citationclass	citationclass
อมยิ้ม	ললিপপ
yves	ইভস
actualuse	actualuse
ras	রাস
ras	ras
หกล้ม	দ্রুতগামী
อุ้งมือ	থাবা
sprint	স্প্রিন্ট
nyc	nyc
publicationdate	publicationdate
gee	গি
แพม	পাম
แพม	pam
จดจ่อ	নিবদ্ধ
australopithecus	অস্ট্রালোপিথেকাস
evo	ইভো
ทรัมป์	ট্রাম্পকে
ทรัมป์	ট্রাম
ทรัมป์	ভেরী
ทรัมป์	ট্রাম্প
timeshift	timeshift
ich	ich
bust	কপর্দকশূন্য
อรรถประโยชน์	উপযোগীতা
อรรถประโยชน์	ইউটিলিটি
อรรถประโยชน์	উপযোগীতা
อรรถประโยชน์	উপযোগ
rsa	rsa
ฮิบ	হিপ
metacritic	মেটাক্রিটিক
โบรกเกอร์	ব্রোকার
cms	cms
arp	arp
biz	বিজ
dude	দোস্ত
deutsch	deutsch
subpages	subpages
hotcat	hotcat
mont	মন্ট
svk	svk
ccccc	ccccc
เซสชัน	সেশন
เซสชัน	সেশন
capo	capo
บัดดี้	বাডি
itc	আইটিসি
infraordo	infraordo
naka	নাকা
พาธ	পথ
พาธ	পাথ
พาธ	পথের
ดุลยพินิจ	বিচক্ষণতা
คอมมูน	কমিউন
nds	nds
aac	aac
dia	দিয়া
adr	adr
util	util
globalsecurity	globalsecurity
kentucky	কেন্টাকি
imageright	imageright
ไฮไลต์	উজ্জ্বল
ไฮไลต์	হাইলাইট
ไฮไลต์	হাইলাইট
ลูกวัว	বাছুর
ซีรี่ส์	সিরিজ
ซีรี่ส์	ধারাবাহিক
longman	longman
ipc	আইপিসি
mah	mah
แชต	আড্ডা
แชต	চ্যাট
quis	quis
cfm	cfm
cccc	cccc
kew	kew
cwa	cwa
pardus	pardus
cambodge	cambodge
เสริฟ	এবাদত
เสริฟ	পরিবেশন
stadion	stadion
demospace	demospace
pog	pog
อืม	ভালো
อืม	ভাল
อืม	বেশ
อืม	ভালোভাবে
hdmi	hdmi
titlebackground	titlebackground
เธน	থানে
tel	তেল
ฟิค	fig
delle	delle
gam	gam
titleforeground	titleforeground
osama	ওসামা
japonica	japonica
อัลเฟร็ด	আলফ্রেড
nec	nec
nbsp	nbsp
halign	halign
nvidia	এনভিডিয়া
isi	isi
isi	আইএসআই
pubmed	pubmed
ส่วนลด	ছাড়
ส่วนลด	ডিসকাউন্ট
ส่วนลด	ছাড়
ค่าสัมบูรณ์	সুনিশ্চিত
ค่าสัมบูรณ์	সুনির্দিষ্ট
ค่าสัมบูรณ์	পরম
tung	টুং
arxiv	arxiv
csv	csv
gin	জিন
วัตถุนิยม	জড়বাদী
buttonlabel	buttonlabel
eco	ইকো
nida	নিদা
muay	মুই
เล้าโลม	শৃঙ্গার
amor	আমর
tis	তিস্তার
bayern	বায়ার্ন
ผิวปาก	বাঁশি
mis	mis
ใสๆ	ডো
amorphous	amorphous
shortsummary	shortsummary
ati	ati
gmbh	gmbh
psy	সাই
tnt	টিএনটি
eso	eso
ปฐมนิเทศ	দিশা
ปฐมนิเทศ	দিক
tam	tam
amadeus	amadeus
โบกมือ	ওড়ানো
โบกมือ	ঢেউ
โบกมือ	তরঙ্গ
อัลลอฮฺ	আল্লাহ্
อัลลอฮฺ	ভগবান
อัลลอฮฺ	আল্লাহ
อัลลอฮฺ	ঈশ্বর
lepus	lepus
มอซ	moz
dcdcdc	dcdcdc
subsid	subsid
harpercollins	harpercollins
ไลค์	মতো
ไลค์	লাইক
ไลค์	পছন্দ
ไลค์	মত
ไลค์	যেমন
domenico	ডোমেনিকো
ชอล์ก	খড়ি
ไฟแนนซ์	অর্থ
ไฟแนนซ์	অর্থব্যবস্থা
ไฟแนนซ์	ফাইন্যান্স
เฝือก	নিক
เฝือก	নিক্ষিপ্ত
เฝือก	কাস্ট
ppi	ppi
colstyle	colstyle
proc	proc
dbt	dbt
dcc	dcc
nicholson	নিকলসন
primer	প্রাইমার
bashkortostan	bashkortostan
const	const
mpv	mpv
mee	মি
vga	vga
scr	scr
บล็อค	ব্লক
บล็อค	স্তম্ভ
บล็อค	অবরুদ্ধ
proud	গর্ববোধ
proud	গর্বিত
proud	অভিমান
slr	slr
trend	ট্রেন্ড
trend	প্রবণতা
outlook	আউটলুক
outlook	outlook
lounge	লাউঞ্জ
บลูเบิร์ด	bluebird
trna	trna
gaon	গাঁও
checkuser	checkuser
meshnumber	meshnumber
มโนธรรม	বিবেক
มโนธรรม	বিবেকের
เหน็บแนม	উপহাস
ร้อนๆ	গরম
ร้อนๆ	hot
ร้อนๆ	হট
โรงนา	শস্যাগার
archiveurl	archiveurl
cena	সিনা
cena	সেনা
chrtitle	chrtitle
endtheme	endtheme
mgrtitle	mgrtitle
bcd	bcd
แปรงสีฟัน	টুথব্রাশ
dev	দেব
แล็ป	গবেষণাগার
แล็ป	ল্যাবরেটরি
แล็ป	ল্যাবে
แล็ป	ল্যাব
som	সোম
saurischia	সরিস্কিয়া
stm	stm
whitesmoke	whitesmoke
irq	irq
insight	অন্তর্দৃষ্টি
lyn	লিন
musashi	মুসাশি
formatdate	formatdate
gcc	জিসিসি
yugra	yugra
ซักรีด	লন্ড্রি
pcall	pcall
relegation	relegation
แฮก	ঠুকে
แฮก	হ্যাক
แฮก	hack
coo	সিওও
คูปอง	কুপন
hug	জড়িয়ে
hug	আদর
ราจ	raj
ราจ	রাজ
เย็นๆ	ঠান্ডা
เย็นๆ	ঠাণ্ডা
เย็นๆ	কোল্ড
pst	pst
dante	দান্তে
colhead	colhead
jelly	জেলি
jelly	জেলী
cassini	ক্যাসিনি
république	république
slip	স্লিপ
och	och
คนสวน	মালী
kawasaki	কাওয়াসাকি
backgroundcolors	backgroundcolors
สต๊อก	স্টক
sfsr	sfsr
aspergillus	aspergillus
pulp	পাল্প
doubleday	doubleday
fitzinger	fitzinger
sortkey	sortkey
งุนงง	ডেজ
metallicity	ধাতবতা
uni	uni
dab	dab
quicktime	quicktime
นมผง	ফর্মুলা
srb	srb
nulla	nulla
sevilla	সেভিলা
sevilla	সেভিয়া
subtemplate	subtemplate
nrc	nrc
seds	seds
wikibase	wikibase
isnotempty	isnotempty
swu	swu
philips	ফিলিপস
พุดดิ้ง	পুডিং
utrecht	utrecht
gainsboro	gainsboro
tsu	সু
mango	আম
kato	কাটো
uncollapsed	uncollapsed
rec	রেক
lightblue	lightblue
taxa	taxa
แรงๆ	পিটা
hina	হিনা
ordovician	অর্ডোভিশিয়ান
ติวเตอร์	টিউটর
ติวเตอร์	গৃহশিক্ষক
puma	পুমা
syed	সৈয়দ
giotto	giotto
hatnote	hatnote
caretta	caretta
โป๊ป	পোপ
ลมกรด	বর
ddd	ddd
kappa	কাপ্পা
voip	voip
rotterdam	rotterdam
pargs	pargs
mein	mein
sono	সোনো
coauthors	coauthors
filmfare	ফিল্মফেয়ার
grus	গ্রুস
confed	confed
ppt	পিপিটি
fern	ফার্ন
ไบเบิ้ล	বাইবেল
annales	annales
spam	স্প্যাম
spam	অযাচিত
เทอร์โมมิเตอร์	থার্মোমিটার
futbolme	futbolme
hangman	জল্লাদ
sis	সিস
sis	বোন
sis	বোনের
hendrik	হেন্ড্রিক
rina	রিনা
faa	faa
fanny	fanny
txt	txt
เลินเล่อ	অবহেলা
kabardino	kabardino
tdi	tdi
artistid	artistid
อ่างอาบน้ำ	গোসল
อ่างอาบน้ำ	বাথ
อ่างอาบน้ำ	স্নান
อ่างอาบน้ำ	গোসলের
checktype	checktype
atr	atr
dst	dst
aql	aql
abusefilter	abusefilter
burger	বার্গার
arkive	arkive
ucl	ucl
แท็ป	টোকা
คาร์ลอ	কার্ল
molly	মলি
ฮอง	হং
gimp	গিম্প
valentin	ভ্যালেন্টিন
schloss	schloss
isis	আইএসআইএস
isis	আইসিস
isis	isis
mistyrose	mistyrose
sampa	sampa
contribs	contribs
รังแค	খুশকি
แรนดัล	রান্ডাল
miniseries	miniseries
moments	moments
moments	মুহূর্ত
poj	poj
edda	edda
ceeb	ceeb
แม็ท	ম্যাট
hobby	হবি
hobby	শখ
datavalue	datavalue
sar	সার
sar	sar
deutschen	deutschen
ucs	ucs
willd	willd
plainlinks	plainlinks
mainz	mainz
เคอร์ฟิว	কারফিউ
funimation	funimation
เทท	টেট
thirteen	তেরো
vevent	vevent
leisure	অবকাশ
leisure	অবসর
ferromagnetic	ferromagnetic
münster	মন্সটার
alb	alb
ncc	এনসিসি
bbs	বিবিএস
geograph	geograph
unforgiven	আনফরগিভেন
pda	pda
pda	pda
pliocene	pliocene
neue	neue
eduardo	এদুয়ার্দো
eduardo	এডুয়ার্ডো
bing	বিং
iptv	iptv
mun	mun
atl	atl
bba	বিবিএ
bba	bba
stadio	stadio
bpm	bpm
skyblue	skyblue
deutsches	deutsches
ryū	ryū
centro	সেন্ট্রো
ria	রিয়া
imd	imd
pubchem	pubchem
tottenham	টটেনহ্যাম
tev	tev
dora	ডোরা
dora	dora
mime	মাইম
mime	mime
cong	কং
หนักๆ	হেভি
หนักๆ	ভারি
หนักๆ	ভারী
kao	কাও
std	এসটিডি
wolfram	wolfram
acta	acta
muller	muller
escherichia	escherichia
imax	imax
bung	বাং
archivedate	archivedate
kerry	কেরি
unhcr	ইউএনএইচসিআর
cups	কাপ
dnp	dnp
msnbc	এমএসএনবিসি
pong	পং
blink	পলক
sixteenth	ষোড়শ
magnet	চুম্বক
toon	টুন
nrhp	nrhp
bild	bild
gbp	gbp
cooh	cooh
bam	bam
bam	বাম
arthropoda	arthropoda
rvr	rvr
pocock	pocock
fet	fet
igf	igf
nct	nct
มัลแวร์	ম্যালওয়্যার
ora	ওরা
ora	ora
ucode	ucode
inst	inst
pax	প্যাক্স
gta	জিটিএ
nas	নাস
ups	ups
บอกใบ้	ইঙ্গিত
cod	কড
เคเบิ้ล	কেবল
เลขาฯ	সেক্রেটারি
เลขาฯ	সচিব
เลขาฯ	সেক্রেটারী
leben	leben
deutschland	deutschland
lisbon	লিসবন
tpe	tpe
haeckel	haeckel
topographic	topographic
tbm	tbm
เมี้ยว	মিউ
livre	livre
mbta	mbta
gesellschaft	gesellschaft
cdu	cdu
fernandez	ফার্নান্দেজ
kunth	kunth
transcluded	transcluded
mir	মির
mir	মীর
girard	girard
bismuth	বিসমাথ
michele	মিশেল
dickson	ডিকসন
taxoboxes	taxoboxes
nok	nok
apec	apec
ญาติๆ	আত্মীয়রা
ญาติๆ	আত্মীয়স্বজন
ญาติๆ	আত্মীয়দের
ญาติๆ	আত্মীয়
toolserver	toolserver
köln	köln
คูต	কুট
jalan	জালান
abovebelow	abovebelow
ชอปปิ้ง	শপিং
ชอปปิ้ง	কেনাকাটা
ชอปปิ้ง	বাজার
superfamilia	superfamilia
bom	বোম
dbd	dbd
uru	uru
noi	নোই
ksa	ksa
เบย	বেই
crocodylus	crocodylus
ไมโล	milo
งีบ	তন্দ্রা
งีบ	ঘুমিয়ে
ano	ano
ano	আনো
vim	ভীম
kirchner	কির্চনার
lour	lour
เปียนโน	পিয়ানো
trachypithecus	trachypithecus
collagen	কোলাজেন
prolog	prolog
sina	সিনা
sina	সিনার
sac	sac
pseudomonas	pseudomonas
ferreira	ফেরেইরা
ดินเนอร์	নৈশভোজ
ดินเนอร์	ডিনার
mazda	মাজদা
unabridged	unabridged
ไกส์	স্কাইপ
ไกส์	skype
mimi	মিমি
mimi	মিমির
กิลเลส	গিলেস্পি
nenets	nenets
avatar	অবতার
yaroslavl	yaroslavl
omim	omim
ssc	এসএসসি
ssc	ssc
fcb	fcb
pennsylvanian	pennsylvanian
อุทาหรณ์	টান
อุทาหรณ์	উপমা
moderne	moderne
ย่อมเยา	সাশ্রয়ী
ย่อมเยา	সাধ্যের
chitra	চিত্রা
เลอะเทอะ	অগোছালো
เลอะเทอะ	জগাখিচুড়ি
เลอะเทอะ	ঝামেলা
barincrement	barincrement
cta	cta
chapterurl	chapterurl
petite	petite
romaji	romaji
broker	ব্রোকার
continuum	অনবচ্ছেদ
ติดตลก	রসিক
ซิการ์	সিগার
adb	adb
ejective	ejective
valencian	valencian
postgrad	postgrad
henrik	হেনরিক
กระดิก	আন্দোলিত
hoang	হোয়াং
bafta	bafta
การขนส่งมวลชน	অতিক্রম
การขนส่งมวลชน	ট্রানজিট
loc	এলওসি
angiosperms	angiosperms
bonn	বন
เมกะเฮิรตซ์	mhz
sixteen	ষোল
oakland	ওকল্যান্ড
tensor	টেন্সর
emedicine	emedicine
oro	অরো
นู่	নূহ
กระเด้ง	বাউন্স
กระเด้ง	লাফানো
ขาอ่อน	উরু
ขาอ่อน	উরুর
ttl	টিটিএল
cristatus	cristatus
แชท	আড্ডা
แชท	চ্যাট
mcfarland	mcfarland
evenodd	evenodd
moo	মু
sma	sma
buryatia	buryatia
เอเย่นต์	এজেন্টের
เอเย่นต์	এজেন্ট
oed	oed
mississippian	mississippian
msu	msu
ตูส	স্টু
germplasm	germplasm
infraclassis	infraclassis
lemonchiffon	lemonchiffon
outdoor	আউটডোর
outdoor	বহিরঙ্গন
antineutrino	antineutrino
imc	imc
เปเป	পেপে
เปเป	পেরু
hodder	hodder
bodyguard	দেহরক্ষী
samba	সাম্বা
velit	velit
dreamworks	dreamworks
minimal	ন্যুনতম
csd	csd
eaba	eaba
viz	viz
casio	ক্যাসিও
özil	ওজিল
subunit	subunit
pur	পুর
gaba	গাবা
ช๊อค	শক
เตารีด	লোহা
เตารีด	লোহার
เตารีด	আয়রন
เตารีด	আর্গন
voc	voc
subphylum	subphylum
reine	reine
saya	সয়া
หวานๆ	মিষ্টি
หวานๆ	সুইট
หวานๆ	মধুর
หวานๆ	sweet
upn	upn
theropoda	থেরোপোডা
tuva	tuva
dunam	dunam
wikivoyage	উইকিভ্রমণ
mms	mms
lexikon	lexikon
vue	vue
consequat	consequat
vin	ভিন
gpp	gpp
เนธาน	নাথান
paleocene	paleocene
ops	ops
enim	enim
blackberry	ব্ল্যাকবেরি
tapirus	tapirus
oligocene	oligocene
bsc	বিএসসি
commuter	কমিউটার
cbn	সিবিএন
บังกะโล	বাংলো
บังกะโล	বাংলো
mps	mps
hrsg	hrsg
นิกิ	নিকি
rip	রিপ
rip	rip
diffusivity	diffusivity
muda	মুদা
สำส่อน	বেশ্যা
nsdap	nsdap
fila	fila
phasianidae	phasianidae
pang	পাং
ngn	ngn
nicky	নিকি
เบลิซ	বেলিজে
เบลิซ	বেলিজ
vojvodina	vojvodina
rdf	আরডিএফ
mita	মিতা
amr	amr
amr	আমর
truss	ট্রাস
catedral	catedral
joanna	জোয়ানা
iglesias	ইগলেসিয়াস
historiography	historiography
manutd	manutd
gmatch	gmatch
wmflabs	wmflabs
prec	prec
affricate	affricate
องคชาติ	শিশ্ন
hussain	হুসাইন
hussain	হুসেন
tempor	tempor
neanderthalensis	neanderthalensis
cng	cng
nail	পেরেকের
nail	পেরেক
nail	নেল
wimax	wimax
duis	duis
aes	aes
reina	রেইনা
afi	afi
kalmykia	kalmykia
csc	সিএসসি
เพลีย	ক্লান্ত
emporis	emporis
ffb	ffb
poptime	poptime
barnstar	barnstar
เด็บ	দেব
daw	daw
enwiki	enwiki
homme	homme
toho	তোহো
ether	ইথার
kwh	kwh
parserfunctions	parserfunctions
adv	adv
กยู	gyu
asturias	আস্তুরিয়াস
gadgets	গ্যাজেট
bund	bund
palacio	palacio
rutaceae	রুটেসি
pka	pka
lgbt	এলজিবিটি
hkg	hkg
taxobox	taxobox
nur	নূর
nazionale	nazionale
dictionnaire	dictionnaire
situ	situ
dprk	dprk
kendall	কেন্ডাল
sylvia	সিলভিয়া
esse	esse
openbsd	openbsd
scc	scc
pitta	শুমচা
ffi	ffi
antiquark	antiquark
oto	oto
highestsinglesranking	highestsinglesranking
campanulata	campanulata
civ	civ
vivo	ভিভো
careerprizemoney	careerprizemoney
doublesrecord	doublesrecord
currentnumber	currentnumber
treron	treron
sixty	sixty
sixty	ষাট
pskov	pskov
nzl	nzl
ซุปเปอร์มาร์เก็ต	সুপারমার্কেট
volvo	ভলভো
disambig	disambig
hpv	hpv
blainville	blainville
dylan	ডিলান
oldid	oldid
เปล่งปลั่ง	উজ্জ্বল
เปล่งปลั่ง	চকচক
leonhard	লিওনার্ট
milo	milo
varanus	varanus
เฮ้	এই
เฮ้	হেই
เฮ้	আরে
เฮ้	হে
nikon	নিকন
prk	prk
คอแห้ง	তৃষ্ণার্ত
nowiki	nowiki
shita	সিতা
ไพค์	পাইক
nyasaland	nyasaland
freenode	freenode
gerd	গের্ড
guilford	guilford
qam	qam
kari	kari
singlesrecord	singlesrecord
เดบิต	ডেবিট
chembox	chembox
humilis	humilis
snak	snak
nes	nes
plunkett	প্লাঙ্কেট
uptown	আপটাউন
ansi	ansi
soccerway	soccerway
เคอร์เซอร์	কার্সর
derm	derm
imo	imo
tenth	দশম
naa	naa
ymca	ওয়াইএমসিএ
adj	adj
motilal	motilal
xinhua	জিনহুয়া
primorsky	primorsky
getty	গেটি
สมิทธ์	স্মিথ
ทำครัว	রান্নাঘর
ทำครัว	কিচেন
bmj	bmj
rtl	rtl
rtl	আরটিএল
tnf	tnf
roundel	roundel
nativename	nativename
เบ็ท	বেথ
suomen	suomen
trump	ট্রাম্পকে
trump	ট্রাম
trump	ভেরী
trump	ট্রাম্প
othernames	othernames
pron	pron
nach	nach
mordovia	mordovia
syr	syr
columnwidth	columnwidth
bose	বোস
bose	বসু
kunst	kunst
sivan	সিভান
madagascariensis	madagascariensis
cero	সেরো
plainlist	plainlist
eutheria	eutheria
bbb	bbb
highestdoublesranking	highestdoublesranking
tif	tif
hoa	hoa
ฟินช์	ফিঞ্চ
kuw	kuw
navi	নাভি
hilton	হিল্টন
abdel	আবদেল
abdel	আব্দেল
swa	swa
ไฟร์เบิร์ด	ফায়ারবার্ড
regency	রিজেন্সি
clubnumber	clubnumber
texture	জমিন
suppressplaceholder	suppressplaceholder
sigurd	সিগার্ড
prestel	prestel
scn	scn
boomerang	boomerang
wikilinks	wikilinks
somethin	সামথিং
ksc	ksc
aldansky	aldansky
haliaeetus	haliaeetus
jeju	জেজু
clr	clr
eme	eme
epac	epac
โฮลท์	holt
mls	এমএলএস
uma	উমা
prionailurus	prionailurus
tem	tem
ดุค	ডিউক
sfc	sfc
asm	asm
ces	ces
soccernet	soccernet
origyear	origyear
preprocess	preprocess
consectetur	consectetur
fen	fen
italicized	italicized
sergio	সার্জিও
เฮ็ค	হেক
cwc	cwc
markus	লোকোমোটিভ
niosh	niosh
australianopenresult	australianopenresult
oliveira	অলিভেইরা
voluptate	voluptate
mus	mus
อาลิ	আলী
อาลิ	আলি
ลอตเตอรี่	লটারি
ipo	আইপিও
tms	tms
testudo	testudo
บริกส์	briggs
ฟรอสท์	ফ্রস্ট
ฟรอสท์	তুষার
func	func
lgpl	এলজিপিএল
เซจ	সেজ
koala	কোয়ালা
vlsi	vlsi
uwa	uwa
anura	অনূঢ়া
ทะนุถนอม	আগলে
grape	আঙ্গুর
wimbledonresult	wimbledonresult
usopenresult	usopenresult
vaginal	যোনির
blum	ব্লাম
photoshop	ফটোশপ
maggi	ম্যাগি
vit	ভিট
systema	সিস্টেমা
โฮลต์	holt
openoffice	openoffice
leno	লেনো
tui	tui
dra	dra
ว่างๆ	ফাঁকা
ว่างๆ	খালি
symphonic	সিম্ফোনিক
ontology	ontology
mentor	মেন্টর
สเต็ก	স্টেক
nep	nep
selena	সেলেনা
selena	সেলিনা
pauling	পাউলিং
ses	ses
chemspiderid	chemspiderid
pam	পাম
pam	pam
deadurl	deadurl
qaboos	কাবুস
khakassia	khakassia
publ	publ
merci	মার্সি
merci	merci
npt	এনপিটি
swat	সোয়াত
psg	পিএসজি
frenchopenresult	frenchopenresult
biol	biol
intermedius	intermedius
แม็ต	ম্যাট
aso	aso
postcode	পোস্টকোড
catalunya	catalunya
accelerometer	accelerometer
relax	আরাম
relax	শিথিল
nivea	nivea
imagecaption	imagecaption
tmp	tmp
noël	noël
chukotka	chukotka
wwii	wwii
coating	প্রলেপ
kcal	kcal
avi	avi
ริงโทน	রিংটোন
nhl	এনএইচএল
mariano	মারিয়ানো
rhs	rhs
glee	উল্লাস
concacaf	কনকাকাফ
czechia	czechia
icc	icc
icc	আইসিসির
icc	আইসিসি
pwa	pwa
เฝอ	ভের্গিল
github	গিটহাব
ยูนิฟอร์ม	ইউনিফর্ম
dhoom	ধুম
zim	zim
recherche	recherche
isr	isr
skyscraperpage	skyscraperpage
crs	crs
kuntze	kuntze
regex	regex
wav	wav
megan	মেগান
tay	tay
icu	icu
miley	মাইলি
ctx	ctx
mainsnak	mainsnak
labore	labore
petaurista	petaurista
moa	moa
bicornis	bicornis
anim	anim
zai	জাই
diaz	ডিয়াজ
แอ๊ปเปิ้ล	আপেল
tmf	tmf
gridcolor	gridcolor
sut	সুত
wmo	wmo
เทพพยากรณ์	ওরাকল
acp	এসিপি
fabricius	fabricius
villars	villars
presto	presto
sinh	sinh
cinerea	cinerea
mrc	mrc
cnet	cnet
rebels	বিদ্রোহী
rebels	বিদ্রোহীদের
rebels	বিদ্রোহীরা
ode	গাথা
bataille	bataille
comune	comune
msk	msk
uncia	uncia
scribner	scribner
maris	মারিস
ทรัมพ์	ট্রাম্পকে
ทรัมพ์	ট্রাম
ทรัมพ์	ভেরী
ทรัมพ์	ট্রাম্প
pokemon	পোকেমন
shy	লাজুক
clade	clade
setter	সেটার
longmans	longmans
cmyk	cmyk
ฉาวโฉ่	কুখ্যাত
ฉาวโฉ่	অখ্যাত
ฉาวโฉ่	কুখ্যাত
tezuka	তেজুকা
fab	fab
biomes	biomes
xxii	xxii
pty	pty
deutscher	deutscher
xxvi	xxvi
dall	dall
ier	ier
ultratop	ultratop
alsos	alsos
sourcebook	sourcebook
iffhs	iffhs
retroflex	মূর্ধন্য
nsa	এনএসএ
podiceps	podiceps
eget	eget
veniam	veniam
paradisi	paradisi
pvt	প্রাইভেট
kha	খা
cmr	cmr
reprehenderit	reprehenderit
fugiat	fugiat
pariatur	pariatur
wikimapia	উইকিম্যাপিয়া
taxonomic	taxonomic
qasim	কাসিম
qasim	কাশিম
qasim	কাসেম
notableworks	notableworks
esc	esc
hmg	hmg
pbk	pbk
banarsidass	banarsidass
swf	swf
ornithischia	অর্নিথিস্কিয়া
footballdatabase	footballdatabase
lexical	আভিধানিক
royaume	royaume
nasser	নাসের
abba	আব্বা
pneumoniae	pneumoniae
xxv	xxv
cpa	cpa
สะเพร่า	বেপরোয়া
สะเพร่า	সিক্ত
acd	acd
messagebox	messagebox
cbe	cbe
เซสชั่น	সেশন
เซสชั่น	সেশন
mubarak	মোবারক
mubarak	মুবারক
stratigraphy	স্ট্র্যাটিগ্রাফি
australasian	australasian
ics	ics
splendens	splendens
ubisoft	ইউবিসফট
igg	igg
tpl	tpl
afa	afa
rashomon	রাশোমোন
gareth	গ্যারেথ
cnc	cnc
msc	এমএসসি
iea	iea
elasmobranchii	elasmobranchii
หนาๆ	পুরু
zia	জিয়া
cindy	সিন্ডি
bur	বুর
phenol	ফেনল
ดรูว	ড্রিউ
phtml	phtml
chelonia	chelonia
recombination	recombination
อัลม่า	আলমা
ลอว์เรน	লরেন
cowboys	রাখাল
cowboys	কাউবয়
nhc	nhc
chatto	chatto
joshi	যোশী
hype	ছলনায়
โชโช	চো
vorbis	vorbis
deu	deu
higgins	হিগিন্স
waterhouse	waterhouse
supérieure	সুপেরিয়র
orientales	orientales
dth	ডিটিএইচ
fmt	fmt
amt	amt
แมช	ম্যাশ
modulo	modulo
mbe	mbe
sbk	হতে
userboxes	userboxes
oic	ওআইসি
jal	jal
ถูกๆ	সস্তা
iczn	iczn
wikipedians	উইকিপিডিয়ানরা
hydrolysis	hydrolysis
mouton	mouton
henrique	হেনরিকে
ฟอลส์	ফলস
ฟอลส์	জলপ্রপাত
unsc	unsc
udmurtia	udmurtia
weidenfeld	weidenfeld
nus	nus
coor	coor
unep	unep
pavo	pavo
แรนดอล	রান্ডাল
peerage	peerage
แอพพลิเคชัน	অ্যাপ্লিকেশন
แอพพลิเคชัน	অ্যাপলিকেশন
fifteen	পনের
fifteen	পনেরো
nia	নিয়া
นูร	নূহ
clh	clh
irst	irst
smr	smr
sassy	উচ্ছল
ปิกนิก	পিকনিক
ปิกนิก	বনভোজন
kamel	কামেল
zeitung	zeitung
ออสซี่	অসি
ashgate	ashgate
bjt	bjt
acad	acad
diaeresis	diaeresis
ผ้าดิบ	কাপড়
dunlop	ডানলপ
sle	sle
ชอล์ค	খড়ি
eighteenth	অষ্টাদশ
onca	onca
orthogonal	লম্ব
dope	আফিম
awm	awm
nei	nei
sheldon	শেল্ডন
เริงร่า	আনন্দময়
เริงร่า	আনন্দদায়ক
phaidon	phaidon
physique	physique
jawa	jawa
lune	lune
niu	niu
mauris	mauris
tiff	tiff
dts	dts
ponsonby	ponsonby
อัยย์	আইয়ুব
qualcomm	qualcomm
ceres	সেরেস
trf	trf
temminckii	temminckii
ไพธอน	python
ไพธอน	পাইথন
ไพธอน	অজগর
ดุ๊ค	ডিউক
latifolia	latifolia
audi	অডি
webcite	webcite
niche	niche
iupacname	iupacname
psc	psc
psc	পিএসসি
martinus	martinus
domesticus	domesticus
mura	মুরা
uup	uup
vertebrata	vertebrata
delisted	delisted
viaf	viaf
ker	ker
exec	exec
alimentary	alimentary
ldp	এলডিপি
schwarzschild	শোয়ার্জশিল্ড
cav	cav
bayan	বায়ান
turnedpro	turnedpro
fink	fink
sharma	শর্মা
อิตาลี่	ইতালী
อิตาลี่	ইটালি
อิตาลี่	ইতালি
wiltshire	wiltshire
json	json
มอร์ฟ	morph
worldstatesmen	worldstatesmen
incididunt	incididunt
aliqua	aliqua
mui	mui
compagnie	compagnie
mmc	mmc
อุกอาจ	ভয়ানক
subcat	subcat
sayyid	সৈয়দ
อัพเดต	নবায়ন
อัพเดต	আপডেট
leica	সিকা
toonopedia	toonopedia
praeger	praeger
macular	macular
aute	aute
pel	pel
เกษียน	অবসর
oma	ওমা
nbk	nbk
partof	partof
accreditations	accreditations
ทักซิโด	টাক্স
transclusion	transclusion
mcs	mcs
skype	স্কাইপ
skype	skype
pura	পুরা
soccerbase	soccerbase
nijhoff	nijhoff
pki	pki
priori	priori
mactutor	mactutor
กิกะไบต์	গিগাবাইট
nylon	নাইলন
xxvii	xxvii
ira	ইরা
softcover	softcover
vibrio	ভিব্রিও
openstreetmap	openstreetmap
hcard	hcard
mhnt	mhnt
xxxxx	xxxxx
kris	ক্রিস
hof	হফ
neues	neues
qid	qid
biophysics	biophysics
palustris	palustris
azur	azur
monocots	monocots
bloomsbury	bloomsbury
andrzej	andrzej
bundesarchiv	bundesarchiv
unrounded	unrounded
waleed	ওয়ালিদ
almanac	পঞ্জিকা
rainer	রাইনার
unk	unk
amoxicillin	এমোক্সিসিলিন
turku	টুর্কু
rpe	rpe
fip	fip
undulatus	undulatus
ngr	ngr
aum	aum
mmhg	mmhg
esm	ইএসএম
patrie	patrie
pcc	pcc
smalltext	smalltext
fqs	fqs
lautrec	লোত্রেক
glam	গ্ল্যাম
kaluga	kaluga
carlsson	কার্লসন
charan	চরন
charan	চরণ
oav	oav
ona	ona
afb	afb
gazetteer	gazetteer
philippensis	philippensis
สเปรดชีต	স্প্রেডশীট
earle	earle
uga	uga
onsoranje	onsoranje
logia	logia
heinrichs	heinrichs
eiusmod	eiusmod
rge	rge
คาโล	কার্লো
ambedkar	আম্বেদকর
exercitation	exercitation
หยง	ইয়ং
studien	studien
clp	clp
butyl	butyl
krause	krause
ceramic	সিরামিক
eines	eines
izmir	ইজমির
ผ้าเช็ดตัว	গামছা
ผ้าเช็ดตัว	তোয়ালে
officia	officia
deserunt	deserunt
patrimoine	patrimoine
tcl	tcl
mollit	mollit
laborum	laborum
divisio	divisio
ils	ils
harrassowitz	harrassowitz
mdt	mdt
otherparty	otherparty
suc	suc
jepson	jepson
hardback	hardback
tambov	tambov
riverside	রিভারসাইড
adipisicing	adipisicing
afg	afg
ferric	ferric
wayback	wayback
usgov	usgov
pau	পাউ
tribus	tribus
diy	diy
mila	মিলা
centropus	centropus
ferrer	ফেরের
dmca	dmca
balkaria	balkaria
kcb	kcb
indef	indef
อ้วก	বমি
vologda	vologda
usc	ইউএসসি
hno	hno
sinica	sinica
ruf	ruf
colwidth	colwidth
แย็บ	জাব
แย็บ	ঠেলা
uut	uut
daa	daa
cambridgeshire	cambridgeshire
farrar	farrar
mut	মুতা
mut	মুত
wikimarkup	wikimarkup
nyu	nyu
pbl	pbl
westview	westview
icrc	আইসিআরসি
arkhangelsk	arkhangelsk
regnal	regnal
psn	psn
griseus	griseus
xxiv	xxiv
gruyter	gruyter
asio	asio
remi	রেমি
brassica	brassica
physik	physik
sdk	sdk
cytomegalovirus	cytomegalovirus
nndb	nndb
polski	polski
ปันผล	dividend
lippincott	lippincott
