acm	acm
gym	vingrošanas
ncaa	ncaa
ช่ำชอง	lietpratēji
seventeen	seventeen
seventeen	septiņpadsmit
เซอร์ไพรส์	pārsteigums
เซอร์ไพรส์	pārsteigt
ars	ars
อาเมน	āmen
ฟลอเรส	floresas
เท็ต	teita
ความเฉื่อย	inerces
ฮาร์ป	arfa
แคลอรี่	kaloriju
แคลอรี่	kaloriju
แคลอรี่	kalorijas
โคมลอย	laternas
univ	univ
bdfutbol	bdfutbol
getparent	getparent
roca	roca
เป๊ะ	tieši
annie	annija
ucb	ucb
bella	bella
เมอร์ลิน	merlin
ตะเข็บ	šuvi
แชด	čadas
มูส	alnis
vpn	vpn
imagestyle	imagestyle
chelsea	chelsea
coin	monētas
coin	monēta
coin	monētu
หอน	šķēps
ทรัม	tramps
titan	titan
wet	slapjas
wet	slapjš
wet	mitra
หลงลืม	novārtā
เตาผิง	kamīns
บาร์บูดา	barbuda
อัลฟ่า	alfa
ขนมอบ	cepšanas
ขนมอบ	mīklas
สดๆ	svaiga
สดๆ	svaigas
สดๆ	svaigs
สดๆ	svaigi
เห็บ	blusas
ukr	ukr
crh	crh
mpa	mpa
prof	prof
หวีด	atskan
บรูก	bru
สวมรอย	purvi
บาร์เลย์	miežu
บาร์เลย์	mieži
ปู่ย่า	gran
ppp	ppp
funky	funky
aut	aut
อินเตอร์เน็ต	interneta
อินเตอร์เน็ต	internets
อินเดียนา	indiana
nikki	nikija
benz	benz
scalemajor	scalemajor
piaget	piažē
nocat	nocat
adsl	adsl
hdtv	hdtv
burton	burton
lcd	lcd
teamwidth	teamwidth
hay	siena
แอป	app
แอป	lietotnes
แอป	aplikāciju
แอป	aplikācijas
cid	cid
kfc	kfc
นกหวีด	atskan
นกหวีด	svilpes
ต้นคอ	kakls
ต้นคอ	kakla
sim	sim
amp	amp
blason	blason
แลป	laboratorijā
แลป	laboratorija
แลป	lab
ขี้เหร่	neglīts
พรีเมียม	piemaksas
พรีเมียม	piemaksa
พรีเมียม	prēmija
aru	aru
uri	uri
uri	uri
เทด	ted
pahs	pao
ชาร์ล็อตต์	šarlote
wikimania	wikimania
มีดโกน	razor
sophie	sofija
ลูกเห็บ	krusa
iro	iro
อุ้งเท้า	ķepām
อุ้งเท้า	ķepu
ronaldo	ronaldo
casa	casa
reptilia	reptilia
sos	sos
sos	sp
ssp	ssp
สังเกตุ	paziņojums
pgp	pgp
eddy	eddy
visa	vīzas
visa	vīzu
ขนตา	skropstu
ขนตา	skropstas
ขนตา	skropstu
symphonie	symphonie
ddr	ddr
อาร์กิวเมนต์	argumentus
อาร์กิวเมนต์	argumenti
uhf	uhf
reg	not
reg	reģ
ซอฟแวร์	programmatūru
ซอฟแวร์	programmatūra
ซอฟแวร์	programmatūrai
ซอฟแวร์	programmatūras
lancer	lancer
mda	mda
เงินปันผล	dividendes
mari	mari
อะเดล	adele
alignbars	alignbars
concepts	jēdzieni
concepts	koncepcijas
smes	mvu
skill	iemaņas
skill	prasmes
skill	prasme
skill	prasmju
sud	sud
โฮมเพจ	mājaslapa
โฮมเพจ	mājaslapā
มอเตอร์เวย์	autoceļa
มอเตอร์เวย์	autoceļš
ลาเวนเดอร์	lavandas
ฟีด	barības
ฟีด	barību
ฟีด	barībai
ฟีด	barība
ฟีด	baro
ฟีด	barība
viva	viva
sql	sql
bodystyle	bodystyle
ไปรษณียบัตร	pastkarti
ตรรก	racionālu
ตรรก	racionāli
ตรรก	racionāla
ตรรก	loģisks
ตรรก	loģiski
ตรรก	loģiskā
ตรรก	loģiku
ตรรก	loģika
ตรรก	loģikas
lte	lte
passive	pasīvā
passive	pasīvo
passive	pasīvi
passive	pasīvais
passive	pasīva
dao	dao
pascal	pascal
ขยะแขยง	pretīga
อาบแดด	sauļoties
burke	bērks
ปั๋ง	stāvošo
วิป	dzinējsuns
โลเวลล์	lowell
kitty	kitija
หลาบ	būvētavas
เต๋	teh
มัสตาร์ด	sinepes
มัสตาร์ด	sinepju
ดอกจิก	klubi
ดอกจิก	klubiem
ดอกจิก	klubos
hood	pārsegs
autoconfirmed	autoconfirmed
eur	eur
alam	alam
โปรไฟล์	profilu
โปรไฟล์	profila
โปรไฟล์	profils
โปรไฟล์	profili
ind	ind
linn	linna
clover	āboliņš
clover	āboliņa
cheese	siers
cheese	sieri
จู๊ด	jūda
wto	pto
perciformes	asarveidīgās
พอกพูน	akrēcijas
moe	moe
เบลโล	bello
turismo	turismo
ing	ing
pfc	pfc
pac	pao
sortable	sortable
nums	nums
ufc	ufc
requiem	rekviēms
รปภ	drošība
รปภ	drošības
elsevier	elsevier
emma	emma
หัวนม	krūtis
plc	plc
raven	krauklis
lorem	lorem
แล็ปท็อป	klēpjdators
lucy	lūsija
ordre	ordre
โป๊กเกอร์	pokera
nfl	nfl
lip	lūpas
lip	lūpu
moss	sūnu
ปลอกคอ	apmales
โฮล์มส์	holmes
ไมลส์	jūdzes
passeriformes	passeriformes
civic	pilsoniskās
leiden	leidenes
iec	iec
naruto	naruto
carmen	karmena
ท็อปส์	galotnēm
ตื้นๆ	sekla
retval	retval
หนองใน	gonoreja
mustela	mustela
ลอต	lota
ลินซ์	linčs
คีท	kīts
elephas	elephas
dubai	dubaijas
ทรัมเปต	trompete
กระวนกระวาย	satraukti
เหิร	lifti
tao	tao
gis	ģis
opentheme	opentheme
สวยๆ	skaists
สวยๆ	skaistas
สวยๆ	skaista
สวยๆ	skaisti
สวยๆ	skaistā
สวยๆ	diezgan
สวยๆ	smuka
สวยๆ	skaistas
sdtv	sdtv
ภาพยนต์	filma
ภาพยนต์	filmu
ภาพยนต์	filmas
ภาพยนต์	kino
spec	spec
asa	asa
rue	rūtas
ฉุบ	šķēres
mou	sm
นํ้า	ūdeni
นํ้า	ūdenī
นํ้า	ūdens
uprising	hunta
uprising	huntu
slim	slim
curry	karija
scaleminor	scaleminor
stp	stp
templatedata	templatedata
rft	rft
det	det
orientalis	orientalis
loaddata	loaddata
osprey	zivjērglis
directx	directx
merriam	merriam
รัดรูป	rads
miocene	miocēns
luca	luka
ตาชั่ง	skalas
ตาชั่ง	svari
familycolor	familycolor
ใคร่ครวญ	atspoguļot
ใคร่ครวญ	atspoguļo
titleclass	titleclass
mmorpg	mmorpg
nic	nic
ขวนขวาย	pelnīt
ขวนขวาย	pelna
ขวนขวาย	nopelnīt
ขวนขวาย	nopelna
คังนัม	gangnam
rae	rae
tls	tls
mtc	mtc
wmf	wmf
ucla	ucla
เอทีเอ็ม	atm
เอทีเอ็ม	bankomāti
wta	wta
omniglot	omniglot
นมวัว	govs
sdn	sdn
เมนเฟรม	lieldatoru
จรจัด	klaidonis
pizza	pizza
pizza	pica
pizza	picas
เซรามิค	keramika
เซรามิค	keramikas
เซรามิค	keramika
เซรามิค	keramikas
cis	cis
cis	ki
cis	nvs
cis	mis
flop	flop
thx	thx
bhd	bhd
cotton	kokvilna
cze	cze
ipod	ipod
ไซนัส	sinusa
setmetatable	setmetatable
hokusai	hokusai
ole	ole
chennai	čennai
solaris	solaris
ดีซ่าน	dzelte
comp	comp
hcl	hcl
baba	baba
ems	ems
เทียนไข	svece
เทียนไข	sveci
hoc	hoc
เก๊าท์	podagra
บู้	boo
eos	eos
tidal	plūdmaiņu
เพียซ	pīrss
pdp	pdp
เมก	meg
shtml	shtml
terme	terme
als	rl
als	als
als	ils
cites	cites
herre	herre
emerald	emerald
percussion	sitamie
จอร์น	džons
จำนอง	hipotēku
lccn	lccn
oecd	oecd
oecd	esao
disp	disp
ตูด	dibens
racer	racer
พลั่ว	lāpstas
พลั่ว	lāpstu
linecolor	linecolor
bodyslam	lmfao
วิสกี้	viskijs
วิสกี้	viskija
วิสกี้	viskijs
basestyle	basestyle
ฟอร์แมต	formāts
จิ๋ม	pussy
จิ๋ม	mīkstais
ไดร์ฟ	brauc
ไดร์ฟ	disks
ไดร์ฟ	braukt
ไดร์ฟ	vadīt
bacillus	bacillus
wifi	wifi
getcurrenttitle	getcurrenttitle
ambox	ambox
msv	msv
ipad	ipad
cmos	kto
gmelin	gmelin
เบรค	bremzes
เบรค	bremžu
เบรค	bremzēm
เบรค	bremzes
ดอท	dot
marksize	marksize
กลมๆ	apaļš
กลมๆ	apaļi
กลมๆ	kārta
กลมๆ	apaļa
mcdonald	mcdonald
nist	nist
มัดจำ	depozīts
มัดจำ	noguldījumu
vhs	vhs
kde	kde
asst	asst
wikibooks	wikibooks
alternativemap	alternativemap
ไนลอน	neilona
ปมด้อย	mazvērtības
lopez	lopesa
gre	gre
ลินช์	linčs
sato	sato
datastyle	datastyle
apa	apa
ต้อกระจก	katarakta
gpa	vpn
gpa	gpa
lightsteelblue	lightsteelblue
sauvage	sauvage
อินเตอร์เฟส	saskarne
stardust	stardust
sao	sao
aol	aol
ลอเรล	laurel
perrow	perrow
ยาสลบ	anestēzija
ก๊าด	petrolejas
rss	rss
aec	aec
แบส	bass
ฝักบัว	dušas
ฝักบัว	dušas
ปาโล	palo
คลัสเตอร์	kopa
คลัสเตอร์	kopas
tee	tējas
wittgenstein	vitgenšteins
geforce	geforce
อีสุกอีใส	bakas
nano	nano
casting	liešanas
iss	sks
bamboo	bambusa
nigra	nigra
gmail	gmail
เมดเลย์	sautējumu
itf	itf
geoffroy	geoffroy
มอลต์	iesala
มอลต์	iesals
เนด	ned
เหยือก	krūze
monobook	monobook
gprs	gprs
fips	fips
watt	vatu
โปรโมชัน	promo
โปรโมชัน	veicināšana
โปรโมชัน	popularizēšana
โปรโมชัน	veicināšanas
editpage	editpage
eka	eka
dodge	dodge
citationclass	citationclass
อมยิ้ม	ledenes
yves	yves
ซ้า	saab
universität	universität
ซอด	zods
amet	amet
ras	ras
ลีท	leits
อุ้งมือ	ķepām
sprint	sprints
nyc	nyc
publicationdate	publicationdate
mma	mma
panoramio	panoramio
ligne	ligne
แพม	pam
จดจ่อ	vērsta
จดจ่อ	mērķtiecīga
australopithecus	australopiteki
evo	evo
ทรัมป์	tramps
ich	ika
ich	ich
johan	johan
johan	johans
rsa	rsa
ฮิบ	hip
ฮิบ	gūžas
ฮิบ	gurnu
metacritic	metacritic
โบรกเกอร์	starpnieks
โบรกเกอร์	brokeri
โบรกเกอร์	brokeri
พาราฟิน	parafīna
arp	arp
biz	biz
dude	vecīt
dude	vecis
deutsch	deutsch
ต้อหิน	glaukomas
subpages	apakšlapas
หี	vāveri
hotcat	hotcat
pga	pga
mont	mont
เซสชัน	sesiju
เซสชัน	sesija
เซสชัน	sesijas
capo	capo
บัดดี้	draudziņ
antagonists	antagonisti
clays	māli
panasonic	panasonic
odbc	odbc
พาธ	ceļš
longus	longs
ดุลยพินิจ	ieskatiem
cochrane	cochrane
คอมมูน	commune
nds	nds
aac	aac
société	société
dia	dia
adr	sai
adr	adr
util	util
globalsecurity	globalsecurity
kentucky	kentuki
imageright	imageright
ไฮไลต์	uzsvēra
ไฮไลต์	uzsvērts
ไฮไลต์	izceltas
ไฮไลต์	izcelt
ไฮไลต์	uzsvērt
ไฮไลต์	uzsver
ไฮไลต์	izceļ
ลูกวัว	teļu
ซีรี่ส์	sērija
ซีรี่ส์	sērijas
longman	longman
aps	aps
แชต	chat
capensis	capensis
österreich	österreich
quis	quis
cfm	cfm
cccc	cccc
fps	fps
cwa	cwa
pardus	pardus
joker	džokers
เสริฟ	kalpot
เสริฟ	kalpo
demospace	demospace
pog	pog
bash	bash
อืม	labi
อืม	nu
hdmi	hdmi
titlebackground	titlebackground
ถาก	ganās
tel	tel
delle	delle
gam	gam
coco	kokos
titleforeground	titleforeground
osama	osama
japonica	japonica
อัลเฟร็ด	alfrēds
nec	nec
cdt	cdt
nbsp	nbsp
duomo	duomo
nvidia	nvidia
ส่วนลด	atlaide
ส่วนลด	atlaidi
ส่วนลด	atlaides
ค่าสัมบูรณ์	absolūtais
ค่าสัมบูรณ์	absolūtā
ค่าสัมบูรณ์	absolūts
tero	tero
xvi	xvi
hdl	abl
arxiv	arxiv
csv	csv
gin	džins
วัตถุนิยม	materiālisma
buttonlabel	buttonlabel
parc	parc
eco	eko
eco	eco
nida	nida
liebe	liebe
amor	amor
fernández	fernández
bayern	bayern
ผิวปาก	atskan
mis	mis
ใสๆ	stirna
saab	saab
amorphous	amorfas
anhalt	anhaltes
immunoglobulin	imūnglobulīnu
shortsummary	shortsummary
ati	ati
gmbh	gmbh
psy	psy
intl	intl
tnt	tnt
eso	edo
ปฐมนิเทศ	orientācijas
ปฐมนิเทศ	orientācija
africana	africana
amadeus	amadeus
ลงๆ	šūpoles
โบกมือ	viļņu
โบกมือ	vilnis
โบกมือ	viļņa
อัลลอฮฺ	dievs
württemberg	virtemberga
มอซ	moz
subsid	subsid
harpercollins	harpercollins
ไลค์	patīk
ไลค์	like
domenico	domeniko
ชอล์ก	krīts
เดนี	dani
ไฟแนนซ์	finansējums
ไฟแนนซ์	finansēšana
ไฟแนนซ์	finansējums
ไฟแนนซ์	finanses
ไฟแนนซ์	finanšu
เฝือก	lietos
berhad	berhad
colstyle	colstyle
proc	proc
uht	uht
dcc	dcc
nicholson	nicholson
jfk	jfk
bashkortostan	baškortostāna
rsu	rsu
fallax	fallax
vga	vga
scr	scr
บล็อค	bloku
บล็อค	blokam
บล็อค	bloka
บล็อค	bloks
บล็อค	bloķēt
บล็อค	bloķēti
บล็อค	bloķēta
บล็อค	bloķēts
proud	lepni
proud	lepna
slr	slr
ssri	ssai
บาดทะยัก	stingumkrampju
cfc	cfc
trend	tendence
outlook	perspektīvas
ลูปัส	lupus
squamata	zvīņrāpuļi
inflow	pieplūdes
lounge	lounge
gaon	gaons
checkuser	checkuser
beau	beau
มโนธรรม	sirdsapziņa
มโนธรรม	sirdsapziņu
มโนธรรม	apziņas
palatinate	pfalca
เหน็บแนม	ņirgāšanās
ร้อนๆ	hot
ร้อนๆ	karsts
ร้อนๆ	karsti
เงินผ่อน	finansējums
เงินผ่อน	finansēšana
erminea	erminea
hpa	hpa
โรงนา	šķūnis
archiveurl	archiveurl
arius	ārijs
ecu	ecu
bcd	bcd
dev	dev
แล็ป	laboratoriju
แล็ป	laboratorijā
แล็ป	laboratoriski
แล็ป	laboratorija
แล็ป	laboratorijā
แล็ป	laboratorija
แล็ป	lab
som	som
stm	stm
irq	irq
insight	ieskats
formatdate	formatdate
yugra	yugra
ซักรีด	veļas
ซักรีด	veļa
pcall	pcall
tyson	taisons
แฮก	hack
coo	coo
คูปอง	kuponu
ราจ	raj
เย็นๆ	saaukstēšanās
เย็นๆ	auksts
เย็นๆ	auksti
เย็นๆ	aukstā
เย็นๆ	aukstums
pst	pst
dante	dante
colhead	colhead
cassini	cassini
och	och
npv	npv
คนสวน	dārznieks
kawasaki	kawasaki
backgroundcolors	backgroundcolors
สต๊อก	krājums
สต๊อก	krājumi
สต๊อก	krājumu
sfsr	sfsr
aspergillus	aspergillus
pulp	mīkstums
pulp	celuloze
pulp	celulozes
doubleday	doubleday
voivodeship	vojevodiste
sortkey	sortkey
uni	uni
dab	dab
quicktime	quicktime
กระดก	krūze
agassiz	agasi
lac	lac
นมผง	formula
นมผง	formulas
srb	srb
nulla	nulla
sevilla	sevilla
nrc	nrc
wikibase	wikibase
isnotempty	isnotempty
andante	andante
aviator	aviator
philips	philips
gba	gba
utrecht	utrehtas
พาโล	palo
mango	mango
milne	milns
kato	kato
theodor	teodors
uncollapsed	uncollapsed
rec	rec
kbps	kbps
lightblue	lightblue
scopus	scopus
taxa	taksonu
แรงๆ	mīklā
ordovician	ordoviks
ติวเตอร์	pasniedzējs
puma	puma
giotto	giotto
โป๊ป	pāvests
interscope	interscope
ddd	ddd
kappa	kapa
voip	voip
rotterdam	roterdamas
pargs	pargs
mein	mein
teatro	teatro
coauthors	coauthors
mild	viegla
mild	viegls
mild	maiga
mild	vieglas
ลีต	leits
filmfare	filmfare
grus	grus
sco	sco
fern	papardes
ไบเบิ้ล	bībele
annales	annāļu
spam	spams
lite	lite
เทอร์โมมิเตอร์	termometru
honneur	honneur
schleswig	schleswig
hangman	karātavu
sis	sis
hendrik	hendrik
carpi	carpi
rina	rina
rta	rta
gts	gts
decca	decca
faa	faa
fanny	fanija
sartre	sartrs
txt	txt
เลินเล่อ	neuzmanības
kabardino	kabarda
tdi	tdi
อ่างอาบน้ำ	pirts
อ่างอาบน้ำ	vanna
checktype	checktype
ssl	ssl
streptococcus	streptococcus
atr	atr
mpc	mpc
dst	dst
abusefilter	abusefilter
anaerobic	anaerobā
arkive	arkive
แท็ป	krāna
คาร์ลอ	kārlis
archaeopteryx	arheopterikss
ฮอง	hong
gimp	gimp
valentin	valentīns
schloss	schloss
lindbergh	lindbergs
isis	isis
réunion	reinjonas
sampa	sampa
hist	hist
umts	umts
contribs	contribs
ไฟแช็ก	vieglāka
ไฟแช็ก	šķiltavas
wikiquote	wikiquote
bruxelles	bruxelles
województwo	województwo
moments	mirkļi
moments	brīžiem
moments	brīži
priming	kapseļu
แม็ท	met
hobby	hobijs
datavalue	datavalue
maison	maison
sar	sar
deutschen	deutschen
jojo	jojo
plainlinks	plainlinks
mainz	maincā
csa	csa
เทท	teita
thirteen	trīspadsmit
surrealism	sirreālisms
บารอมิเตอร์	barometrs
vevent	vevent
chapelle	chapelle
leisure	atpūtā
leisure	atpūta
münster	münster
île	ildefransa
ไลล์	lails
geograph	geograph
beats	sitas
ronda	ronda
unforgiven	nepiedots
pda	pda
aura	auras
pliocene	pliocēns
neue	neue
rosso	rosso
eduardo	eduardo
bing	bings
méxico	méxico
iptv	iptv
mun	mun
msm	mag
fef	fef
ambystoma	ambystoma
atl	atl
bba	bba
stadio	stadio
dagestan	dagestāna
fta	btn
nacl	nacl
olav	olav
italiana	italiana
skyblue	skyblue
latreille	latreille
deutsches	deutsches
fes	fes
ams	ams
centro	centro
radeon	radeon
wiesbaden	vīsbādenes
vitis	vitis
บางเบา	spalvas
nin	nin
innsbruck	insbruka
tottenham	tottenham
dora	dora
อ๊ะ	ups
mime	mime
firewire	firewire
peterson	peterson
หนักๆ	smags
หนักๆ	smagas
หนักๆ	smaga
หนักๆ	smagais
หนักๆ	smagi
หนักๆ	smago
birdman	birdman
std	std
wolfram	volframs
acta	acta
escherichia	escherichia
imax	imax
archivedate	archivedate
kerry	kerry
unhcr	unhcr
orchestre	orchestre
pars	pars
benn	benns
guerra	guerra
blink	blink
kanye	kanje
liner	čaulas
magnet	magnētu
nrhp	nrhp
bild	bild
courbet	kurbē
gbp	gbp
cooh	cooh
อุ๊ย	ups
dunk	dunk
bam	rpm
exodus	izceļošanas
arthropoda	arthropoda
rvr	rvr
pocock	pocock
lettres	lettres
igf	igf
nct	cnt
tabi	tabi
ora	ora
plosive	plosive
อัพเดท	atjaunināts
อัพเดท	atjaunināta
อัพเดท	atjaunināti
อัพเดท	atjaunots
pax	pax
gta	gta
nas	nas
ups	ups
cod	mencu
cod	menca
cod	mencas
cod	cod
เคเบิ้ล	kabeļi
เคเบิ้ล	kabeļu
เคเบิ้ล	kabelis
เลขาฯ	sekretāre
เลขาฯ	sekretārs
thyristors	tiristori
leben	leben
deutschland	deutschland
lisbon	lisabona
lisbon	lisabonas
lisbon	lisabonā
tpe	tpe
ptsd	posttraumatiskā
topographic	topogrāfiskajā
minna	minna
transliteration	transliterāciju
livre	livre
zita	zita
hort	horts
cdu	cdu
transcluded	transcluded
mir	mir
bismuth	bismuta
korn	korn
michele	michele
ochotona	ochotona
ตอแหล	muļķības
nok	nok
apec	apec
ญาติๆ	radinieki
ญาติๆ	radi
ญาติๆ	radiniekiem
salvelinus	salvelinus
toolserver	toolserver
köln	köln
hotspur	hotspur
zimmermann	zimmermann
église	église
abovebelow	abovebelow
ชอปปิ้ง	iepirkšanās
ชอปปิ้ง	iepirkties
siècle	siècle
เบย	bae
república	república
nucleotide	nukleotīdu
quantitative	kvantitatīvs
quantitative	kvantitatīvi
quantitative	kvantitatīvā
moctezuma	montesuma
dtv	dtv
kirchner	kirhners
เปียนโน	klavieres
collagen	kolagēna
prolog	prolog
ดอยช์	deutsche
slalom	slalomā
macbook	macbook
sac	sac
pseudomonas	pseudomonas
ferreira	ferreira
ดินเนอร์	vakariņas
mazda	mazda
ไกส์	skype
mimi	mimi
nenets	ņencu
avatar	avatars
yaroslavl	jaroslavļa
fcb	fcb
accademia	accademia
powerpc	powerpc
coe	coe
pennsylvanian	pennsylvanian
อุทาหรณ์	alegorija
wikinews	wikinews
moderne	moderne
dvořák	dvoržāks
nosferatu	nosferatu
เลอะเทอะ	nekārtību
barincrement	barincrement
taxon	taksona
chapterurl	chapterurl
fai	fai
petite	petite
broker	starpnieks
broker	brokeri
ติดตลก	asprātīgs
fia	fia
ซิการ์	cigāru
ejective	ejective
valencian	valensijas
ดรอป	piliens
ดรอป	nomest
rodentia	rodentia
electronegativity	elektronegativitāte
henrik	henrik
ouest	ouest
bafta	bafta
การขนส่งมวลชน	tranzīts
การขนส่งมวลชน	tranzīta
loc	loc
angiosperms	segsēkļi
bonn	bonnas
เมกะเฮิรตซ์	mhz
sixteen	sešpadsmit
galerie	galerie
glutamate	glutamāts
khabarovsk	habarovskas
oakland	oakland
tensor	tensor
emedicine	emedicine
oro	oro
ขาอ่อน	ciskas
ขาอ่อน	augšstilbi
ttl	ttl
shonen	shonen
แชท	chat
africanus	afrikānis
internazionale	internazionale
evenodd	evenodd
moo	moo
buryatia	burjatija
เอเย่นต์	aģents
เอเย่นต์	aģente
seurat	serā
mississippian	mississippian
ตูส	stjū
shockley	šoklijs
outdoor	āra
outdoor	sportot
polydor	polydor
intermedia	intermedia
influenzae	influenzae
imc	imc
เปเป	pepe
เปเป	peru
hodder	hodder
bodyguard	miesassargs
samba	samba
velit	velit
dreamworks	dreamworks
wikiversity	wikiversity
niloticus	niloticus
minimal	minimāls
minimal	minimāla
minimal	minimāli
ntsc	ntsc
viz	viz
özil	ezils
subunit	apakšvienība
pur	poliuretāna
gaba	gaba
ช๊อค	šoks
เตารีด	dzelzi
เตารีด	dzelzs
coturnix	coturnix
voc	gos
reine	reine
governorate	guberņa
göttingen	getingene
หวานๆ	saldais
หวานๆ	salds
หวานๆ	saldā
urs	urs
tyrosine	tirozīna
céline	selīna
dunam	dunams
wikivoyage	wikivoyage
mms	mms
lexikon	lexikon
dmc	dmc
montréal	montréal
vue	vue
consequat	consequat
spica	spica
vin	vin
webos	webos
gpp	gpp
humboldt	humbolta
nike	nike
เนธาน	neitans
paleocene	paleocene
ops	ops
nisi	nisi
degeneres	didženeresa
enim	enim
blackberry	kazeņu
โชคลาง	māņticīgi
marius	marius
tapirus	kabomani
oligocene	oligocene
bsc	bsc
regio	regio
hrsg	hrsg
นิกิ	niki
rip	rip
smtp	smtp
sus	sus
pedersen	pedersen
dag	dag
animenewsnetwork	animenewsnetwork
nsdap	nsdap
motogp	motogp
palermo	palermo
meryl	merila
เบลิซ	belizas
vojvodina	vojvodinas
buchholz	buholca
abbaye	abbaye
dukes	dukes
mita	mita
prc	ķtr
parque	parque
rondo	rondo
amr	amr
moma	moma
sachsen	sachsen
spielberg	spīlberga
เหยาะ	jao
catedral	catedral
hannover	hannover
joanna	joanna
iglesias	iglesias
mobygames	mobygames
augsburg	augsburga
spectabilis	spectabilis
gmatch	gmatch
wmflabs	wmflabs
primetime	primetime
affricate	affricate
zaw	zaw
องคชาติ	dzimumlocekļa
nsw	sidneja
tempor	tempor
neanderthalensis	neanderthalensis
acs	kv
nail	nagu
wimax	wimax
duis	duis
aes	aes
zum	zum
afi	afi
kalmykia	tatārijas
csc	csc
salvator	salvator
andersson	andersson
albin	albins
เพลีย	apnicis
เพลีย	noguruši
เพลีย	noguris
emporis	emporis
ffb	ffb
tpp	tec
apex	virsotne
enwiki	enwiki
homme	homme
toho	toho
adp	adf
adp	ada
pwr	pwr
helgi	helgi
catchment	sateces
ether	ēteri
ether	ēterī
kwh	kwh
tdma	tdma
ramanujan	rāmānudžans
parserfunctions	parserfunctions
tcm	tcm
กยู	kyu
asturias	astūrijas
asc	asc
bund	bund
palacio	palacio
série	série
eros	eross
lgbt	lgbt
hkg	hkg
icann	icann
rihanna	rihanna
nur	nur
nazionale	nazionale
bouvier	buvjē
dictionnaire	dictionnaire
situ	situ
dprk	ktdr
kendall	kendall
castelnau	castelnau
stripe	josla
stripe	strīpas
sylvia	silvija
esse	esse
wolfsburg	volfsburga
หลานๆ	mazbērni
หลานๆ	mazbērniem
mycobacterium	mycobacterium
xix	xix
agb	agb
openbsd	openbsd
dolce	dolce
highestsinglesranking	highestsinglesranking
gbr	gbr
civ	civ
thalberg	thalberg
buch	buch
truncatus	truncatus
careerprizemoney	careerprizemoney
bibcode	bibcode
opengl	opengl
บลูเบอร์รี	melleņu
doublesrecord	doublesrecord
mtb	mtb
currentnumber	currentnumber
consolidation	konsolidācija
fútbol	fútbol
pskov	pleskavas
nzl	nzl
ซุปเปอร์มาร์เก็ต	lielveikalos
ซุปเปอร์มาร์เก็ต	lielveikali
ซุปเปอร์มาร์เก็ต	lielveikalu
volvo	volvo
disambig	disambig
deus	deus
piedmont	pjemontas
clostridium	clostridium
phineas	fineass
psk	psk
hpv	hpv
dylan	dilans
oldid	oldid
pgm	pgm
mollis	mollis
puy	puy
analogues	analogi
laidlaw	laidlaw
varanus	varanus
เฮ้	hei
เฮ้	hey
nikon	nikon
prk	prk
sana	sana
nowiki	nowiki
ไพค์	līdaka
ไพค์	līdakas
freenode	freenode
gucci	gucci
gerd	gerds
qam	qam
kari	kari
singlesrecord	singlesrecord
naoh	naoh
หนึบ	lipīgs
flava	flava
snak	snak
hbv	hbv
ansi	ansi
soccerway	soccerway
wada	wada
เคอร์เซอร์	kursora
เคอร์เซอร์	kursors
prinz	princa
imo	imo
richelieu	rišeljē
tenth	desmitais
tenth	desmitā
naa	naa
roadster	rodsters
ymca	ymca
saku	saku
localisation	lokalizācijas
ssb	ssb
adj	adj
paix	paix
tunguska	tunguska
facies	fācija
สมิทธ์	smith
สมิทธ์	smits
ทำครัว	virtuve
ทำครัว	virtuves
sfr	sfr
rtl	rtl
vir	vir
suomen	suomen
trump	tramps
nach	nach
pteropus	pteropus
bose	bose
anchoring	nostiprināšana
kunst	kunst
madagascariensis	madagascariensis
cero	cero
plainlist	plainlist
eutheria	eutheria
bbb	bbb
highestdoublesranking	highestdoublesranking
tif	tif
todor	todor
kuw	kuw
earn	pelnīt
earn	pelna
earn	nopelnīt
earn	nopelna
kuni	kuni
navi	navi
hilton	hilton
abdel	abdel
ไฟร์เบิร์ด	firebird
wrc	wrc
regency	regency
lago	lago
texture	tekstūras
texture	konsistence
suppressplaceholder	suppressplaceholder
sigurd	sigurds
ota	ota
boomerang	bumerangs
stephan	stephan
wikilinks	wikilinks
haliaeetus	haliaeetus
zun	zun
monoamine	monoamīnoksidāzes
ovata	ovata
mls	mls
uma	uma
prionailurus	leopardkaķi
trofeo	trofeo
tem	tem
ดุค	hercogs
malayan	malajas
asm	asm
tres	tres
ces	ce
soccernet	soccernet
origyear	origyear
spiegel	spiegel
preprocess	preprocess
cheers	cheers
cheers	priekā
consectetur	consectetur
paradisaea	paradisaea
fen	fen
fen	purvs
sergio	sergio
markus	markus
markus	markuss
triomphe	triomphe
chanel	chanel
australianopenresult	australianopenresult
oliveira	oliveira
eazy	eazy
photoreceptor	fotoreceptoru
hermes	hermes
bernhard	bernhards
cbm	uvp
voluptate	voluptate
mus	mus
herrera	herrera
sven	svens
listn	listn
อาลิ	ali
kirov	kirovas
ลอตเตอรี่	loterijas
astrakhan	astrahaņas
ipo	ipo
ฟรอสท์	sals
func	func
lgpl	lgpl
römer	römer
เซจ	sage
koala	koala
cml	hml
forte	forte
anura	anura
grape	vīnogu
wimbledonresult	wimbledonresult
usopenresult	usopenresult
vaginal	maksts
photoshop	photoshop
maggi	maggi
bartolomeo	bartolomeo
gatsby	getsbijs
msx	msx
systema	systema
asn	asn
siluriformes	siluriformes
dsa	idi
openoffice	openoffice
leno	leno
antwerp	antverpenes
iis	iis
tui	tui
prostaglandin	prostaglandīna
prostaglandin	prostaglandīnu
ว่างๆ	brīvs
ว่างๆ	tukši
ว่างๆ	tukšs
ว่างๆ	tukšas
ว่างๆ	tukša
symphonic	simfoniskais
lse	lse
mentor	padomdevējs
mentor	vadītājai
nep	nep
selena	selēna
pauling	polings
ses	ses
pam	pam
deadurl	deadurl
eilers	eilers
publ	publ
swat	swat
cns	cns
psg	psg
frenchopenresult	frenchopenresult
biol	biol
intermedius	intermedius
แม็ต	met
aso	aso
catalunya	catalunya
accelerometer	akselerometru
relax	atpūties
relax	atpūsties
nivea	nivea
chelyabinsk	čeļabinskas
tmp	tmp
pes	pes
noël	noël
chukotka	čukotkas
coating	pārklājums
kcal	kcal
avi	avi
quagga	kvaga
shima	shima
dap	dap
nhl	nhl
csf	csf
csf	vss
mariano	mariano
rhs	rhs
bourgogne	burgundijas
concacaf	concacaf
loxodonta	loxodonta
icc	icc
icc	skt
lipase	lipāzes
nobilis	nobilis
masato	masato
natvar	natvar
aix	aix
github	github
โบนส์	kaulus
โบนส์	kauli
ยูนิฟอร์ม	vienādu
ยูนิฟอร์ม	vienoti
ยูนิฟอร์ม	vienāda
zim	zim
bfa	bfa
metabolite	metabolīts
metabolite	metabolītu
งงงวย	mulsina
selassie	selassie
wikispecies	wikispecies
isr	isr
chiaroscuro	chiaroscuro
regex	regex
wav	wav
megan	megana
hispano	hispano
miley	mailija
ctx	ctx
mainsnak	mainsnak
labore	labore
vitae	vitae
bicornis	bicornis
fazer	fazer
pyotr	pjotrs
sanguinea	sanguinea
diaz	diaz
amine	amīnu
himalayan	himalaju
xviii	xviii
แอ๊ปเปิ้ล	āboli
gridcolor	gridcolor
tid	tid
เทพพยากรณ์	oracle
cephalopoda	cephalopoda
landsat	landsat
bofors	bofors
fabricius	fabricius
presto	presto
cinerea	cinerea
awd	ssi
rebels	nemierniekiem
ode	oda
reds	sarkanie
regensburg	regensburgas
bataille	bataille
comune	comune
msk	msk
xxi	xxi
boydell	boydell
uncia	uncia
maris	maris
maris	māri
nami	nami
ทรัมพ์	tramps
ffk	ffk
pokemon	pokemonu
shy	kautrīgs
setter	noteicēju
longmans	longmans
arista	arista
polymerization	polimerizācijas
cmyk	cmyk
thuringia	tīringenes
ฉาวโฉ่	bēdīgi
ฉาวโฉ่	bēdīgi
könig	könig
xxii	xxii
tvm	tvm
deutscher	deutscher
xxvi	xxvi
bhr	bhr
dall	dall
ier	ier
zeit	zeit
horner	horners
showtopic	showtopic
alstom	alstom
sourcebook	sourcebook
pectoralis	pectoralis
pata	pata
galleria	galleria
iffhs	iffhs
retroflex	retroflekss
searchlight	searchlight
malthus	maltuss
balsam	balzams
eget	eget
veniam	veniam
pardalis	pardalis
spurious	neīstās
pvt	pvt
taiping	taipinu
allstars	allstars
cmr	cmr
reprehenderit	reprehenderit
fugiat	fugiat
pariatur	pariatur
vadis	vadis
ramón	ramón
rufa	rufa
chf	ssm
methuen	methuen
wikimapia	wikimapia
taxonomic	taksonomiskās
theresia	theresia
polaris	polaris
ciao	čau
zin	zin
esc	esc
smp	bit
athlon	athlon
inconnu	inconnu
oncorhynchus	oncorhynchus
mugen	mugen
uli	uli
allegretto	allegretto
footballdatabase	footballdatabase
mips	vic
mips	mic
cee	cee
crm	crm
artiodactyla	artiodactyla
hidalgo	hidalgo
abba	abba
pneumoniae	pneumoniae
xxv	xxv
dll	dll
aze	aze
cpa	cpa
messagebox	messagebox
lfc	lfc
persson	persson
เซสชั่น	sesiju
เซสชั่น	sesija
เซสชั่น	sesijas
seitz	zeics
girolamo	girolamo
splendens	splendens
ubisoft	ubisoft
igg	igg
afa	afa
cnc	cnc
msc	msc
iea	vea
militaire	militaire
punctatus	punctatus
elasmobranchii	elasmobranchii
หนาๆ	biezs
หนาๆ	biezas
หนาๆ	bieza
หนาๆ	biezi
magyar	magyar
cindy	sindija
phenol	fenolu
phenol	fenola
phenol	fenols
ดรูว	pievērsa
phtml	phtml
benedetto	benedetto
nmda	nmda
อัลม่า	alma
ลอว์เรน	lorēna
cowboys	kovboji
sergey	sergejs
chatto	chatto
aeronautical	aeronavigācijas
representativeness	pārstāvība
mwf	mwf
คาร์เนชั่น	neļķu
californica	californica
agrobacterium	agrobacterium
โชโช	cho
deu	deu
caco	caco
remixed	remixed
ocelot	geparda
higgins	higgins
verizon	verizon
strangelove	streindžlavs
waterhouse	waterhouse
oao	oao
maj	maj
sps	vms
supérieure	supérieure
rostov	rostov
fmt	fmt
lactobacillus	lactobacillus
amt	amt
แมช	misu
pdu	pdu
carolus	carolus
ramsar	ramsāres
limbata	limbata
userboxes	userboxes
opéra	opéra
ถูกๆ	lētas
ถูกๆ	lēts
ถูกๆ	lēta
ถูกๆ	lēti
wikipedians	wikipedians
hydrolysis	hidrolīze
hydrolysis	hidrolīzes
ฟอลส์	nokrīt
ฟอลส์	krīt
ฟอลส์	iekrīt
québec	québec
viperidae	viperidae
udmurtia	udmurtija
weidenfeld	weidenfeld
pavo	pavo
pilosa	nepilnzobji
peerage	pēra
activision	activision
osce	edso
jacobus	jacobus
tampere	tamperē
tampere	tamperes
แอพพลิเคชัน	piemērošana
แอพพลิเคชัน	piemērošanu
แอพพลิเคชัน	pieteikums
fifteen	piecpadsmit
postfix	postfix
certifications	sertifikācijas
certifications	apliecinājumi
universidad	universidad
tah	tah
macrophage	makrofāgu
étoile	étoile
typus	typus
machina	machina
sourceforge	sourceforge
ปิกนิก	piknika
ปิกนิก	pikniks
dbms	dbms
brigitte	brigita
fuck	fuck
zeitung	zeitung
gib	gib
ashgate	ashgate
ftv	ftv
