regency	리젠시
vos	vos
texture	텍스처
texture	질감
lcc	lcc
ota	ota
boomerang	boomerang
stephan	슈테판
somethin	somethin
ksc	ksc
jeju	제주
clr	clr
iguaçu	이구아수
mls	mls
ดุค	공작
ดุค	듀크
malayan	말레이
asm	asm
onsen	온천
tres	tres
dod	dod
ces	ces
cheers	힘내
roode	루드
sergio	세르지오
markus	마르쿠스
chanel	샤넬
eazy	eazy
hermes	헤르메스
mappings	매핑
sven	스벤
อาลิ	알리
อาลิ	ali
kirov	키로프
ลอตเตอรี่	복권
astrakhan	아스트라한
บริกส์	브릭스
ฟรอสท์	프로스트
ฟรอสท์	서리
koala	코알라
naver	네이버
shiki	시키
forte	포르테
ทะนุถนอม	소중히
grape	포도
docomo	docomo
photoshop	포토샵
msx	msx
ebook	전자책
leno	레노
antwerp	앤트워프
iis	iis
tui	tui
ว่างๆ	비어
ontology	온톨로지
mentor	멘토
ยกนิ้ว	엄지손가락
ยกนิ้ว	엄지
สเต็ก	스테이크
สเต็ก	스테이크
nep	nep
selena	셀레나
pauling	폴링
ses	ses
tyrol	티롤
pam	pam
swat	swat
swat	스와트
cns	cns
psg	psg
แม็ต	매트
catalunya	카탈루냐
tmp	tmp
rhineland	라인란트
coating	코팅
avi	avi
shima	시마
ริงโทน	벨소리
dap	dap
csf	csf
glee	글리
concacaf	concacaf
icc	icc
masato	마사토
aix	aix
github	github
turbofan	터보팬
ยูนิฟอร์ม	유니폼
fnc	fnc
crs	crs
wav	wav
megan	메건
megan	메간
icu	icu
gmp	gmp
atx	atx
hasbro	해즈브로
pyotr	표트르
diaz	디아즈
diaz	디아스
implementations	구현
แอ๊ปเปิ้ล	사과
เทพพยากรณ์	오라클
acp	acp
presto	프레스토
mrc	mrc
cnet	cnet
พิมพ์เขียว	blueprint
ddf	ddf
rebels	반군
rebels	반란군
reds	레즈
xxi	xxi
gonzo	gonzo
ทรัมพ์	트럼프
shy	부끄러워
shy	부끄러움
shy	부끄러운
gerry	제리
pty	pty
alstom	알스톰
pata	파타고니아
pata	파타
galleria	갤러리아
fns	fns
taiping	타이핑
taiping	태평
chf	chf
polaris	폴라리스
ciao	ciao
zin	팩터
esc	esc
smp	smp
hmg	hmg
athlon	애슬론
swf	swf
lexical	낱말
mips	mips
ktx	ktx
tos	tos
crm	crm
prada	프라다
abba	abba
dll	dll
cpa	cpa
กระเพื่อม	곡선
เซสชั่น	세션
เซสชั่น	세션
mubarak	무바라크
saitō	사이토
ics	ics
ubisoft	유비소프트
afa	afa
gareth	개러스
cnc	cnc
msc	msc
หนาๆ	두껍게
หนาๆ	두꺼운
cindy	신디
phenol	페놀
ดรูว	드류
ดรูว	드루
bgm	bgm
recombination	재결합
อัลม่า	alma
อัลม่า	알마
ลอว์เรน	로렌
cowboys	카우보이
คาร์เนชั่น	카네이션
hype	과장
vorbis	vorbis
higgins	히긴스
verizon	버라이즌
cdm	cdm
kiki	키키
pdu	pdu
tetsuya	테츠야
jal	일본항공
jal	jal
ฟอลส์	폭포
activision	액티비전
tampere	탐페레
แอพพลิเคชัน	애플리케이션
แอพพลิเคชัน	프로그램
แอพพลิเคชัน	어플리케이션
fifteen	열다섯
นูร	노아
comcast	컴캐스트
ปิกนิก	피크닉
ปิกนิก	소풍
brigitte	브리짓
gib	gib
ftv	ftv
angie	앤지
ผ้าดิบ	직물
dunlop	던롭
jbl	jbl
bernoulli	베르누이
dope	쩔어
sheldon	셸던
physique	체격
beatrix	베아트릭스
tiff	tiff
dts	dts
sncf	sncf
qualcomm	퀄컴
ไพธอน	python
ไพธอน	파이썬
tsr	tsr
ดุ๊ค	공작
ดุ๊ค	듀크
esprit	esprit
tyumen	튜멘
audi	아우디
niche	틈새
psc	psc
planar	평면
kazuki	카즈키
seki	세키
wetland	습지
umd	umd
vulgate	불가타
bayan	바얀
powerpoint	파워포인트
sharma	샤르마
อิตาลี่	이탈리아
json	json
snr	snr
hanabi	hanabi
mui	mui
gladys	글래디스
mmc	mmc
goodwill	친선
อัพเดต	갱신
อัพเดต	업데이트
เกษียน	은퇴
เกษียน	퇴직
voronezh	보로네시
skype	스카이프
กิกะไบต์	기가바이트
nylon	나일론
ira	ira
csm	csm
virgo	처녀자리
bryansk	브랸스크
ato	아토
postgresql	postgresql
pci	pci
ooo	ooo
turku	투르쿠
pcc	pcc
tva	tva
kaluga	칼루가
asroc	asroc
สเปรดชีต	스프레드시트
คาโล	카를로
cps	cps
krause	크라우스
ceramic	세라믹
ceramic	도자기
massa	마사
ผ้าเช็ดตัว	타월
ผ้าเช็ดตัว	수건
นอกชาน	테라스
tcl	tcl
ils	ils
oem	oem
pdb	pdb
riverside	리버사이드
astrophysical	천체물리학
bps	bps
diy	diy
msi	msi
piacenza	피아첸차
อ้วก	구토
fpga	fpga
lea	리아
lea	레아
บุฟเฟ่ต์	뷔페
valery	발레리
scala	스칼라
brics	브릭스
lavigne	라빈
cambridgeshire	케임브리지셔
คลัตช์	클러치
corot	corot
farrar	패러디
farrar	패러
acl	acl
stavropol	스타브로폴
schulze	슐츠
federalist	연방주의
poliomyelitis	소아마비
remi	레미
sdk	sdk
sdk	sdk
ปันผล	배당
emacs	이맥스
เท็ท	테이트
ihs	ihs
naoko	나오코
zexal	zexal
oryx	오릭스
ryazan	랴잔
kyiv	키예프
kddi	kddi
mems	mems
aic	aic
tga	tga
pct	pct
iberia	이베리아
cpp	cpp
blg	blg
furukawa	후루카와
ssd	ssd
อินเดียนาโปลิส	인디애나폴리스
staples	스테이플스
lublin	루블린
gtk	gtk
wir	wir
stc	stc
dac	dac
iaa	iaa
tft	tft
bmp	bmp
kostroma	코스트로마
transformer	트랜스포머
transformer	변압기
sgi	sgi
ผ้าปูที่นอน	시트
omni	옴니
gma	gma
grease	그리스
bmx	bmx
lol	ㅋㅋ
lol	ㅎㅎㅎ
lol	ㅋㅋㅋ
irkutsk	이르쿠츠크
howstuffworks	howstuffworks
wdm	wdm
esquire	에스콰이어
nlp	nlp
angelique	안젤리크
quantization	양자화
stovl	stovl
grb	grb
psv	psv
ebooks	전자책
คอมเมนท์	댓글
crusaders	크루세이더
sorrento	소렌토
motorsport	모터스포츠
nis	nis
mmx	mmx
lymphocyte	림프구
yangtze	양쯔강
unc	unc
nozomi	노조미
miu	miu
tomsk	톰스크
mci	mci
kimberley	킴벌리
hdr	hdr
cie	cie
netflix	넷플릭스
mentions	언급
nrw	nrw
tas	tas
vfl	vfl
โค้ท	외투
โค้ท	코트
จอส	조스
cpv	cpv
puebla	푸에블라
qantas	콴타스
demos	데모
cef	cef
ulyanovsk	울리야놉스크
แจ๊คพ็อต	대박
atf	atf
conf	conf
colossus	콜로서스
schmitt	슈밋
schmitt	슈미트
จอยส์	조이스
sawa	사와라
sawa	사와
dba	dba
gustaf	구스타프
oka	oka
oka	오카
โพลีเอสเตอร์	폴리에스테르
natal	나탈
condenser	콘덴서
wep	wep
posix	posix
lhs	lhs
issf	issf
osmium	오스뮴
adc	adc
smt	smt
tumblr	텀블러
เศร้าๆ	슬픔
เศร้าๆ	슬픈
เศร้าๆ	슬프다
icp	icp
jolly	졸리
macross	마크로스
ktv	ktv
pygmalion	피그말리온
wlan	무선랜
vlc	vlc
simbad	simbad
aam	aam
moor	무어
moor	무어인
adidas	아디다스
cbr	cbr
kpop	kpop
technologist	기술자
yum	냠냠
tokai	도카이
standardization	표준화
satoru	사토루
monza	몬차
calvados	칼바도스
segmentation	세그멘테이션
งามๆ	화려하다
งามๆ	이쁜
งามๆ	화려한
บ๋อย	종업원
บ๋อย	웨이터
josephson	조지프슨
udf	udf
saas	saas
slc	slc
ordinal	순서수
kidman	키드먼
susie	수지
โทนิค	토닉
fsb	fsb
alyssa	앨리사
microsystems	마이크로시스템즈
freelance	프리랜서
taguchi	다구치
fsf	fsf
reboot	리부트
โซลูชัน	해결책
โซลูชัน	솔루션
plutarch	플루타르코스
pharrell	퍼렐
รีเซ็ต	리셋
รีเซ็ต	초기화
โค๊ช	코치
csp	csp
glider	글라이더
แม๊กซ์	맥스
แม๊กซ์	막스
แม๊กซ์	최대
แม๊กซ์	max
fushigi	불가사의
marriott	메리어트
marriott	매리엇
bmc	bmc
silvia	실비아
hst	hst
dds	dds
brew	brew
ppc	ppc
buckinghamshire	버킹엄
tvq	tvq
tca	tca
sforza	스포르차
dreamcast	드림캐스트
scp	scp
ttc	ttc
jtbc	jtbc
fma	fma
selenium	셀레늄
bdsm	bdsm
grotto	동굴
authentic	정통
chocolat	쇼콜라
grenoble	그르노블
apod	apod
pps	pps
medina	메디나
ankara	앙카라
carolingian	카롤링거
ecm	ecm
hawks	호크스
spm	spm
sys	sys
isdb	isdb
พาราไดส์	파라다이스
พาราไดส์	천국
พาราไดส์	낙원
okamoto	오카모토
activex	activex
hitoshi	히토시
hbr	hbr
amc	amc
castilian	카스티야
silesia	실레시아
elliptic	타원
oldenburg	올덴부르크
asd	asd
cmi	cmi
rift	리프트
ccl	ccl
บิงโก	빙고
holic	holic
snp	snp
ฮิสทีเรีย	히스테리
stv	stv
probabilistic	확률적
waist	허리
marian	마리안
pls	pls
yttrium	이트륨
eula	eula
gummy	거미
rtm	rtm
rheinmetall	라인메탈
sag	sag
günter	귄터
ชารลส์	샤를
ชารลส์	찰스
dtm	dtm
hbc	hbc
darmstadt	다름슈타트
dma	dma
mss	mss
gnd	gnd
pavlov	파블로프
bale	베일
ats	ats
checksum	체크섬
metallurgy	금속공학
metallurgy	금속
armani	아르마니
ipu	ipu
ddp	ddp
vevo	vevo
cbd	cbd
pvp	pvp
woodstock	우드스톡
aborigines	원주민
pinckney	핑크니
vanadium	바나듐
smc	smc
thq	thq
secretion	분비
fyodor	표도르
bms	bms
upc	upc
vfb	vfb
alu	알루
dhcp	dhcp
mcp	mcp
constructor	생성자
eac	eac
อุ๊บ	oops
wtc	wtc
vazquez	바스케스
ปิคนิค	피크닉
ปิคนิค	소풍
cdp	cdp
galatasaray	갈라타사라이
avro	아브로
epik	에픽
nakanishi	나카니시
bitcoin	비트코인
svo	svo
พีรามิด	피라미드
czechoslovak	체코슬로바키아
dmx	dmx
bnp	bnp
สล๊อต	슬롯
คาร์ไลส์	칼라일
อัลเบิร์	알베르트
อัลเบิร์	앨버트
rts	rts
anz	anz
jms	jms
ginza	긴자
samarium	사마륨
warcraft	워크래프트
berne	베른
akc	akc
ytv	ytv
dep	dep
enclose	동봉
scarborough	스카보로
scarborough	스카버러
pronunciations	발음
vvv	vvv
hsl	hsv
hsl	hsl
tuner	튜너
dce	dce
khanate	칸국
sds	sds
bsp	bsp
soweto	소웨토
jsa	jsa
ssm	ssm
candu	candu
sdp	sdp
yekaterinburg	예카테린부르크
cdn	cdn
ยุ่งๆ	바쁜
ยุ่งๆ	바쁘다
ยุ่งๆ	바빠
rostock	로스토크
toshio	토시오
sgml	sgml
silverlight	실버라이트
ifc	ifc
แท็งค์	탱크
แท็งค์	전차
boinc	boinc
serbs	세르비아인
iib	iib
กระติก	매점
hok	hok
tartu	타르투
dha	dha
osijek	오시예크
scalar	스칼라장
scalar	스칼라
wycombe	위컴
คลัช	클러치
łódź	우치
cfr	cfr
cska	cska
อีไล	엘리
yuu	ㅠㅜ
grp	grp
coldplay	콜드플레이
lilian	릴리안
lilian	릴리언
iia	iia
ubs	ubs
pylori	헬리코박터
printf	printf
turkestan	투르키스탄
messi	메시
servlet	서블릿
ikon	ikon
mitigation	완화
pov	pov
steyr	슈타이어
vod	vod
uic	uic
gorizia	고리치아
ฮ็อป	힙합
wideband	광대역
แบล็คเมล์	협박
syfy	syfy
catv	catv
ocarina	오카리나
jacky	재키
azuma	아즈마
nss	nss
marburg	마르부르크
oscillation	진동
kano	카노
yusuke	유스케
bcr	bcr
toefl	토플
dessert	후식
dessert	디저트
peptides	펩타이드
sgh	sgh
pluralism	다원주의
expansions	확장
jenner	제너
แมททิส	마티스
yakutsk	야쿠츠크
peres	페레스
bau	bau
แห้งๆ	건조
แห้งๆ	드라이
stefanie	스테파니
philology	문헌학
tec	tec
misty	misty
misty	이슬
wilber	윌버
condo	호화
schiphol	스키폴
gmc	gmc
pim	pim
ebs	ebs
matrices	행렬
darpa	darpa
usm	usm
epr	epr
rhenium	레늄
franck	프랑크
kagura	구라
kagura	가구라
weierstrass	바이어슈트라스
fujifilm	후지필름
psm	psm
bucks	벅스
oculus	오큘러스
bic	bic
macworld	맥월드
paddington	패딩턴
honorius	호노리오
bingo	빙고
mysore	마이소르
cca	cca
stafford	스태퍼드
hmi	hmi
taito	다이토
taito	타이토
caesars	시저스
qpr	qpr
tomoe	토모에
บราวเซอร์	브라우저
transnistria	트란스니스트리아
matte	마테
matte	매트
แพงๆ	비싼
แพงๆ	비싸다
abl	abl
simferopol	심페로폴
alcohols	알코올
lng	lng
cpc	cpc
ดิบๆ	raw
hci	hci
hawkeye	호크아이
naacp	naacp
dti	dti
trier	트리어
sleeve	소매
dreadnought	드레드노트
redshift	적색편이
michelin	미슐랭
dmm	dmm
เดเรก	데릭
usp	usp
arias	아리아스
cjk	cjk
polis	폴리스
tottori	돗토리
bor	보르
mame	mame
muzik	muzik
spurs	스퍼스
renner	레너
iceman	아이스맨
rayleigh	레일리
laplace	라플라스
vicenza	비첸차
macfarlane	맥팔레인
zara	자라
srv	srv
democratization	민주화
blanca	블랑카
frameworks	프레임워크
sml	sml
tps	tps
kst	kst
typhoid	장티푸스
tpm	tpm
stl	stl
addons	addons
cpm	cpm
jeddah	지다
captcha	captcha
avn	avn
refraction	굴절
neodymium	네오디뮴
soulcalibur	소울칼리버
naturalism	자연주의
nac	nac
poznań	포즈난
osu	osu
andromedae	안드로메다자리
เดเร็ก	데릭
ลมปาก	words
ลมปาก	단어
awb	awb
versace	베르사체
gunslinger	건슬링거
อ้วนๆ	뚱뚱한
อ้วนๆ	지방
อ้วนๆ	살찐
rbc	rbc
campania	캄파니아
kyūshū	규슈
แอลฟ่า	알파
slovene	슬로베니아
slovene	슬로베니아어
thérèse	테레즈
yumiko	유미코
cortina	코티나
matsuoka	마쓰오카
บุฟเฟต์	뷔페
paypal	페이팔
tana	타나
testis	고환
vela	돛자리
debtors	채무자
bse	bse
toshihiko	토시히코
edm	edm
nexon	넥슨
mcneill	맥닐
lga	lga
ฮ่าๆ	ㅋㅋ
ฮ่าๆ	ㅎㅎㅎ
ฮ่าๆ	ㅋㅋㅋ
dimm	dimm
turk	투르크인
turk	투르크
cushion	쿠션
emr	emr
eeprom	eeprom
leonidas	레오니다스
damping	감쇠
gigabit	기가비트
takarazuka	다카라즈카
abi	abi
hcn	hcn
pee	오줌
pee	소변
arboretum	수목원
rhodium	로듐
beos	beos
saffir	사피어
danzig	단치히
classicism	고전주의
tsg	tsg
maiko	마이코
cagliari	칼리아리
concepción	콘셉시온
equinoxes	분점
curzon	커즌
bona	보나
pharyngeal	인두
มัฟฟิน	머핀
มัฟฟิน	머핀
navies	해군
workplace	직장
malloc	malloc
softbank	소프트뱅크
วงๆ	연승
เก้บ	게이브
apl	apl
technetium	테크네튬
jit	jit
gtr	gtr
haim	하임
ofi	ofi
sqlite	sqlite
watford	왓퍼드
watford	왓포드
ถี่ๆ	두근
pontus	폰투스
sumire	스미레
pta	pta
chromic	크로뮴
paulus	파울루스
vbr	vbr
leaflet	전단지
optimality	최적성
อาร์คัม	아캄
ตู้จดหมาย	사서함
ipl	ipl
คิกิ	키키
helicobacter	헬리코박터
gotō	고토
อ่างล้างหน้า	세탁기
อ่างล้างหน้า	싱크로
คุ้นๆ	익숙한
wrocław	브로츠와프
sumiyoshi	스미요시
cmo	cmo
aek	aek
blogger	블로거
ericsson	에릭슨
ime	ime
คล๊าก	클라크
fcs	fcs
maharashtra	마하라슈트라
ica	ica
cheongju	청주
cheongju	청주시
quicksilver	퀵실버
tsc	tsc
rcc	rcc
prestressed	프리스트레스트
themis	테미스
cec	cec
sna	sna
marlowe	말로
wcc	wcc
simd	simd
positivism	실증주의
ifa	ifa
hotline	핫라인
soundcloud	사운드클라우드
mountaineering	등산
presenters	발표자
ishibashi	이시바시
nfs	nfs
colonia	콜로니아
microprocessor	마이크로프로세서
ocr	ocr
rakuten	라쿠텐
snmp	snmp
ldap	ldap
mlg	mlg
ctr	ctr
lilo	lilo
frantz	프란츠
doolittle	둘리틀
kloss	클로스
dur	dur
adk	adk
calderon	칼데론
pae	pae
ppd	ppd
lebron	르브론
aar	aar
เทนเนสซี่	테네시
rollers	롤러
บูดาเปส	부다페스트
ridgway	리지웨이
ags	ags
sox	sox
adaptations	각색
mmo	mmo
mumford	멈퍼드
ragusa	라구사
adsense	애드센스
beyer	바이어
peaks	봉우리
ldh	ldh
แคธี	캐시
อินเทอร์เฟส	인터페이스
vocaloid	보컬로이드
kerala	케랄라
afd	afd
ropeway	로프웨이
copland	코플랜드
cnt	cnt
herold	헤럴드
quasar	퀘이커
quasar	퀘이사
adjacency	인접
ricoh	리코
aws	aws
ระบม	아픔
veronika	베로니카
kaa	kaa
onomichi	오노미치
shintaro	신타로
dolph	돌프
schulz	슐츠
maroc	모로코
ucc	ucc
abm	abm
wcdma	wcdma
tvbs	tvbs
ntfs	ntfs
raytheon	레이시온
eriko	에리코
ploy	계략
btv	btv
fatman	뚱보
jeonju	전주
jeonju	전주시
wordsworth	워즈워스
gravure	그라비아
gsc	gsc
ccm	ccm
hmd	hmd
urology	비뇨기과
dhl	dhl
borodin	보로딘
rpc	rpc
traversal	순회
perforation	천공
polytope	다포체
obs	obs
campeche	캄페체
xps	xps
bff	절친
handley	핸들리
tenryū	덴류
coxeter	콕서터
cpr	심폐소생술
ldc	ldc
divorcee	이혼
freescale	프리스케일
udine	우디네
genova	제노바
octet	옥텟
jonsson	욘손
queenstown	퀸스타운
potts	포츠
พฤหัสฯ	목요일
lucerne	루체른
millard	밀러드
brindisi	브린디시
jis	jis
bfi	bfi
sns	sns
gilmour	길모어
wilfrid	윌프리드
meditations	명상
gbu	gbu
lovell	러벨
kharkov	하리코프
larisa	라리사
environmentalism	생태주의
fdr	루즈벨트
vms	vms
gfw	gfw
yoghurt	요구르트
rar	rar
snl	snl
ean	ean
acb	acb
airbag	에어백
daf	daf
dcs	dcs
นอร์ฟอล์ค	노퍽
dyslexia	난독증
regionalism	지역주의
mfc	mfc
dpkg	dpkg
brasilia	브라질리아
deathmatch	데스매치
svt	svt
stapleton	스테이플턴
ทื่อๆ	블런트
michaela	미카엘라
ซอฟท์แวร์	소프트웨어
ott	오트
walmart	월마트
etihad	에티하드
srm	srm
slovaks	슬로바키아인
efi	efi
wfp	wfp
เซ็ธ	seth
rtos	rtos
kamo	가모
tajiri	다지리
tajiri	타지리
koike	코이케
dme	dme
haruko	하루코
jsf	jsf
sitges	시체스
mamluk	맘루크
herat	헤라트
salo	살로
ogura	고쿠라
ogura	오쿠라
ogura	오구라
cls	cls
chappell	채플
บวมๆ	부어
mpl	mpl
southend	사우스엔드
tosca	토스카
menzies	멘지스
maghreb	마그레브
smb	smb
epistles	서신
mcdonalds	맥도날드
เมี๊ยว	야옹이
phobos	포보스
hsp	hsp
yoshinori	요시노리
ddh	ddh
varese	바레세
msdn	msdn
plenary	본회의
urmia	우르미아
macedon	마케도니아
กัลโลเวย์	갤러웨이
ssn	ssn
aos	aos
gtb	gtb
oso	oso
takashima	다카시마
takashima	타카시마
readability	가독성
junkers	융커스
salerno	살레르노
xfce	xfce
โดมินิกา	도미니카
bda	bda
ปปป	yyyy
šiauliai	샤울랴이
gdi	gdi
gallup	갤럽
mikel	미켈
kumasi	쿠마시
pavlova	파블로바
parodies	패러디
concession	양보
rothesay	로스시
serre	세르
cyrene	키레네
bibi	비비
ddc	ddc
windhoek	빈트후크
hongqiao	훙차오
exposures	노출
ostrava	오스트라바
valeri	발레리
varney	바니
เค๊ก	케이크
abn	abn
pcmcia	pcmcia
jumeirah	주메이라
montenegrin	몬테네그로어
montenegrin	몬테네그로
montenegrin	몬테네그로인
deakin	디킨
antoninus	안토니우스
antoninus	안토니누스
cordillera	코르디예라
hirst	허스트
shoal	암초
thoreau	소로
bbq	바비큐
bbq	바베큐
sdf	sdf
lyre	리라
nsb	nsb
คิคิ	키트
คิคิ	kit
bastia	바스티아
citroën	시트로엥
kkk	kkk
kkk	ㅋㅋㅋ
kash	캐쉬
kash	캐시
boutros	부트로스
itanium	아이테니엄
tuple	튜플
glazer	글레이저
anisotropic	비등방성
mcm	mcm
igp	igp
sbc	sbc
cheonan	천안시
cheonan	천안
diodes	다이오드
สลิ่ม	쐐기
อัยน์	아인
nicol	니콜
sinbad	신밧드
macartney	매카트니
ipm	ipm
petro	페트로
maccabi	마카비
kyocera	교세라
aphid	진딧물
msd	msd
dhahran	다란
ชีฟอง	시폰
metcalf	멧커프
tlb	tlb
mii	mii
megadeth	메가데스
ฮาร์ส	하스
akio	아키오
tsv	tsv
seleucus	셀레우코스
fano	파노
mods	개조
blazer	블레이저
orthopedic	정형외과
mcfarlane	맥팔레인
cremona	크레모나
dfl	dfl
lula	룰라
throwback	회상
shinsuke	신스케
toruń	토룬
drm	drm
absolutism	전제군주제
gcn	gcn
hnl	hnl
bto	bto
เมโทรโปลิส	메트로폴리스
pce	pce
veranda	베란다
ฑูต	외교관
lrc	lrc
fsv	fsv
openssl	openssl
ไมเคิ้ล	마이클
ไมเคิ้ล	미하엘
ไมเคิ้ล	미카엘
clipper	클리퍼
kula	쿨라
dslr	dslr
bmd	bmd
sugimoto	스기모토
cco	cco
rsi	rsi
