แล็ปท็อป	skootrekenaars
แล็ปท็อป	skootrekenaar
เบลก	blake
lucy	lucy
กานพลู	naeltjies
ordre	ordre
dinosauria	dinosauria
โป๊กเกอร์	poker
nfl	nfl
lip	lip
moss	mos
moss	moss
ปลอกคอ	collar
โฮล์มส์	holmes
ไมลส์	myle
ไมลส์	myl
passeriformes	passeriformes
civic	burgerlike
civic	munisipale
civic	civic
leiden	leiden
iec	iec
carmen	carmen
ท็อปส์	tops
ตื้นๆ	shallow
mustela	mustela
ลอต	lott
henle	henle
bce	bce
คีท	kees
คีท	keith
elephas	elephas
dubai	dubai
ทรัมเปต	trompet
กระวนกระวาย	angstig
tao	tao
สวยๆ	mooi
สวยๆ	mooi
สวยๆ	pretty
sdtv	sdtv
ภาพยนต์	fliek
ภาพยนต์	rolprent
ภาพยนต์	flieks
ภาพยนต์	rolprente
ภาพยนต์	movies
cma	cma
spec	spesifikasie
spec	spec
ฉุบ	skêr
mou	mou
นํ้า	water
gorm	gorm
psr	psr
uprising	junta
curry	kerrie
curry	curry
scaleminor	scaleminor
templatedata	templatedata
rft	rft
det	det
orientalis	orientalis
loaddata	loaddata
osprey	visvalk
merriam	merriam
รัดรูป	rudd
miocene	mioseen
zanthoxylum	zanthoxylum
luca	luca
ตาชั่ง	skale
evergreen	immergroen
ใคร่ครวญ	herhaal
ใคร่ครวญ	reflekteer
titleclass	titleclass
nic	nic
rubiaceae	rubiaceae
ขวนขวาย	verwerf
rae	rae
tls	tls
encyclopaedia	encyclopaedia
ucla	ucla
เอทีเอ็ม	otm
wta	wta
แรนด์	rand
แรนด์	randse
omniglot	omniglot
ยางลบ	eraser
นมวัว	koei
ped	ped
จรจัด	hawelose
pizza	pizza
เซรามิค	keramiek
cis	cis
flop	flop
phuket	phuket
nrt	nrt
thx	thx
cotton	katoen
ipod	ipod
ipod	ipods
emerg	emerg
setmetatable	setmetatable
hokusai	hokusai
ole	ole
chennai	chennai
peng	peng
solaris	solaris
ดีซ่าน	geelsug
comp	comp
บาร์บีคิว	braai
hrh	hrh
hcl	hcl
ems	ems
sohc	sohc
เทียนไข	kers
hoc	hoc
rafinesque	rafinesque
โคไซน์	kosinus
บู้	spoke
subfamilia	subfamilia
eos	eos
เพียซ	pierce
pdp	pdp
เมก	meg
shtml	shtml
sue	sue
cites	cites
birdlife	birdlife
emerald	emerald
แฮ็ค	gekraak
รีซ	reese
จอร์น	johannes
จอร์น	john
plantae	plantae
lccn	lccn
oecd	oecd
subclassis	subclassis
ตูด	ass
ตูด	boude
racer	racer
linecolor	linecolor
วิสกี้	whiskey
วิสกี้	whisky
benth	benth
basestyle	basestyle
afp	afp
ฟอร์แมต	formateer
คิงสตัน	kingston
จิ๋ม	pussy
ไดร์ฟ	aandrywer
lpg	lpg
bacillus	bacillus
wifi	wifi
getcurrenttitle	getcurrenttitle
ambox	ambox
msv	msv
ipad	ipad
cmos	cmos
gmelin	gmelin
เบรค	brake
เบรค	rem
ดอท	punt
ดอท	dot
กลมๆ	rondte
mcdonald	mcdonald
mcdonald	mcdonalds
มัดจำ	inbetaal
trigramme	trigramme
vhs	vhs
kde	kde
asst	asst
wikibooks	wikibooks
bkk	bbk
lothringen	lothringen
ไนลอน	nylon
lopez	lopez
squalus	squalus
goldblatt	goldblatt
sato	sato
datastyle	datastyle
apa	apa
kloster	kloster
ต้อกระจก	katarak
forsskål	forsskål
gpa	gpa
sauvage	sauvage
อินเตอร์เฟส	koppelvlak
stardust	stardust
sao	sao
ลอเรล	laurel
factsheet	factsheet
ยาสลบ	narkose
hon	hon
rss	rss
แบส	bas
ฝักบัว	stort
ฝักบัว	buie
ฝักบัว	storte
ฝักบัว	reënbuie
ปาโล	palo
คลัสเตอร์	cluster
nom	nom
wittgenstein	wittgenstein
avec	avec
อีสุกอีใส	waterpokkies
อีสุกอีใส	pox
nano	nano
iss	iss
nigra	nigra
ผ้าเช็ดหน้า	sakdoek
เมดเลย์	medley
ipcc	ipcc
itf	itf
nong	nong
geoffroy	geoffroy
เนด	ned
เหยือก	mug
เหยือก	pitcher
เหยือก	jug
monobook	monobook
watt	watt
โปรโมชัน	promosie
โปรโมชัน	promosie
editpage	editpage
habilis	habilis
dodge	dodge
eia	eia
citationclass	citationclass
yves	yves
universität	universität
amet	amet
ลีท	leith
หกล้ม	tripping
อุ้งมือ	pootjies
sprint	sprint
nyc	nyc
publicationdate	publicationdate
mma	mma
panoramio	panoramio
ligne	ligne
แพม	pam
จดจ่อ	gefokusde
australopithecus	australopithecus
vhf	vhf
evo	evo
ทรัมป์	trump
ich	ich
johan	johan
bust	bust
rsa	rsa
ฮิบ	hip
metacritic	metacritic
โบรกเกอร์	makelaar
biz	biz
dude	dude
deutsch	deutsch
subpages	subpages
gotta	gotta
hotcat	hotcat
pga	pga
mont	mont
เซสชัน	sessie
เซสชัน	sessies
capo	capo
บัดดี้	maatjie
เอะอะ	fuss
panasonic	panasonic
infraordo	infraordo
kaon	kaon
naka	naka
longus	longus
ดุลยพินิจ	goeddunke
cochrane	cochrane
คอมมูน	commune
nds	nds
aac	aac
société	société
dia	dia
globalsecurity	globalsecurity
kentucky	kentucky
imageright	imageright
ไฮไลต์	gemerk
ไฮไลต์	hoogtepunt
ไฮไลต์	verlig
ไฮไลต์	hoogtepunte
ลูกวัว	calf
raiders	raiders
ซีรี่ส์	reeks
ซีรี่ส์	series
longman	longman
mah	mah
aps	aps
แชต	klets
แชต	gesels
österreich	österreich
quis	quis
cfm	cfm
kew	kew
pardus	pardus
joker	nar
cambodge	cambodge
เสริฟ	dien
เสริฟ	bedien
demospace	demospace
อืม	goed
อืม	wel
อืม	sowel
hdmi	hdmi
mundo	mundo
titlebackground	titlebackground
เธน	thane
sumatrana	sumatrana
staphylococcus	staphylococcus
แท่	tae
ฟิค	fig
delle	delle
gam	gam
coco	coco
palgrave	palgrave
titleforeground	titleforeground
osama	osama
japonica	japonica
อัลเฟร็ด	alfred
nec	nec
cdt	cdt
nbsp	nbsp
duomo	duomo
nvidia	nvidia
isi	isi
pubmed	pubmed
ส่วนลด	afslag
ค่าสัมบูรณ์	absolute
tung	tung
xvi	xvi
hdl	hdl
arxiv	arxiv
csv	csv
gin	gin
วัตถุนิยม	materialisme
parc	parc
eco	eco
université	université
nida	nida
liebe	liebe
amor	amor
fernández	fernández
bayern	bayern
ผิวปาก	fluitjie
ผิวปาก	fluit
mis	mis
ใสๆ	doe
anhalt	anhalt
shortsummary	shortsummary
ati	ati
gmbh	gmbh
แฮ่	hae
tnt	tnt
eso	eso
ปฐมนิเทศ	oriëntasie
africana	africana
tam	tam
amadeus	amadeus
โบกมือ	waai
โบกมือ	golf
อัลลอฮฺ	god
württemberg	württemberg
มอซ	moz
harpercollins	harpercollins
ไลค์	soos
domenico	domenico
เดนี	dani
ไฟแนนซ์	finansiering
ไฟแนนซ์	finansieel
ไฟแนนซ์	finansies
moulin	moulin
mayo	mayo
proc	proc
dcc	dcc
nicholson	nicholson
jfk	jfk
primer	primer
bashkortostan	basjkortostan
fallax	fallax
mpv	mpv
mee	mee
vga	vga
scr	scr
บล็อค	blokkeer
บล็อค	blok
บล็อค	geblokkeerde
บล็อค	geblokkeer
บล็อค	verhoed
บล็อค	geblok
proud	trots
slr	slr
trend	trend
trend	tendens
trend	neiging
outlook	outlook
lacépède	lacépède
sissel	sissel
ลูปัส	lupus
lounge	sitkamer
บลูเบิร์ด	bluebird
meshnumber	meshnumber
beau	beau
มโนธรรม	bewussyn
palatinate	palts
ร้อนๆ	hot
ร้อนๆ	warm
เงินผ่อน	finansiering
hpa	hpa
โรงนา	barn
archiveurl	archiveurl
nadh	nadh
arius	arius
ecu	ecu
dev	dev
แล็ป	laboratorium
แล็ป	laboratorium
แล็ป	lab
saurischia	saurischia
พุช	puss
stm	stm
irq	irq
insight	insig
ohv	ohv
formatdate	formatdate
yugra	yugra
ซักรีด	wasgoed
pcall	pcall
tyson	tyson
sharpe	sharpe
แฮก	hack
coo	coo
hug	drukkie
เย็นๆ	cold
เย็นๆ	koue
เย็นๆ	koud
pst	pst
cassini	cassini
république	république
slip	gly
och	och
คนสวน	tuinier
kawasaki	kawasaki
backgroundcolors	backgroundcolors
éditions	éditions
sfsr	sfsr
pulp	pulp
doubleday	doubleday
amg	amg
uni	uni
dab	dab
quicktime	quicktime
agassiz	agassiz
lac	lac
nulla	nulla
nrc	nrc
seds	seds
wikibase	wikibase
aviator	vlieënier
philips	philips
utrecht	utrecht
พาโล	palo
ute	ute
tsu	tsu
mango	mango
milne	milne
kato	kato
theodor	theodor
uncollapsed	uncollapsed
rec	rec
kbps	kbps
scopus	scopus
taxa	taxa
hina	hina
ordovician	ordovisium
ติวเตอร์	tutor
puma	puma
giotto	giotto
caretta	caretta
shtetl	sjtetl
โป๊ป	pous
interscope	interscope
ddd	ddd
kappa	kappa
voip	voip
rotterdam	rotterdam
pargs	pargs
sono	sono
teatro	teatro
coauthors	coauthors
mild	mild
ลีต	leith
filmfare	filmfare
grus	grus
fern	fern
คาร์ไมเคิล	carmichael
ไบเบิ้ล	bybel
annales	annales
spam	gemorspos
lite	lite
lite	light
เทอร์โมมิเตอร์	termometer
cervus	cervus
honneur	honneur
schleswig	sleeswyk
sis	sis
hendrik	hendrik
carpi	carpi
rina	rina
mdi	mdi
decca	decca
fanny	fanny
sartre	sartre
txt	txt
kabardino	kabardino
อ่างอาบน้ำ	bad
อ่างอาบน้ำ	bad
อ่างอาบน้ำ	bath
checktype	checktype
ssl	ssl
streptococcus	streptococcus
dst	dst
burger	burger
anaerobic	anaërobiese
arkive	arkive
ucl	ucl
คาร์ลอ	carl
archaeopteryx	archaeopteryx
molly	molly
ฮอง	hong
gimp	gimp
valentin	valentin
schloss	schloss
lindbergh	lindbergh
isis	isis
réunion	réunion
sampa	sampa
hist	hist
jacq	jacq
umts	umts
contribs	contribs
ไฟแช็ก	ligter
wikiquote	wikiquote
getz	getz
bruxelles	bruxelles
województwo	województwo
แรนดัล	randall
moments	oomblikke
cribb	cribb
edda	edda
ceeb	ceeb
แม็ท	matt
hobby	hobby
hobby	stokperdjie
datavalue	datavalue
maison	maison
พุส	puss
sar	sar
deutschen	deutschen
plainlinks	plainlinks
mainz	mainz
csa	csa
accord	accord
เทท	tate
thirteen	dertien
บารอมิเตอร์	barometer
chapelle	chapelle
leisure	ontspanning
leisure	leisure
rüppell	rüppell
ait	ait
münster	münster
île	île
ไลล์	lyle
geograph	geograph
beats	beats
beats	slae
unforgiven	unforgiven
aura	aura
pliocene	plioseen
neue	neue
rosso	rosso
eduardo	eduardo
bing	bing
méxico	méxico
iptv	iptv
flex	flex
atl	atl
stadio	stadio
dagestan	dagestan
pectinata	pectinata
nacl	nacl
olav	olav
hystrix	hystrix
italiana	italiana
latreille	latreille
deutsches	deutsches
fes	fes
ams	ams
centro	centro
wiesbaden	wiesbaden
ria	ria
vitis	vitis
บางเบา	vere
nin	nin
innsbruck	innsbruck
tottenham	tottenham
tev	tev
dora	dora
อ๊ะ	oeps
mime	mime
microlepis	microlepis
firewire	firewire
peterson	peterson
cong	cong
หนักๆ	swaar
birdman	birdman
kao	kao
std	std
acta	acta
muller	muller
escherichia	escherichia
imax	imax
archivedate	archivedate
kerry	kerry
qld	qld
orchestre	orchestre
pars	pars
benn	benn
guerra	guerra
msnbc	msnbc
pong	pong
blink	flikker
blink	blink
sixteenth	sixteenth
iarc	iarc
bild	bild
courbet	courbet
gbp	gbp
cooh	cooh
อุ๊ย	oeps
bam	bam
exodus	exodus
arthropoda	arthropoda
pocock	pocock
fet	fet
rwd	rwd
nen	nen
shounen	shounen
ora	ora
อัพเดท	opgedateer
อัพเดท	gewysig
อัพเดท	bygewerk
pax	pax
gta	gta
nas	nas
ups	ups
บอกใบ้	wenke
cod	kabeljou
เคเบิ้ล	kabel
เลขาฯ	sekretaris
เลขาฯ	sekretaresse
craib	craib
deutschland	deutschland
haeckel	haeckel
topographic	topografiese
transliteration	transliterasie
เมี้ยว	miaau
dyk	dyk
livre	livre
zita	zita
ไซปัน	saipan
gesellschaft	gesellschaft
cdu	cdu
fernandez	fernandez
transcluded	transcluded
mir	mir
girard	girard
bismuth	bismut
droit	droit
econ	econ
michele	michele
nok	nok
apec	apec
pou	pou
salvelinus	salvelinus
toolserver	toolserver
jalan	jalan
hotspur	hotspur
zimmermann	zimmermann
wikt	wikt
église	église
ชอปปิ้ง	inkopies
ชอปปิ้ง	shopping
superfamilia	superfamilia
กรีส	grease
uru	uru
noi	noi
ocellatus	ocellatus
siècle	siècle
เบย	bae
cfa	cfa
república	república
ไมโล	milo
งีบ	uiltjie
musique	musique
moctezuma	moctezuma
dtv	dtv
kirchner	kirchner
เปียนโน	klavier
ดอยช์	deutsche
slalom	slalom
sina	sina
macbook	macbook
sac	sac
unitary	unitary
ferreira	ferreira
ดินเนอร์	aandete
mazda	mazda
ไกส์	skype
mimi	mimi
กิลเลส	gillespie
nenets	nenets
avatar	avatar
yaroslavl	jaroslawl
ssc	ssc
accademia	accademia
powerpc	powerpc
coe	coe
pennsylvanian	pennsylvanian
wikinews	wikinews
ย่อมเยา	bekostigbaar
ย่อมเยา	bekostigbare
dvořák	dvořák
nosferatu	nosferatu
เลอะเทอะ	mess
barincrement	barincrement
botanic	botanic
taxon	takson
cta	cta
chapterurl	chapterurl
ทัณฑ์บน	parole
fai	fai
petite	petite
romaji	romaji
quint	quint
broker	makelaar
continuum	continuum
fia	fia
adb	adb
valencian	valencia
ดรอป	druppel
ดรอป	val
rodentia	rodentia
electronegativity	elektronegatiwiteit
henrik	henrik
กระดิก	bewe
ouest	ouest
bafta	bafta
การขนส่งมวลชน	transit
loc	loc
loc	sl
angiosperms	angiosperms
bonn	bonn
เมกะเฮิรตซ์	mhz
sixteen	sestien
sixteen	sixteen
บังตา	verblind
galerie	galerie
khabarovsk	chabarofsk
oakland	oakland
nadph	nadph
tensor	tensor
oro	oro
พุซ	puss
heidelbergensis	heidelbergensis
กระเด้ง	hop
ขาอ่อน	dye
dns	dns
ttl	ttl
cristatus	cristatus
แชท	klets
แชท	gesels
mcfarland	mcfarland
africanus	africanus
internazionale	internazionale
evenodd	evenodd
moo	moo
buryatia	boerjatië
เอเย่นต์	agent
seurat	seurat
oed	oed
mississippian	mississippian
ตูส	stu
shockley	shockley
infraclassis	infraclassis
rechts	rechts
outdoor	outdoor
outdoor	buite
outdoor	buitelug
intermedia	intermedia
barbus	barbus
antineutrino	antineutrino
treme	treme
เปเป	pepe
เปเป	peru
hodder	hodder
samba	samba
velit	velit
dreamworks	dreamworks
wikiversity	wikiversity
niloticus	niloticus
minimal	minimum
minimal	minimale
ntsc	ntsc
csu	csu
barron	barron
bopp	bopp
özil	özil
pur	pur
ช๊อค	shock
ช๊อค	skok
เตารีด	yster
coturnix	kwartels
voc	voc
subphylum	subphylum
governorate	governorate
göttingen	göttingen
hohenzollern	hohenzollern
หวานๆ	lieflike
หวานๆ	soet
urs	urs
theropoda	theropoda
tuva	tiwa
dunam	dunam
wikivoyage	wikivoyage
lexikon	lexikon
vue	vue
consequat	consequat
spica	spica
bara	bara
vin	vin
nike	nike
เนธาน	nathan
cava	cava
paleocene	paleoseen
ops	ops
nisi	nisi
enim	enim
blackberry	blackberry
marius	marius
oligocene	oligoseen
bsc	bsc
hrsg	hrsg
นิกิ	niki
rip	rip
alamos	alamos
smtp	smtp
sus	sto
pedersen	pedersen
nsdap	nsdap
phasianidae	fisantagtiges
nicky	nicky
motogp	motogp
palermo	palermo
meryl	meryl
เบลิซ	belize
vojvodina	vojvodina
buchholz	buchholz
abbaye	abbaye
dukes	dukes
parque	parque
rondo	rondo
amr	amr
moma	moma
sachsen	sachsen
spielberg	spielberg
เหยาะ	yao
villosa	villosa
catedral	catedral
joanna	joanna
iglesias	iglesias
augsburg	augsburg
historiography	historiography
kyi	kyi
wmflabs	wmflabs
sdb	sdb
primetime	primetime
outre	outre
องคชาติ	penis
nsw	nsw
hussain	hussain
tempor	tempor
neanderthalensis	neanderthalensis
acs	acs
nail	nael
duis	duis
aes	aes
reina	reina
kalmykia	kalmikië
cvn	cvn
andersson	andersson
albin	albin
เพลีย	moeg
svensson	svensson
emporis	emporis
daw	daw
enwiki	enwiki
homme	homme
léopold	léopold
borderline	borderline
kwh	kwh
ramanujan	ramanujan
parserfunctions	parserfunctions
tcm	tcm
adv	adv
asturias	asturië
asc	asc
vaillant	vaillant
gadgets	gadgets
gadgets	apparate
bund	bund
palacio	palacio
série	série
rutaceae	rutaceae
beverley	beverley
pka	pka
eros	eros
lgbt	lgbt
zanuck	zanuck
taxobox	taxobox
rihanna	rihanna
blitz	blitz
nur	nur
nazionale	nazionale
bouvier	bouvier
dictionnaire	dictionnaire
oxidative	oksidatiewe
situ	situ
kendall	kendall
castelnau	castelnau
thành	thành
stripe	streep
sylvia	sylvia
wolfsburg	wolfsburg
mycobacterium	mycobacterium
omg	sjoe
xix	xix
agb	agb
pitta	pitta
dolce	dolce
rerun	hardloop
antiquark	antiquark
peterborough	peterborough
afs	ags
mdd	mdd
barker	barker
thalberg	thalberg
vivo	vivo
buch	buch
bibcode	bibcode
opengl	opengl
treron	treron
sixty	sestig
pskov	pskof
federalism	federalisme
politique	politique
ซุปเปอร์มาร์เก็ต	supermarkte
ซุปเปอร์มาร์เก็ต	supermark
volvo	volvo
piedmont	piedmont
phineas	phineas
psk	psk
blainville	blainville
dylan	dylan
oldid	oldid
pgm	pgm
mollis	mollis
puy	puy
battista	battista
เปล่งปลั่ง	skitterende
leonhard	leonhard
milo	milo
laidlaw	laidlaw
varanus	varanus
เฮ้	hallo
เฮ้	hi
เฮ้	haai
nikon	nikon
sana	sana
คอแห้ง	dors
atrium	atrium
nowiki	nowiki
ไพค์	pike
nyasaland	njassaland
freenode	freenode
gerd	gerd
guilford	guilford
naoh	naoh
gourmet	gourmet
chembox	chembox
หนึบ	grof
หนึบ	klewerig
หนึบ	taai
flava	flava
humilis	humilis
swainson	swainson
pte	pte
ไวต์ฮอล	whitehall
wada	wada
mola	mola
prinz	prinz
derm	derm
imo	imo
richelieu	richelieu
roadster	roadster
ymca	ymca
copyleft	kopielinks
adj	adj
staffordshire	staffordshire
paix	paix
getty	getty
สมิทธ์	smith
rolfe	rolfe
ทำครัว	kombuis
sfr	sfr
rtl	rtl
roundel	roundel
nativename	nativename
เบ็ท	beth
rosetta	rosetta
suomen	suomen
trump	trump
nach	nach
mordovia	mordowië
kunst	kunst
madagascariensis	madagascariensis
plainlist	plainlist
usher	usher
eutheria	eutheria
bbb	bbb
todor	todor
hoa	hoa
ฟินช์	finch
earn	verwerf
adolph	sailor
navi	navi
hilton	hilton
abdel	abdel
swa	swa
ไฟร์เบิร์ด	firebird
wrc	wrc
lago	lago
spyder	spyder
lycée	lycée
texture	tekstuur
sigurd	sigurd
boomerang	boomerang
boomerang	boemerang
stephan	stephan
wikilinks	wikilinks
ksc	ksc
haliaeetus	haliaeetus
jeju	jeju
clr	clr
iguaçu	iguaçu
โฮลท์	holt
uma	uma
ดุค	duke
ดุค	hertog
tres	tres
ces	ces
origyear	origyear
preprocess	preprocess
cheers	cheers
cheers	hoera
consectetur	consectetur
paradisaea	paradisaea
roode	roode
stochastic	stogastiese
insignis	insignis
nld	nld
sergio	sergio
triomphe	triomphe
faf	faf
chanel	chanel
oliveira	oliveira
hermes	hermes
bernhard	bernhard
voluptate	voluptate
herrera	herrera
อาลิ	ali
astrakhan	astrachan
หือ	huh
testudo	testudo
บริกส์	briggs
ฟรอสท์	frost
func	func
britz	britz
römer	römer
เซจ	sage
forte	forte
anura	anura
grape	druiwe
blum	blum
photoshop	photoshop
bartolomeo	bartolomeo
systema	systema
โฮลต์	holt
ebook	ebook
lazare	lazare
openoffice	openoffice
leno	leno
antwerp	antwerpen
iis	iis
tui	tui
sws	sws
ว่างๆ	leeg
ว่างๆ	leë
ว่างๆ	egipte
ใบเบิก	pave
ontology	ontologie
lse	lse
mentor	mentor
สเต็ก	steak
สเต็ก	biefstuk
nep	nep
selena	selena
pauling	pauling
boucher	boucher
tyrol	tyrol
swartz	swartz
pam	pam
deadurl	deadurl
mof	mof
eilers	eilers
khakassia	chakassië
sonate	sonate
ventricosa	ventricosa
psg	psg
intermedius	intermedius
แม็ต	matt
aso	aso
transrapid	transrapid
nivea	nivea
chelyabinsk	tsjeljabinsk
pes	pes
rhineland	rynland
noël	noël
quagga	kwagga
mallorca	mallorca
perugino	perugino
rhein	rhein
csf	csf
mariano	mariano
fsa	fsa
bourgogne	bourgogne
concacaf	concacaf
loxodonta	loxodonta
icc	icc
nobilis	nobilis
เฝอ	virgil
aix	aix
tfl	tfl
mezzo	mezzo
böhlke	böhlke
โบนส์	bones
โบนส์	bene
ยูนิฟอร์ม	eenvormige
ยูนิฟอร์ม	uniform
zim	zim
selassie	selassie
wikispecies	wikispecies
recherche	recherche
kaup	kaup
megan	megan
tay	tay
hispano	hispano
rafale	rafale
atx	atx
คลอโรฟอร์ม	chloroform
mainsnak	mainsnak
hasbro	hasbro
westport	westport
labore	labore
palmas	palmas
vitae	vitae
moa	moa
bicornis	bicornis
anim	anim
pyotr	pyotr
diaz	diaz
amine	amine
himalayan	himalayan
xviii	xviii
แอ๊ปเปิ้ล	apples
callsign	callsign
gridcolor	gridcolor
hieronymus	hieronymus
เทพพยากรณ์	orakel
cephalopoda	cephalopoda
landsat	landsat
acp	acp
farnese	farnese
fabricius	fabricius
mrc	mrc
awd	awd
rebels	rebels
rebels	rebelle
ode	ode
reds	reds
reds	rooi
regensburg	regensburg
bataille	bataille
comune	comune
msk	msk
xxi	xxi
boydell	boydell
uncia	uncia
scribner	scribner
maris	maris
ทรัมพ์	trump
clade	klade
longmans	longmans
arista	arista
cmyk	cmyk
gerry	gerry
thuringia	thüringen
ฉาวโฉ่	notorious
könig	könig
fab	fab
xxii	xxii
pty	pty
obe	obe
deutscher	deutscher
dall	dall
ier	ier
zeit	zeit
horner	horner
gentile	gentile
alstom	alstom
sourcebook	sourcebook
pectoralis	pectoralis
mtdna	mtdna
galleria	galleria
searchlight	searchlight
podiceps	podiceps
eget	eget
veniam	veniam
ukiyo	ukiyo
pardalis	pardalis
pvt	pvt
taiping	taiping
reprehenderit	reprehenderit
fugiat	fugiat
pariatur	pariatur
vadis	vadis
ramón	ramón
rufa	rufa
chf	chf
methuen	methuen
wikimapia	wikimapia
taxonomic	taxonomic
theresia	theresia
polaris	polaris
édition	édition
qasim	qasim
zin	zin
smp	smp
athlon	athlon
pbk	pbk
oncorhynchus	oncorhynchus
swf	swf
presl	presl
sauropsida	sauropsida
uli	uli
ornithischia	ornithischia
mips	mips
tos	tos
cee	cee
royaume	royaume
nasser	nasser
artiodactyla	artiodactyla
hidalgo	hidalgo
abba	abba
xxv	xxv
acd	acd
cbe	cbe
เซสชั่น	sessie
เซสชั่น	sessies
castello	castello
seitz	seitz
mubarak	mubarak
girolamo	girolamo
stratigraphy	stratigrafie
général	général
ics	ics
splendens	splendens
annandale	annandale
afa	afa
rashomon	rashomon
gareth	gareth
korat	korat
msc	msc
ment	ment
militaire	militaire
adt	adt
punctatus	punctatus
protium	protium
elasmobranchii	elasmobranchii
หนาๆ	dik
aran	aran
magyar	magyar
zia	zia
cindy	cindy
phenol	fenol
ดรูว	drew
benedetto	benedetto
nusa	nusa
อัลม่า	alma
krupp	krupp
phylogenetics	filogenie
ลอว์เรน	lauren
cowboys	cowboys
sergey	sergei
chatto	chatto
caudata	caudata
คาร์เนชั่น	carnation
ฮาร์ฟ	harv
vorbis	vorbis
deu	deu
caco	caco
higgins	higgins
verizon	verizon
strangelove	strangelove
waterhouse	waterhouse
formosus	formosus
tainan	tainan
maj	maj
sps	sps
supérieure	supérieure
orientales	orientales
rostov	rostof
amt	amt
แมช	vermorsel
carolus	carolus
mbe	mbe
ramsar	ramsar
tandem	tandem
hfc	hfc
pycnonotus	pycnonotus
oic	oic
opéra	opéra
jal	jal
bibron	bibron
เมโย	mayo
ถูกๆ	goedkoop
wikipedians	wikipedians
cruze	cruze
mouton	mouton
henrique	henrique
québec	québec
viperidae	viperidae
udmurtia	oedmoertië
weidenfeld	weidenfeld
unep	unep
pavo	pou
แรนดอล	randall
pilosa	pilosa
peerage	pair
lwb	lwb
kps	kps
jacobus	jacobus
saarland	saarland
tampere	tampere
แอพพลิเคชัน	aansoek
แอพพลิเคชัน	toepassings
แอพพลิเคชัน	toepassing
fifteen	vyftien
fifteen	vyftiende
commandeur	commandeur
universidad	universidad
étoile	étoile
irst	irst
wesleyan	wesleyan
typus	typus
machina	machina
sourceforge	sourceforge
ปิกนิก	piekniek
brigitte	brigitte
kamel	kamel
dinh	dinh
fuck	fuck
zeitung	zeitung
officier	officier
ออสซี่	aussie
ashgate	ashgate
oerlikon	oerlikon
angie	angie
minima	minima
reticulatus	reticulatus
dunlop	dunlop
giuliano	giuliano
serranidae	serranidae
bernoulli	bernoulli
stroud	stroud
onca	onca
กีซ	kees
dope	dope
sheldon	sheldon
bahnhof	bahnhof
cité	cité
nox	nox
เริงร่า	vreugdevol
phaidon	phaidon
kool	kool
haemophilus	haemophilus
stéphane	stéphane
jawa	jawa
martius	martius
lune	lune
collège	collège
leopardus	leopardus
ไฮท์	hoogtes
ไฮท์	heights
zoster	zoster
beatrix	beatrix
heraldic	heraldic
krajina	krajina
mauris	mauris
mtu	mtu
dts	dts
sncf	sncf
pallidus	pallidus
ceres	ceres
maas	maas
temminckii	temminckii
ไพธอน	python
ไพธอน	luislang
tsr	tsr
regis	regis
ดุ๊ค	duke
ดุ๊ค	hertog
esprit	esprit
tyumen	tjoemen
latifolia	latifolia
audi	audi
psc	psc
domesticus	domesticus
spinosa	spinosa
premiers	premiers
vertebrata	vertebrata
delisted	delisted
álvarez	álvarez
seki	seki
wetland	vleiland
dato	dato
ker	ker
ldp	ldp
schwarzschild	schwarzschild
powerpoint	powerpoint
jours	jours
sharma	sharma
tethys	tethys
อิตาลี่	italië
smolensk	smolensk
wiltshire	wiltshire
yuzhno	joezjno
auflage	auflage
jeune	jeune
weyden	weyden
urgell	urgell
krasnoyarsk	krasnojarsk
snr	snr
plume	plume
incididunt	incididunt
aliqua	aliqua
orenburg	orenburg
mui	mui
gladys	gladys
compagnie	compagnie
photovoltaic	wek
petrus	petrus
strada	strada
goodwill	goodwill
rubra	rubra
อัพเดต	opdateer
อัพเดต	opgedateer
vittata	vittata
praeger	praeger
solidus	solidus
pel	pel
trujillo	trujillo
ferrand	ferrand
isla	menorca
เกษียน	aftrede
oma	oma
peuple	peuple
binh	binh
voronezh	woronezj
peltata	peltata
ทักซิโด	tuxedo
skype	skype
polygram	polygram
nijhoff	nijhoff
mactutor	mactutor
nylon	nylon
ira	ira
clément	clément
openstreetmap	openstreetmap
rosaceae	rosaceae
toul	toul
rowe	rowe
csm	csm
mhnt	mhnt
kris	kris
seventeenth	seventeenth
mobutu	mobutu
neues	neues
virgo	virgo
biophysics	biofisika
amphibia	amphibia
palustris	palustris
bryansk	brjansk
azur	azur
cerro	cerro
bloomsbury	bloomsbury
nihil	nihil
andrzej	andrzej
ato	ato
thc	thc
bundesarchiv	bundesarchiv
président	président
gtl	gtl
punctata	punctata
almanac	almanac
rainer	rainer
penza	penza
postgresql	postgresql
pci	pci
ooo	ooo
sapindaceae	sapindaceae
plasmodium	plasmodium
turku	turku
undulatus	undulatus
ngr	ngr
mmhg	mmhg
ugo	ugo
premio	premio
smalltext	smalltext
lautrec	lautrec
glam	glam
kaluga	kaloega
laevis	laevis
imap	imap
gazetteer	gazetteer
shawshank	shawshank
dafif	dafif
aquino	aquino
howards	howards
สเปรดชีต	sigblad
ogilby	ogilby
leucas	leucas
pistoia	pistoia
earle	earle
nishimura	nishimura
fiesta	fiesta
logia	logia
eiusmod	eiusmod
epinephelus	epinephelus
carinthia	karinthië
คาโล	carlo
ambedkar	ambedkar
exercitation	exercitation
หยง	yong
studien	studien
kurgan	kurgan
nineteen	negentien
krause	krause
paniculata	paniculata
selznick	selznick
nigripes	nigripes
eines	eines
pgc	pgc
mgr	mgr
phases	fases
libertadores	libertadores
นอกชาน	stoep
นอกชาน	patio
tcl	tcl
repubblica	repubblica
kolmogorov	kolmogorov
divisio	divisio
ils	ils
rossetti	rossetti
karabakh	karabakh
toastmasters	toastmasters
titsingh	titsingh
dassault	dassault
pulchella	pulchella
