smackdown	smackdown
โฉบ	foxtrot
nba	nba
oscar	oscar
ฟาวล์	foul
เบ้า	mold
ชีน	sheen
ยมโลก	underworld
แชมพู	shampoo
แมลงสาบ	cockroach
mnet	mnet
โนรี	reno
ffc	ffc
amazon	amazon
khz	khz
joy	joy
cuvier	cuvier
ขัดจังหวะ	interrupting
ขัดจังหวะ	interrupted
fref	fref
msn	msn
ssr	ssr
แอพ	app
แอพ	apps
ปลาวาฬ	whales
ปลาวาฬ	whale
ปลาวาฬ	orca
โฟล	flo
oricon	oricon
อะไหล่	parts
อดัมส์	adams
atc	atc
increment	increment
เงื่อน	knots
เงื่อน	knot
หวาดระแวง	paranoid
หวาดระแวง	paranoia
แทร็ค	track
beam	beam
เบียด	squeeze
นอกรีต	heresy
นอกรีต	heretic
นอกรีต	pagan
ติดใจ	addictive
แมงกานีส	manganese
ton	ton
kof	kof
กำปั้น	fist
เสือดำ	panther
nick	nick
boulenger	boulenger
landmark	landmark
xiii	xiii
หล่า	rallies
แจน	jan
กำมะหยี่	velvet
ท่วมท้น	overwhelming
เฆี่ยน	cane
เฆี่ยน	flogged
ละอาย	shame
ละอาย	ashamed
โกลาหล	chaotic
boxing	boxing
เวอร์ชั่น	version
เวอร์ชั่น	versions
วังน้อย	noi
csstext	csstext
เบ็ต	beth
เคต	kate
โปร่งแสง	transparency
โปร่งแสง	transparent
โปร่งแสง	translucent
routledge	routledge
gnu	gnu
champ	champ
ปิงปอง	pong
canon	canon
เมอ	mer
เบรุต	beirut
cellpadding	cellpadding
แล่	carve
marc	marc
พิซซ่า	pizza
ประแจ	wrench
หมกมุ่น	obsessive
หมกมุ่น	obsessed
สวัสดิภาพ	welfare
คลาสสิค	classical
คลาสสิค	classic
psp	psp
elegans	elegans
excel	excel
เหยา	yao
dom	dom
เงามืด	shadows
bsd	bsd
เชิน	shen
กระเช้า	tram
riaa	riaa
rus	rus
inner	inner
แกลลอน	gallon
แกลลอน	gallons
expo	expo
jpn	jpn
rpg	rpg
สัมพันธภาพ	fellowship
directory	directory
สลด	tragic
ไซยาไนด์	cyanide
api	api
api	apis
หลาว	yards
ฉ้อโกง	fraud
เดค	dec
ยูน	yoon
sad	macintosh
จำนำ	pawned
จำนำ	hock
ลูป	loops
ลูป	loop
lisa	lisa
encyclopædia	encyclopædia
terry	terry
จักจั่น	cicada
uhfffaoysa	uhfffaoysa
ตะแกรง	grate
แบนเนอร์	banners
แบนเนอร์	banner
เพนนี	penny
โกดัง	warehouse
ไตร่ตรอง	reflect
ไตร่ตรอง	ponder
ตะเกียบ	chopsticks
inter	inter
เหรัญญิก	treasurer
webcitation	webcitation
แซะ	sae
เกตเวย์	gateway
ชีค	sheik
vulpes	vulpes
rico	rico
สล็อต	slots
fit	fit
ลูกไก่	chick
คล้องจอง	rhyme
คล้องจอง	rhymes
สแลง	slang
jyp	jyp
โฮสต์	host
sas	sas
ซ่อง	brothel
mala	mala
โซฟา	sofa
โซฟา	couch
ตะปู	nail
ตะปู	nails
gymnothorax	gymnothorax
jon	jon
วิกลจริต	insane
liberty	liberty
chronicle	chronicle
จำนวนนับ	count
จำนวนนับ	counts
เยรูซาเล็ม	jerusalem
เกท	gate
ไดอารี่	diary
ไดอารี่	diaries
ผีดิบ	zombie
sepc	sepc
wan	wan
สันดาน	nature
luis	luis
ลูกอม	candy
authorlink	authorlink
พาราไดซ์	paradise
ประทุษร้าย	mayhem
rfc	rfc
kung	kung
หวด	whipping
หวด	whip
ติดลบ	negative
messenger	messenger
xii	xii
รวมๆ	globally
ทางเท้า	curb
ทางเท้า	sidewalk
ทางเท้า	pavement
จักรราศี	zodiac
kottelat	kottelat
เริม	herpes
อุรังอุตัง	orangutan
tbd	tbd
พันธบัตร	bond
พันธบัตร	bonds
กริ่ง	doorbell
พืชพันธุ์	crops
bush	bush
จับใจ	captivated
บอบบาง	fragile
บอบบาง	delicate
เอ้อ	well
แวม	wham
bao	bao
fin	fin
รูท	root
firefox	firefox
เบ้าตา	orbital
เบ้าตา	sockets
nbc	nbc
csi	csl
csi	csi
บั่นทอน	devastated
บั่นทอน	crippling
hiv	hiv
sec	sec
cctv	cctv
กิจวัตร	routine
usgs	usgs
geo	geo
ชะเอม	licorice
แดช	dash
ทังสเตน	tungsten
แซบ	zach
globe	globe
โมเด็ม	modem
โมเด็ม	modems
เผิง	peng
concat	concat
ฮอป	hop
fusca	fusca
บรู๊ค	brooke
feeling	feeling
ราล์ฟ	ralph
บรรณารักษ์	librarian
บรรณารักษ์	librarians
grammar	grammar
roh	roh
tor	tor
ไถ่บาป	salvation
adams	adams
wright	wright
yamaha	yamaha
แท็บ	tabs
แท็บ	tab
inchikey	inchikey
moves	moves
โอเค	okay
มัลฟอย	malfoy
บิลเลียด	billiard
บิลเลียด	billiards
ใบสั่ง	ticket
excellence	excellence
โกลเด้น	golden
ทวีคูณ	multiply
cox	cox
แฮนด์บอล	handball
แคสเปียน	caspian
statement	statements
candy	candy
อั้ม	aum
ฟิตเนส	fitness
rgm	rgm
burn	burn
msg	msg
subsp	subsp
เคลีย	clea
senshi	senshi
ของกิน	grub
โอ๊ค	oaks
โอ๊ค	oak
เด็ค	dec
issn	issn
vegas	vegas
gui	gui
จุ๊บ	kisses
ลูว์	lew
คำขาด	categorical
สปริงฟิลด์	springfield
ชลอ	slowing
เต็นท์	tent
dee	dee
superman	superman
gsm	gsm
อนาธิปไตย	anarchists
อนาธิปไตย	anarchist
อนาธิปไตย	anarchy
sims	sims
mba	mba
แมนชั่น	mansion
งมงาย	ignorant
งมงาย	ignorance
งมงาย	superstitious
ขมขื่น	bitter
ขมขื่น	bitterness
เมตริก	metric
micro	micro
null	null
usb	usb
alania	alania
roc	roc
กระสอบ	sacks
กระสอบ	sack
mono	mono
ยุทธภัณฑ์	ammunition
cdc	cdc
miami	miami
ฮอกไกโด	hokkaido
ฮั้ว	rigging
tin	tin
ขัดเกลา	purify
ประทัด	firecrackers
ประทัด	firecracker
โอลิมปิค	olympic
โอลิมปิค	olympian
justin	justin
ของชำ	grocery
ของชำ	groceries
steam	steam
copd	copd
แชมเปญ	champagne
เชง	cheng
ท้อแท้	frustrating
ท้อแท้	frustrated
ท้อแท้	discouraged
ซิลเวีย	sylvia
กระจกตา	cornea
aud	aud
subordo	subordo
orthographic	orthographic
wikia	wikia
powerbomb	powerbomb
imf	imf
epa	epa
เรเน่	renee
ภราดรภาพ	brotherhood
รักแร้	armpits
รักแร้	armpit
dohc	dohc
gnome	gnome
javascript	javascript
marnay	marnay
dale	dale
exclusive	exclusive
คารวะ	homage
taxi	taxi
runner	runner
pad	pad
ศูนย์สูตร	equator
พันธนาการ	bondage
คนรวย	rich
เกาลัด	chestnut
เกาลัด	chestnuts
randy	randy
env	env
รีวิว	reviews
รีวิว	review
smtown	smtown
unity	unity
แมทท์	matt
ไวโอเล็ต	violet
acc	acc
kegg	kegg
croatia	croatia
corp	corp
เบ็ธ	beth
dodson	dodson
ทันใจ	instant
ใบปลิว	flyer
ใบปลิว	flyers
ชาวสวน	gardeners
corvus	corvus
สเปค	specification
สเปค	spec
สเปค	specs
duo	duo
โต้วาที	debate
yume	yume
แรคคูน	raccoon
แรคคูน	raccoons
tot	tot
sms	sms
ฉูดฉาด	gaudy
mrna	mrna
อเดล	adele
โกเบ	kobe
เบ่ง	push
ถั่วงอก	sprouts
jose	jose
farm	farm
wikiproject	wikiproject
แฮง	hank
intensive	intensive
bss	bss
ซึมซับ	absorb
ดื้อยา	resistant
รีก	creek
gps	gps
slogan	slogan
ถอนพิษ	antidote
bloch	bloch
โล้น	bald
โล้น	balding
ยั่วยวน	seduce
uae	uae
ฟินน์	finn
วิจารณญาณ	discretion
โซดา	soda
ฉี่	pee
ปลั๊ก	plug
ปลั๊ก	plugs
ตูนิส	tunis
ลูกปืน	bullet
ประสาทหลอน	delusional
แครอท	carrot
แครอท	carrots
zen	zen
ubuntu	ubuntu
twelve	twelve
rocky	rocky
ส้อม	fork
ส้อม	cutlery
pin	pin
จิตเวชศาสตร์	psychiatry
tcp	tcp
พีค	peak
iata	iata
ทัค	tuck
wordpress	wordpress
เม่า	moth
ฟู้ด	foods
โอ๊ต	oaks
โอ๊ต	oatmeal
โอ๊ต	oats
cfo	cfo
cev	cev
efefef	efefef
obj	obj
โรคจิตเภท	schizophrenic
โรคจิตเภท	schizophrenia
ตระหง่าน	towering
snap	snap
monogatari	monogatari
ไรย์	rye
จักรภพ	universe
presenter	presenter
blu	blu
julia	julia
หูด	wart
หูด	warts
การุณย์	karun
wikisource	wikisource
zip	zip
สันทนาการ	rec
สันทนาการ	recreation
สันทนาการ	recreational
สันทนาการ	leisure
cad	cad
วอร์เรน	warren
gay	gay
ขยี้	crush
ขยี้	crushed
flickr	flickr
diva	diva
equus	equus
potato	potato
dancer	dancer
ฟิวส์	fuses
ฟิวส์	fuse
ein	ein
ทรอมโบน	trombone
dms	dms
เซธ	seth
จอยซ์	joyce
classe	classe
sio	sio
ufo	ufos
ufo	ufo
ไม้บรรทัด	ruler
blossom	blossom
ยาบ้า	meth
สินสอด	dowry
vitamin	vitamin
เกียด	kia
จิตใต้สำนึก	subconscious
เกี๊ยว	dumplings
เกี๊ยว	dumpling
userbox	userbox
bmw	bmw
yesno	yesno
ฟ้าร้อง	thunder
แม่หม้าย	widow
jurassic	jurassic
suv	suvs
suv	suv
เงื่อนงำ	clue
เงื่อนงำ	clues
dell	dell
กระพือ	flapping
กระพือ	flap
เสือก	tiger
diuretics	diuretics
bts	bts
miguel	miguel
ดังๆ	loud
สิงค์	haunted
ไฮเวย์	highway
ชำแหละ	dissect
ชำแหละ	dissection
จู๋	penis
จู๋	dicks
จู๋	cock
lam	lam
ประภาคาร	lighthouse
เบาๆ	gently
cleveland	cleveland
vip	vip
ดอกจัน	asterisk
kor	kor
andreas	andreas
sme	sme
char	jis
เหน็ดเหนื่อย	fatigue
ไมเกรน	migraine
ไมเกรน	migraines
ไนต์คลับ	nightclub
โผ	dart
timeaxis	timeaxis
render	render
แคชเมียร์	cashmere
แคชเมียร์	kashmiri
แคชเมียร์	kashmir
โคลนนิ่ง	clone
โคลนนิ่ง	cloning
ทอร์เรส	torres
รีโมท	remote
ฮันท์	hunt
อิมเมจ	image
โคบอลต์	cobalt
infinity	infinity
คู่ควร	worthy
nancy	nancy
ยุ้ง	barn
อัลลอฮ์	god
ซุกซน	naughty
มึนเมา	intoxicated
มึนเมา	debauchery
agar	agar
คร่ำครวญ	moaning
superordo	superordo
lil	lil
michelle	michelle
บุคลิกลักษณะ	personality
mpls	mpls
echo	echo
pcr	pcr
โพลล์	polls
โพลล์	poll
โบลท์	bolt
credit	credit
nguyen	nguyen
ก๊อก	knock
ไฮไลท์	highlighted
ไฮไลท์	highlights
ไฮไลท์	highlight
seo	seo
springer	springer
สอย	shiv
ovw	ovw
ฮิป	hip
เครื่องร่อน	glider
มันเทศ	yam
reuters	reuters
polyhedra	polyhedra
mansi	mansi
khanty	khanty
เอื้อย	zap
confederations	confederations
prov	prov
macau	macau
rey	rey
copper	copper
ไดอะแกรม	diagrams
mas	mas
faq	faq
แฮมเบอร์เกอร์	hamburger
แฮมเบอร์เกอร์	hamburgers
ลีห์	leigh
vaccinium	vaccinium
โลโล	lolo
sekai	sekai
เฮโรอีน	heroin
bezirk	bezirk
mrt	mrt
sting	sting
zhao	zhao
kpa	kpa
vols	vols
airplay	airplay
rchb	rchb
tar	tar
กะพริบ	blink
เอ็มม่า	emma
แบบสอบถาม	questionnaire
attitude	attitude
kami	kami
โรงรถ	garage
len	len
nest	nest
layout	layout
gadget	gadget
ภวังค์	trance
ภวังค์	unconsciousness
hrs	hrs
ซิงค์	synced
ซิงค์	sync
สร่าง	sober
มอร์ฟีน	morphine
เฟร็ด	fred
พูห์	pooh
ying	ying
neckbreaker	neckbreaker
โฟลเดอร์	folders
โฟลเดอร์	folder
bwv	bwv
hai	hai
rockman	rockman
ffa	ffa
เมกะไบต์	mib
เมกะไบต์	megabytes
เท่ห์	cool
ไขควง	screwdriver
bon	bon
ratp	ratp
exo	exo
premium	premium
mst	mst
exe	exe
pagasa	pagasa
alocasia	alocasia
tsunami	tsunami
เดลาแวร์	delaware
ล้วนๆ	purely
หนุ่มๆ	boys
คาร์ไลล์	carlisle
arsenal	arsenal
กระโถน	potty
xiv	xiv
triumph	triumph
hotmail	hotmail
crest	crest
ridl	ridl
ฟีเจอร์	feature
ฟอยล์	foil
infoboxes	infoboxes
mbps	mbps
เคอร์เนล	kernel
mbs	mbs
แอสไพริน	aspirin
adm	adm
cash	cash
คอนโทรล	control
หดหู่	depressed
หดหู่	depressing
หดหู่	depression
boo	boo
hoya	hoya
transformers	exhibitions
gsd	gsd
สุขใจ	happy
ตุ๋ย	pedophile
boku	boku
ซูม	zoom
ncbi	ncbi
thesis	thesis
เทต	tate
utf	utf
jang	jang
โคเคน	coke
โคเคน	cocaine
frozen	frozen
mammalia	mammalia
โพซิตรอน	positrons
initiative	initiative
plotarea	plotarea
เบ็ดเตล็ด	trivia
เบ็ดเตล็ด	misc
เบ็ดเตล็ด	miscellaneous
npc	npc
xyz	xyz
ดาการ์	dakar
safari	safari
รังสีวิทยา	radiology
โนห์	noh
transfermarkt	transfermarkt
ปลาบปลื้ม	ecstatic
rai	rai
โอ๊ย	ugh
dateformat	dateformat
dino	dino
ชอล	chul
tattoo	tattoo
ละเมอ	sleepwalking
เคฟ	kev
mev	mev
กว้าน	winch
ท่องจำ	memorize
ping	ping
melbourne	melbourne
undef	undef
lindl	lindl
บังเกอร์	bunker
อิสลามาบัด	islamabad
mia	mia
bride	bride
ภูเขาน้ำแข็ง	iceberg
chuck	chuck
ไฝ	mole
ไฝ	moles
petit	petit
noaa	noaa
สลิป	slip
cruz	cruz
finale	finale
maya	maya
dolby	dolby
เบลค	blake
jstor	jstor
เน็ด	ned
ล็อบบี้	lobby
ซ้าบ	saab
aki	aki
palestine	palestine
kate	kate
fhm	fhm
กรี๊ด	scream
pmc	pmc
อีเจียน	aegean
vita	vita
tdr	tdr
iaea	iaea
ซิบ	zipper
โพส	post
โพส	pose
แฮ็ก	hacking
แฮ็ก	hacked
แฮ็ก	hack
icao	icao
นอกใจ	cheating
ขายส่ง	wholesaler
ขายส่ง	wholesale
sap	sap
puisne	puisne
บดขยี้	crushing
บดขยี้	crushed
textcolor	textcolor
wbu	wbu
โปสการ์ด	postcard
โปสการ์ด	postcards
isp	isp
engl	engl
gpu	gpu
ทุบตี	beatings
cvt	cvt
สปา	spa
สปา	spas
tbl	tbl
mbit	mbit
ลค	blake
chill	chill
cyp	cyp
origargs	origargs
pid	pid
nbt	nbt
duty	duty
คอรัปชั่น	corrupt
din	din
spd	spd
orbiter	orbiter
phylogeny	phylogeny
che	che
nabf	nabf
แพ็คเกจ	pack
แพ็คเกจ	plan
แพ็คเกจ	package
บอยด์	boyd
วอลเล่ย์	volleyball
sans	sans
acm	acm
โซนาร์	sonar
gym	gym
ncaa	ncaa
ช่ำชอง	skillful
seventeen	seventeen
เซอร์ไพรส์	surprise
rune	rune
ars	ars
อาเมน	amen
ฟลอเรส	flores
เท็ต	tate
ความเฉื่อย	inertia
ฮาร์ป	harp
memphis	memphis
ดิ๊ก	dick
แคลอรี่	calorie
แคลอรี่	calories
โคมลอย	lanterns
univ	univ
bdfutbol	bdfutbol
พล็อต	plot
getparent	getparent
roca	roca
เป๊ะ	exactly
annie	annie
ไถนา	plow
ucb	ucb
xtreme	xtreme
bella	bella
เมอร์ลิน	merlin
ตะเข็บ	stitching
แชด	chad
มูส	moose
vpn	vpn
resistivity	resistivity
chelsea	chelsea
coin	coin
ป้ายสี	smears
หอน	howling
หอน	spear
ทรัม	trump
titan	titan
wet	wet
หลงลืม	neglect
เตาผิง	fireplace
บาร์บูดา	barbuda
อัลฟ่า	alpha
ขนมอบ	baking
ขนมอบ	pastry
สดๆ	fresh
เห็บ	fleas
crh	crh
mpa	mpa
prof	prof
หวีด	whistle
บรูก	bru
ลูค	luke
สวมรอย	bogs
บาร์เลย์	barley
ปู่ย่า	gran
ppp	ppp
funky	funky
aut	aut
pete	pete
อาร์เรย์	array
อินเตอร์เน็ต	internet
nominator	nominator
อินเดียนา	indiana
namida	namida
แฮกเกอร์	hacker
แฮกเกอร์	hackers
nikki	nikki
benz	benz
scalemajor	scalemajor
piaget	piaget
adsl	adsl
hdtv	hdtv
burton	burton
vestibular	vestibular
lcd	roundup
lcd	lcd
gakuen	gakuen
steindachner	steindachner
hay	hay
แอป	app
แอป	apps
cid	cid
kfc	kfc
นกหวีด	whistle
นกหวีด	whistles
bie	bie
ต้นคอ	neck
chrome	chrome
taoiseach	taoiseach
ก้าวก่าย	intrusive
sim	sim
vec	vec
amp	amp
blason	blason
แลป	lab
ขี้เหร่	ugly
พรีเมียม	premium
aru	aru
uri	uri
uri	uris
koei	koei
เทด	ted
ชาร์ล็อตต์	charlotte
wikimania	wikimania
มีดโกน	razor
sophie	sophie
ลูกเห็บ	hail
iro	iro
อุ้งเท้า	paws
อุ้งเท้า	paw
ploceus	ploceus
ลิปสติก	lipstick
ronaldo	ronaldo
ergaster	ergaster
reptilia	reptilia
หนักใจ	troubling
sos	sos
ฮวา	hwa
อายัด	frozen
ssp	ssp
ซุซุ	zeus
tabernaemontana	tabernaemontana
cts	cts
dallwitz	dallwitz
มุทะลุ	reckless
สังเกตุ	notice
แก้วหู	eardrums
pgp	pgp
eddy	eddy
visa	visa
ขนตา	eyelash
ขนตา	eyelashes
ขนตา	lashes
symphonie	symphonie
ddr	ddr
อาร์กิวเมนต์	arguments
uhf	uhf
crush	crush
reg	reg
ซอฟแวร์	software
ocinsoutput	ocinsoutput
lancer	lancer
mda	mda
iwgp	iwgp
เงินปันผล	dividends
mari	mari
อะเดล	adele
alignbars	alignbars
concepts	concepts
smes	smes
temminck	temminck
skill	skill
sud	sud
โฮมเพจ	homepage
โลชั่น	lotion
มอเตอร์เวย์	motorway
ลาเวนเดอร์	lavender
ฟีด	feed
ฟีด	feeds
บัซ	buzz
viva	viva
sql	sql
meshname	meshname
ฟกช้ำ	contusion
vtec	vtec
ไปรษณียบัตร	postcard
ตรรก	rational
ตรรก	logical
ตรรก	logic
lte	lte
passive	passive
อาร์ตี	artie
dao	dao
pascal	pascal
ขยะแขยง	disgusting
burke	burke
ปั๋ง	boner
transcript	transcript
วิป	whipped
โลเวลล์	lowell
kitty	kitty
หลาบ	yards
เต๋	teh
มัสตาร์ด	mustard
ดอกจิก	clubs
hood	hood
น้ำมูก	snot
schott	schott
ร่ำไห้	weep
หลงกล	fooled
eur	eur
alam	alam
กุญแจมือ	handcuffs
tona	tona
โปรไฟล์	profile
โปรไฟล์	profiles
จาว	shao
livesey	livesey
sais	sais
ind	ind
linn	linn
clover	clover
cheese	cheese
riaj	riaj
จู๊ด	jude
wto	wto
perciformes	perciformes
บูกิต	bukit
พอกพูน	accretion
moe	moe
เบลโล	bello
ing	ing
ctrl	ctrl
pfc	pfc
dota	dota
pac	pac
ชุล	chul
nums	nums
ufc	ufc
requiem	requiem
รปภ	security
elsevier	elsevier
emma	emma
หัวนม	nipples
หัวนม	nipple
หัวนม	tits
heuristic	heuristic
mohd	mohd
plc	plc
raven	raven
แล็ปท็อป	laptops
แล็ปท็อป	laptop
เบลก	blake
lucy	lucy
กานพลู	clove
dinosauria	dinosauria
โป๊กเกอร์	poker
nfl	nfl
dengeki	dengeki
lip	lip
moss	moss
ปลอกคอ	collar
ปลอกคอ	collars
โฮล์มส์	holmes
ไมลส์	miles
sitout	sitout
civic	civic
leiden	leiden
iec	iec
naruto	naruto
tlc	tlc
carmen	carmen
ท็อปส์	tops
ตื้นๆ	shallow
หนองใน	gonorrhea
mustela	mustela
ลอต	lott
henle	henle
ลินซ์	lynch
คีท	keith
elephas	elephas
dubai	dubai
ทรัมเปต	trumpet
กระวนกระวาย	anxious
เหิร	lifts
tao	tao
gis	gis
สวยๆ	beautiful
สวยๆ	pretty
sdtv	sdtv
ภาพยนต์	movie
ภาพยนต์	movies
cma	cma
mep	mep
spec	spec
asa	asa
rue	rue
ฉุบ	scissors
mou	mou
พุพอง	blister
นํ้า	water
คราง	moan
gorm	gorm
psr	psr
uprising	junta
slim	slim
curry	curry
scaleminor	scaleminor
templatedata	templatedata
zonal	zonal
rft	rft
exp	exp
det	det
orientalis	orientalis
corticosteroids	corticosteroids
osprey	osprey
directx	directx
merriam	merriam
รัดรูป	rudd
miocene	miocene
zanthoxylum	zanthoxylum
slammy	slammy
luca	luca
ตาชั่ง	scales
evergreen	evergreen
ใคร่ครวญ	reflect
ใคร่ครวญ	contemplating
mmorpg	mmorpg
nic	nic
ผสมเทียม	insemination
rubiaceae	rubiaceae
ขวนขวาย	earn
njpw	njpw
limnonectes	limnonectes
คังนัม	gangnam
rae	rae
tls	tls
wmf	wmf
pwg	pwg
idn	idn
encyclopaedia	encyclopaedia
bandai	bandai
มิจฉาชีพ	crooks
ucla	ucla
เอทีเอ็ม	atm
เอทีเอ็ม	atms
wta	wta
แรนด์	rand
ยางลบ	eraser
นมวัว	cow
terma	terma
ped	ped
sdn	sdn
เมนเฟรม	mainframe
จรจัด	tramp
จรจัด	homeless
pizza	pizza
rem	rem
เซรามิค	ceramic
เซรามิค	ceramics
cis	cis
flop	flop
dek	dek
phuket	phuket
nrt	nrt
thx	thx
bhd	bhd
cotton	cotton
cze	cze
ipod	ipod
ipod	ipods
ทำหมัน	sterilization
ไซนัส	sinuses
ไซนัส	sinus
hokusai	hokusai
ips	ips
ole	ole
chennai	chennai
peng	peng
solaris	solaris
ปั๊บ	voilà
สุขารมณ์	hedonism
ดีซ่าน	jaundice
comp	comp
บาร์บีคิว	barbecue
บาร์บีคิว	bbq
บาร์บีคิว	barbeque
hcl	hcl
baba	baba
ems	ems
sohc	sohc
เทียนไข	candle
hoc	hoc
rafinesque	rafinesque
โคไซน์	cosine
regie	regie
เก๊าท์	gout
บู้	boo
eos	eos
tidal	tidal
เพียซ	pierce
pdp	pdp
เมก	meg
shtml	shtml
sue	sue
terme	terme
als	als
cites	cites
birdlife	birdlife
emerald	emerald
bas	bas
percussion	percussion
แฮ็ค	hacked
รีซ	reese
จอร์น	john
ตะคริว	cramping
ตะคริว	cramp
plantae	plantae
จำนอง	mortgage
lccn	lccn
oecd	oecd
subclassis	subclassis
sig	sig
ตูด	ass
ตูด	butt
racer	racer
พลั่ว	shovels
พลั่ว	shovel
linecolor	linecolor
bodyslam	lmfao
irn	irn
วิสกี้	whiskey
วิสกี้	whisky
benth	benth
basestyle	basestyle
ยอร์น	york,
afp	afp
ฟอร์แมต	format
lycodon	lycodon
คิงสตัน	kingston
จิ๋ม	pussy
ไดร์ฟ	drive
lpg	lpg
bacillus	bacillus
wifi	wifi
msv	msv
ipad	ipad
afanasieff	afanasieff
สำลัก	choke
สำลัก	choking
cmos	cmos
gmelin	gmelin
เบรค	brake
เบรค	brakes
ดอท	dot
marksize	marksize
กลมๆ	round
mcdonald	mcdonald
mcdonald	mcdonalds
nist	nist
มัดจำ	deposit
vhs	vhs
kde	kde
medlineplus	medlineplus
wikibooks	wikibooks
bkk	bbk
อีเมล์	email
lothringen	lothringen
ไนลอน	nylon
ทะลึ่ง	cheeky
ปมด้อย	inferiority
albomarginata	albomarginata
lopez	lopez
gre	gre
เขย่ง	tiptoe
squalus	squalus
ลินช์	lynch
goldblatt	goldblatt
กิกิ	kiki
sato	sato
apa	apa
ต้อกระจก	cataract
ifpi	ifpi
forsskål	forsskål
gpa	gpa
lightsteelblue	lightsteelblue
sauvage	sauvage
อินเตอร์เฟส	interface
stardust	stardust
sao	sao
aol	aol
ลอเรล	laurel
ยาสลบ	anesthesia
ก๊าด	kerosene
hon	hon
rss	rss
แบส	bass
ฝักบัว	shower
ฝักบัว	showers
ปาโล	palo
คลัสเตอร์	cluster
คลัสเตอร์	clusters
tee	tee
nom	nom
wittgenstein	wittgenstein
แมป	mapped
kmc	kmc
geforce	geforce
อีสุกอีใส	pox
nano	nano
casting	casting
iss	iss
bamboo	bamboo
nigra	nigra
miq	miq
gmail	gmail
cyworld	cyworld
ผ้าเช็ดหน้า	handkerchiefs
ผ้าเช็ดหน้า	handkerchief
เมดเลย์	medley
ipcc	ipcc
itf	itf
nong	nong
geoffroy	geoffroy
มอลต์	malt
byp	byp
เนด	ned
เหยือก	mug
เหยือก	pitcher
เหยือก	jug
monobook	monobook
gprs	gprs
playmore	playmore
fips	fips
watt	watt
veitchii	veitchii
โปรโมชัน	promo
โปรโมชัน	promotion
psu	psu
editpage	editpage
habilis	habilis
eka	eka
dodge	dodge
eia	eia
อมยิ้ม	lollipop
yves	yves
ซ้า	saab
universität	universität
ซอด	zod
kin	kin
นัมบะ	namba
ras	ras
ลีท	leith
หกล้ม	tripping
อุ้งมือ	paws
sprint	sprint
nyc	nyc
otome	otome
barneby	barneby
gee	gee
mma	mma
panoramio	panoramio
ligne	ligne
แพม	pam
จดจ่อ	focused
australopithecus	australopithecus
vhf	vhf
evo	evo
shinee	shinee
ทรัมป์	trump
timeshift	timeshift
ich	ich
doki	doki
johan	johan
คีบ	forceps
bust	bust
อรรถประโยชน์	utilities
อรรถประโยชน์	utility
rsa	rsa
ฮิบ	hip
metacritic	metacritic
โบรกเกอร์	broker
โบรกเกอร์	brokers
พาราฟิน	paraffin
cms	cms
abcd	abcd
arp	arp
uswa	uswa
biz	biz
dude	dude
deutsch	deutsch
ฮโย	hyo
ต้อหิน	glaucoma
subpages	subpages
gotta	gotta
หี	cunt
geniculate	geniculate
pga	pga
ไมก้า	micah
mont	mont
svk	svk
จัว	chua
เซสชัน	session
เซสชัน	sessions
capo	capo
บัดดี้	buddy
เอะอะ	fuss
pantene	pantene
itc	itc
antagonists	antagonists
clays	clays
tko	tko
vlan	vlan
panasonic	panasonic
guideline	guideline
odbc	odbc
infraordo	infraordo
leguminosae	leguminosae
naka	naka
พาธ	path
ดุลยพินิจ	discretion
cochrane	cochrane
คอมมูน	commune
nds	nds
gogo	gogo
aac	aac
société	société
dia	dia
adr	adr
kentucky	kentucky
ไฮไลต์	highlighted
ไฮไลต์	highlight
ไฮไลต์	highlights
ลูกวัว	calf
raiders	raiders
ซีรี่ส์	series
longman	longman
ipc	ipc
mah	mah
aps	aps
แชต	chat
capensis	capensis
österreich	österreich
cfm	cfm
fps	fps
kew	kew
cwa	cwa
กรน	snoring
pardus	pardus
chikara	chikara
joker	joker
cambodge	cambodge
fcc	fcc
เสริฟ	serve
ataxia	ataxia
ลุด	cords
stadion	stadion
pog	pog
bash	bash
อืม	well
hdmi	hdmi
mundo	mundo
titlebackground	titlebackground
เธน	thane
sumatrana	sumatrana
ถาก	graze
staphylococcus	staphylococcus
แท่	tae
tel	tel
ฟิค	fig
delle	delle
gam	gam
coco	coco
palgrave	palgrave
osama	osama
kinki	kinki
japonica	japonica
kinase	kinase
อัลเฟร็ด	alfred
nec	nec
cdt	cdt
duomo	duomo
nvidia	nvidia
isi	isi
pubmed	pubmed
ส่วนลด	discount
ส่วนลด	discounts
ค่าสัมบูรณ์	absolute
tung	tung
tero	tero
xvi	xvi
hdl	hdl
arxiv	arxiv
csv	csv
gin	gin
วัตถุนิยม	materialistic
วัตถุนิยม	materialism
parc	parc
eco	eco
kokoro	kokoro
université	université
facebuster	facebuster
nida	nida
liebe	liebe
muay	muay
เล้าโลม	foreplay
amor	amor
fernández	fernández
bayern	bayern
ผิวปาก	whistle
ผิวปาก	whistling
mis	mis
ใสๆ	doe
saab	saab
vtr	vtr
amorphous	amorphous
anhalt	anhalt
immunoglobulin	immunoglobulin
shortsummary	shortsummary
ati	ati
gmbh	gmbh
แฮ่	hae
psy	psy
intl	intl
tnt	tnt
natalie	natali
ปฐมนิเทศ	orientation
tam	tam
duméril	duméril
amadeus	amadeus
ลงๆ	swings
โบกมือ	waving
โบกมือ	wave
อัลลอฮฺ	god
württemberg	württemberg
lepus	lepus
มอซ	moz
harpercollins	harpercollins
ไลค์	like
domenico	domenico
ชอล์ก	chalk
เดนี	dani
ไฟแนนซ์	financing
ไฟแนนซ์	finance
เฝือก	cast
ppi	ppi
berhad	berhad
moulin	moulin
mayo	mayo
proc	proc
เกรียม	charred
uht	uht
dcc	dcc
nicholson	nicholson
jfk	jfk
bashkortostan	bashkortostan
mov	mov
ฟลุ๊ค	fluke
rsu	rsu
fallax	fallax
mee	mee
กระเจี๊ยบ	gumbo
vga	vga
scr	scr
fcl	fcl
บล็อค	block
บล็อค	blocked
proud	proud
slr	slr
ppv	ppv
บาดทะยัก	tetanus
cfc	cfc
trend	trend
outlook	outlook
lacépède	lacépède
sissel	sissel
ลูปัส	lupus
ชีก	sheik
squamata	squamata
inflow	inflow
eis	eis
lounge	lounge
moonsault	moonsault
บลูเบิร์ด	bluebird
พิธีรีตอง	formalities
gaon	gaon
checkuser	checkuser
govaerts	govaerts
meshnumber	meshnumber
beau	beau
มโนธรรม	conscience
cmu	cmu
palatinate	palatinate
เหน็บแนม	mockery
ร้อนๆ	hot
เงินผ่อน	financing
erminea	erminea
hpa	hpa
โรงนา	barn
archiveurl	archiveurl
nadh	nadh
arius	arius
ecu	ecu
ขนลุก	creepy
bcd	bcd
แปรงสีฟัน	toothbrush
แปรงสีฟัน	toothbrushes
dev	dev
แล็ป	laboratory
แล็ป	lab
som	som
saurischia	saurischia
suzumiya	suzumiya
กักตุน	hoarding
oxidase	oxidase
stm	stm
gagnep	gagnep
whitesmoke	whitesmoke
pod	pods
irq	irq
insight	insight
lyn	lyn
musashi	musashi
ohv	ohv
formatdate	formatdate
gcc	gcc
wwwf	wwwf
ซักรีด	laundry
pcall	pcall
tyson	tyson
sharpe	sharpe
แฮก	hack
coo	coo
คูปอง	coupons
reductase	reductase
hug	hug
ราจ	raj
เย็นๆ	cold
pst	pst
dante	dante
jelly	jelly
eigenmann	eigenmann
cassini	cassini
république	république
slip	slip
och	och
ter	ter
คนสวน	gardener
kawasaki	kawasaki
backgroundcolors	backgroundcolors
iep	iep
éditions	éditions
สต๊อก	stock
sfsr	sfsr
aspergillus	aspergillus
pulp	pulp
doubleday	doubleday
voivodeship	voivodeship
fitzinger	fitzinger
งุนงง	daze
metallicity	metallicity
amg	amg
ducal	ducal
uni	uni
dab	dab
quicktime	quicktime
กระดก	downed
otoko	otoko
agassiz	agassiz
lac	lac
นมผง	formula
srb	srb
nulla	nulla
hatsukoi	hatsukoi
nrc	nrc
wikibase	wikibase
aviator	aviator
philips	philips
gba	gba
พุดดิ้ง	pudding
utrecht	utrecht
gainsboro	gainsboro
พาโล	palo
ute	ute
tsu	tsu
mango	mango
milne	milne
