eddy	eddy
visa	vize
visa	viza
ddr	ddr
อาร์กิวเมนต์	argumente
อาร์กิวเมนต์	argumenti
uhf	uhf
crush	crush
reg	reg
ซอฟแวร์	softver
ocinsoutput	ocinsoutput
แฟนซี	fancy
mda	mda
mari	mari
อะเดล	adela
alignbars	alignbars
concepts	koncepti
smes	msp
skill	vještine
โฮมเพจ	homepage
มอเตอร์เวย์	autoceste
ฟีด	hrani
บัซ	baz
viva	viva
sql	sql
meshname	meshname
bodystyle	bodystyle
ไปรษณียบัตร	dopisnica
ตรรก	racionalno
ตรรก	logično
ตรรก	logičan
ตรรก	logika
lte	lte
passive	pasivne
passive	pasivno
passive	pasivna
pascal	pascal
transcript	transcript
kitty	kiti
ดอกจิก	klubovi
ดอกจิก	klubova
hood	hood
autoconfirmed	autoconfirmed
schott	schott
eur	eur
alam	alam
กุญแจมือ	lisice
โปรไฟล์	profil
จาว	shao
sais	sais
ind	ind
linn	linn
clover	clover
cheese	sir
จู๊ด	judea
จู๊ด	jude
บูกิต	bukit
พอกพูน	akrecija
moe	moa
เบลโล	bello
turismo	turismo
ing	ing
ctrl	ctrl
pfc	pfk
pac	pac
ชุล	chul
sortable	sortable
nums	nums
ufc	ufc
requiem	requiem
รปภ	obezbjeđenje
รปภ	sigurnost
elsevier	elsevier
emma	ema
emma	emma
heuristic	heuristika
mohd	mohd
plc	plc
raven	gavran
raven	raven
lorem	lorem
แล็ปท็อป	laptop
เบลก	blake
lucy	lucy
กานพลู	klinčić
ordre	ordre
โป๊กเกอร์	poker
nfl	nfl
moss	mos
โฮล์มส์	holmes
โฮล์มส์	holmesa
ไมลส์	miles
ไมลส์	milja
ไมลส์	km
civic	civic
civic	građanskog
civic	građanske
civic	građanski
leiden	leiden
iec	iec
tlc	tlc
carmen	carmen
extensor	extensor
ตื้นๆ	plitkih
retval	retval
mustela	mustela
ลินซ์	lynch
คีท	keith
elephas	elephas
dubai	dubai
ทรัมเปต	truba
tao	tao
gis	gis
สวยๆ	lijepe
สวยๆ	lijepa
สวยๆ	prilično
สวยๆ	pretty
ภาพยนต์	film
ภาพยนต์	filmovi
ภาพยนต์	filmova
cma	cma
spec	spec
asa	asa
rue	rue
ฉุบ	makaze
นํ้า	voda
psr	psr
slim	slim
curry	kari
scaleminor	scaleminor
templatedata	templatedata
rft	rft
exp	exp
det	det
orientalis	orientalis
loaddata	loaddata
osprey	osprey
directx	directx
merriam	merriam
รัดรูป	rudd
miocene	miocena
luca	luca
evergreen	evergreen
ใคร่ครวญ	odražavati
ใคร่ครวญ	odražavaju
titleclass	titleclass
mmorpg	mmorpg
nic	nic
ผสมเทียม	oplođenje
ผสมเทียม	oplodnju
rubiaceae	rubiaceae
ขวนขวาย	stiču
rae	rae
tls	tls
mtc	mtc
wmf	wmf
encyclopaedia	enciklopedije
encyclopaedia	enciklopedija
bandai	bandai
ucla	ucla
เอทีเอ็ม	atm
wta	wta
แรนด์	rand
topicid	topicid
นมวัว	krava
ped	ped
จรจัด	tramp
rem	rem
เซรามิค	keramika
เซรามิค	keramika
cis	cis
flop	tropa
nrt	nrt
thx	thx
bhd	bhd
cotton	pamuk
ipod	ipod
ไซนัส	sinus
setmetatable	setmetatable
hokusai	hokusai
ole	ole
chennai	chennai
peng	peng
solaris	solaris
ปั๊บ	voilà
สุขารมณ์	hedonizam
ดีซ่าน	žutica
comp	pratioca
hcl	hcl
baba	baba
ems	ems
เทียนไข	svijeće
hoc	hoc
rafinesque	rafinesque
บู้	bu
บู้	boo
subfamilia	subfamilia
eos	eja
เพียซ	pierce
pdp	pdp
เมก	meg
shtml	shtml
sue	tužiti
terme	terme
als	als
cites	navodi
emerald	smaragdno
bas	bas
percussion	udaraljke
รีซ	ris
จอร์น	john
plantae	plantae
lccn	lccn
oecd	oecd
disp	disp
sig	sig
ตูด	ass
ตูด	tur
linecolor	linecolor
irn	irn
วิสกี้	viski
วิสกี้	viski
benth	benth
basestyle	basestyle
afp	afp
ฟอร์แมต	formatu
ฟอร์แมต	formata
ฟอร์แมต	format
คิงสตัน	kingston
ไดร์ฟ	drive
ไดร์ฟ	vozi
bacillus	bacillus
wifi	wifi
getcurrenttitle	getcurrenttitle
pollicis	pollicis
ambox	ambox
msv	msv
ipad	ipad
cmos	cmos
เบรค	brake
ดอท	tačka
marksize	marksize
กลมๆ	rundu
mcdonald	mcdonald
nist	nist
มัดจำ	depozita
vhs	vhs
kde	kde
medlineplus	medlineplus
wikibooks	wikibooks
alternativemap	alternativemap
อีเมล์	mail
อีเมล์	email
lopez	lopez
gre	gre
ลินช์	lynch
กิกิ	kiki
sato	sato
datastyle	datastyle
apa	apa
ifpi	ifpi
gpa	gpa
lightsteelblue	lightsteelblue
sauvage	sauvage
อินเตอร์เฟส	interfejs
stardust	stardust
sao	sao
aol	aol
ลอเรล	laurel
perrow	perrow
ยาสลบ	anestezije
ก๊าด	kerozin
hon	hon
rss	rss
coliseo	coliseo
aec	aec
แบส	bas
ปาโล	palo
คลัสเตอร์	jato
คลัสเตอร์	skupovi
คลัสเตอร์	skupova
tee	tee
nom	nom
wittgenstein	wittgenstein
avec	avec
geforce	geforce
อีสุกอีใส	pox
nano	nano
casting	casting
iss	iss
nigra	nigra
miq	miq
gmail	gmail
เมดเลย์	medley
ipcc	ipcc
itf	itf
geoffroy	geoffroy
มอลต์	malt
เนด	neda
เหยือก	mug
เหยือก	bacač
เหยือก	jug
monobook	monobook
watt	vat
โปรโมชัน	promo
โปรโมชัน	promocija
habilis	habilis
eia	eia
citationclass	citationclass
yves	yves
ซ้า	saab
universität	universität
amet	amet
kyaw	kyaw
ras	ras
ลีท	leith
sprint	sprint
nyc	nyc
publicationdate	publicationdate
gee	gee
panoramio	panoramio
ligne	ligne
แพม	pam
จดจ่อ	usmjereni
จดจ่อ	fokusirana
australopithecus	australopitek
ทรัมป์	trump
johan	johan
อรรถประโยชน์	komunalne
rsa	rsa
ฮิบ	hip
metacritic	metacritic
โบรกเกอร์	broker
cms	cms
abcd	abcd
arp	arp
biz	biz
dude	stari
ต้อหิน	glaucoma
subpages	subpages
hotcat	hotcat
pga	pga
mont	mont
svk	svk
ccccc	ccccc
เซสชัน	sjednicu
เซสชัน	sjednici
เซสชัน	sjednica
เซสชัน	sjednica
capo	capo
บัดดี้	buddy
itc	itc
panasonic	panasonic
guideline	guideline
infraordo	infraordo
leguminosae	leguminosae
พาธ	put
longus	longus
คอมมูน	komuna
nds	nds
gogo	gogo
aac	aac
société	société
dia	dija
adr	adr
util	util
globalsecurity	globalsecurity
kentucky	kentucky
imageright	imageright
ไฮไลต์	naglasili
ไฮไลต์	naglašena
ไฮไลต์	istakla
ไฮไลต์	isticanja
ไฮไลต์	istaknuta
ไฮไลต์	osvjetljava
ลูกวัว	tele
ซีรี่ส์	serija
ซีรี่ส์	seriji
longman	longman
ipc	ipc
mah	mah
aps	aps
แชต	chat
capensis	capensis
österreich	österreich
quis	quis
cfm	cfm
contentcat	contentcat
cccc	cccc
fps	fps
cwa	cwa
pardus	pardus
joker	joker
fcc	fcc
เสริฟ	služe
เสริฟ	služiti
ataxia	ataksija
demospace	demospace
อืม	pa
mundo	mundo
เธน	thane
staphylococcus	staphylococcus
แท่	tae
tel	tel
gam	gam
coco	coco
palgrave	palgrave
osama	osama
อัลเฟร็ด	alfred
nec	nec
nbsp	nbsp
duomo	duomo
nvidia	nvidia
pubmed	pubmed
ค่าสัมบูรณ์	apsolutni
ค่าสัมบูรณ์	apsolutna
tung	tung
tero	tero
xvi	xvi
hdl	hdl
arxiv	arxiv
csv	csv
gin	džin
วัตถุนิยม	materijalizam
parc	parc
eco	eko
eco	eco
kokoro	kokoro
université	université
nida	nida
liebe	liebe
amor	amor
tis	tis
fernández	fernández
bayern	bayern
mis	mis
ใสๆ	doe
saab	saab
vtr	vtr
anhalt	anhalt
shortsummary	shortsummary
ati	ati
gmbh	gmbh
psy	psy
tnt	tnt
eso	eso
natalie	natali
ปฐมนิเทศ	orijentacija
africana	africana
tam	tam
amadeus	amadeus
โบกมือ	mahali
โบกมือ	talas
อัลลอฮฺ	allah
อัลลอฮฺ	allaha
อัลลอฮฺ	allahu
อัลลอฮฺ	bog
württemberg	württemberg
harpercollins	harpercollins
ไลค์	kao
ไลค์	like
domenico	domenico
ชอล์ก	krede
เดนี	dani
ไฟแนนซ์	finansiranje
ไฟแนนซ์	finansije
ppi	ppi
moulin	moulin
mayo	mayo
proc	proc
uht	uht
dcc	dcc
nicholson	nicholson
jfk	jfk
primer	primer
bashkortostan	baškortostan
mov	mov
const	const
mpv	mpv
vga	vga
scr	scr
fcl	fcl
บล็อค	blokirati
บล็อค	blokiran
บล็อค	blokirao
บล็อค	blokirane
บล็อค	blokirali
บล็อค	blokirala
proud	ponosna
proud	proud
proud	ponosni
slr	slr
ppv	ppv
ssri	ssri
cfc	cfc
trend	trend
outlook	prognoza
squamata	ljuskaši
inflow	priliv
eis	eis
checkuser	checkuser
meshnumber	meshnumber
beau	beau
มโนธรรม	savjesti
cmu	cmu
palatinate	falačka
hominin	hominin
ร้อนๆ	hot
ร้อนๆ	vrelo
เงินผ่อน	finansiranje
hpa	hpa
โรงนา	barn
inset	inset
archiveurl	archiveurl
nadh	nadh
ecu	ecu
bcd	bcd
nobelprize	nobelprize
dev	dev
แล็ป	laboratoriji
แล็ป	laboratorija
แล็ป	laboratorija
แล็ป	laboratoriji
แล็ป	lab
som	som
saurischia	saurischia
stm	stm
msds	msds
insight	uvid
lyn	lyn
formatdate	formatdate
gcc	gcc
pcall	pcall
tyson	tyson
hug	hug
ราจ	raj
เย็นๆ	hladno
pst	pst
dante	dante
colhead	colhead
cassini	cassini
république	république
och	och
ter	ter
kawasaki	kawasaki
backgroundcolors	backgroundcolors
éditions	éditions
สต๊อก	berze
สต๊อก	dionica
สต๊อก	deonice
สต๊อก	dionice
sfsr	sfsr
aspergillus	aspergillus
doubleday	doubleday
voivodeship	vojvodstvo
sortkey	sortkey
งุนงง	daze
amg	amg
uni	uni
dab	dab
quicktime	quicktime
lac	lac
นมผง	formula
srb	srb
sevilla	sevilla
subtemplate	subtemplate
nrc	nrc
seds	seds
wikibase	wikibase
isnotempty	isnotempty
andante	andante
philips	philips
พุดดิ้ง	pudding
utrecht	utrecht
gainsboro	gainsboro
พาโล	palo
tsu	tsu
mango	mango
kato	kato
theodor	theodor
uncollapsed	uncollapsed
rec	rec
kbps	kbps
lightblue	lightblue
แรงๆ	batter
ordovician	ordovician
ติวเตอร์	tutor
puma	puma
syed	syed
giotto	giotto
hatnote	hatnote
โป๊ป	papa
interscope	interscope
ลมกรด	olujne
emp	emp
ddd	ddd
kappa	kappa
voip	voip
pargs	pargs
mein	mein
sono	sono
teatro	teatro
coauthors	coauthors
mild	blaga
mild	blagi
mild	blaži
mild	blage
ลีต	leith
sco	sco
ppt	ppt
fern	paprat
คาร์ไมเคิล	carmichael
ไบเบิ้ล	biblija
annales	annales
spam	oglasa
lite	lite
honneur	honneur
schleswig	schleswig
coord	coord
sis	sis
hendrik	hendrik
carpi	carpi
decca	decca
faa	vazduhoplovstva
fanny	fanny
electrophoresis	elektroforeza
sartre	sartre
txt	txt
เลินเล่อ	uništavanju
kabardino	kabardino
tdi	tdi
อ่างอาบน้ำ	kadi
อ่างอาบน้ำ	kupanje
phylogenetic	filogenetsko
checktype	checktype
ssl	ssl
dst	dst
tachi	tachi
aql	aql
burger	burger
arkive	arkive
ucl	ucl
แท็ป	tap
คาร์ลอ	carl
molly	moli
molly	molly
ฮอง	hong
gimp	gimp
valentin	valentin
schloss	schloss
lindbergh	lindbergh
isis	isis
réunion	reuniona
hist	hist
jacq	jacq
bmi	bmi
umts	umts
ไฟแช็ก	lahke
wikiquote	wikiquote
getz	getz
województwo	województwo
แรนดัล	randall
mcclelland	mcclelland
moments	trenutaka
moments	trenucima
edda	edda
ceeb	ceeb
แม็ท	met
แม็ท	matt
hobby	hobi
datavalue	datavalue
maison	maison
sar	sar
deutschen	deutschen
ucs	ucs
willd	willd
plainlinks	plainlinks
mainz	mainz
csa	csa
thirteen	trinaest
surrealism	nadrealizam
บารอมิเตอร์	barometar
vevent	vevent
leisure	rekreativnih
ait	ait
münster	münster
île	île
alb	alb
ncc	ncc
bbs	bbs
tvn	tvn
aura	auru
aura	aura
pliocene	pliocene
neue	neue
rosso	rosso
eduardo	eduardo
bing	bing
méxico	méxico
iptv	iptv
mun	mun
fef	fef
flex	flex
atl	atl
stadio	stadio
dagestan	dagestan
nacl	nacl
bpm	bpm
hystrix	hystrix
sto	sto
italiana	superkup
argonauta	argonauta
ngv	ngv
lozano	lozano
angiosperm	angiosperm
deutsches	deutsches
ams	ams
centro	centro
radeon	radeon
ria	ria
nin	ninski
pubchem	pubchem
innsbruck	innsbruck
tottenham	tottenham
tev	tev
dora	dora
อ๊ะ	ups
mime	mime
firewire	firewire
peterson	peterson
หนักๆ	heavy
หนักๆ	teški
หนักๆ	težak
หนักๆ	teška
หนักๆ	teške
birdman	birdman
std	std
std	polnih
wolfram	volfram
acta	acta
muller	muller
imax	imax
bung	bung
archivedate	archivedate
kerry	kerry
unhcr	unhcr
generalized	generalizirani
qld	qld
orchestre	orchestre
cups	pehari
pars	pars
illu	illu
guerra	guerra
msnbc	msnbc
pong	pong
tve	tve
blink	blink
iarc	iarc
magnet	magnet
toon	toon
nrhp	nrhp
bild	bild
courbet	courbet
gbp	gbp
cooh	cooh
อุ๊ย	ups
bam	bam
exodus	egzodus
arthropoda	arthropoda
rvr	rvr
msj	msj
rwd	rwd
lettres	lettres
igf	igf
nct	nct
มัลแวร์	malware
ora	ora
ucode	ucode
goto	goto
อัพเดท	ažurirana
pax	paks
nas	nas
ups	uspona
cod	cod
เคเบิ้ล	kabla
เลขาฯ	sekretar
leben	leben
deutschland	deutschland
lisbon	lisabon
tpe	tpe
ptsd	ptsd
haeckel	haeckel
topographic	topografsku
tbm	tbm
minna	minna
transliteration	transliteration
gamepad	gamepad
dyk	dyk
livre	livre
zita	zita
ไซปัน	saipan
gesellschaft	gesellschaft
cdu	cdu
fernandez	fernandez
transcluded	transcluded
mir	mir
girard	girard
bismuth	bizmut
cronquist	cronquist
droit	droit
korn	korn
dickson	dickson
nok	nok
ญาติๆ	rodbina
nnn	nnn
hotspur	hotspur
nabla	nabla
église	église
abovebelow	abovebelow
ชอปปิ้ง	kupovinu
citrate	citrat
superfamilia	superfamilia
miramax	miramax
bom	bom
กรีส	mast
uru	uru
noi	noi
siècle	siècle
cfa	cfa
república	república
crocodylus	crocodylus
ไมโล	milo
nucleotide	nukleotid
ano	ano
quantitative	kvantitativna
dtv	dtv
kirchner	kirchner
เปียนโน	klavir
trachypithecus	trachypithecus
ดอยช์	deutsche
slalom	slalom
macbook	macbook
pseudomonas	pseudomonas
unitary	unitarna
ferreira	ferreira
ดินเนอร์	večera
ดินเนอร์	večeru
ดินเนอร์	večere
michi	michi
bvm	bvm
mazda	mazda
ไกส์	skype
mimi	mimi
กิลเลส	gillespie
nenets	nenečki
avatar	avatar
omim	omim
ssc	ssc
powerpc	powerpc
coe	ve
pennsylvanian	pennsylvanian
wikinews	wikivijesti
dvořák	dvořák
nosferatu	nosferatu
เลอะเทอะ	mess
taxon	takson
chapterurl	chapterurl
ทัณฑ์บน	uslovnu
ทัณฑ์บน	uslovno
ทัณฑ์บน	uslovne
fai	fai
petite	petite
études	études
broker	broker
continuum	hipoteza
fia	fia
ซิการ์	cigara
adb	adb
ดรอป	kap
ดรอป	pad
electronegativity	elektronegativnost
henrik	henrik
ouest	ouest
bafta	bafta
การขนส่งมวลชน	tranzitna
การขนส่งมวลชน	tranzitne
การขนส่งมวลชน	tranzit
loc	loc
เมกะเฮิรตซ์	mhz
sixteen	šesnaest
galerie	galerie
khabarovsk	habarovsk
oakland	oakland
nadph	nadph
tensor	tensor
emedicine	emedicine
oro	oro
นู่	nuh
heidelbergensis	heidelbergensis
กระเด้ง	bounce
ขาอ่อน	bedra
dns	dns
shonen	shonen
acn	acn
adagio	adagio
แชท	chat
mcfarland	mcfarland
africanus	africanus
evenodd	evenodd
moo	moo
zap	zap
buryatia	burjatija
เอเย่นต์	agens
เอเย่นต์	agent
seurat	seurat
mississippian	mississippian
msu	msu
ตูส	stu
germplasm	germplasm
rechts	rechts
polydor	polydor
intermedia	intermedia
influenzae	influenzae
barbus	barbus
เปเป	pepe
เปเป	perua
เปเป	peruu
เปเป	peru
bodyguard	bodyguard
nfc	nfc
samba	samba
velit	velit
dreamworks	dreamworks
wikiversity	wikiversity
niloticus	niloticus
minimal	minimalno
minimal	minimalni
sop	sop
csd	csd
viz	viz
csu	csu
barron	barron
özil	özil
subunit	subunit
pur	pur
ช๊อค	šok
yami	yami
เตารีด	željezo
plexus	plexus
voc	voc
subphylum	subphylum
reine	reine
göttingen	göttingen
atk	atk
hohenzollern	hohenzollern
หวานๆ	slatko
urs	urs
upn	upn
micky	micky
tyrosine	tirozin
tuva	tuva
wikivoyage	wikivoyage
cgmp	cgmp
lexikon	lexikon
dmc	dmc
vue	vue
consequat	consequat
bara	bara
vin	vin
pedophilia	pedofilija
nike	nike
เนธาน	nathan
abdulrahman	abdulrahman
iter	iter
cava	cava
paleocene	paleocene
ops	ops
degeneres	degeneres
blackberry	blackberry
marius	mariusa
oligocene	oligocene
bsc	bsc
regio	regio
mps	parlamentaraca
mps	parlamentarci
mps	poslanici
hrsg	hrsg
นิกิ	niki
ซื่อๆ	naivne
rip	rip
alamos	alamos
smtp	smtp
brachii	brachii
sus	sus
pedersen	pedersen
utd	utd
dag	dag
nsdap	nsdap
torr	torr
ngn	ngn
nicky	nicky
palermo	palermo
meryl	meryl
เบลิซ	beliz
vojvodina	vojvodina
rdf	rdf
abbaye	abbaye
dukes	dukes
prc	prc
parque	parque
rondo	rondo
amr	amr
truss	truss
moma	moma
spielberg	spielberg
catedral	catedral
hannover	hannover
joanna	ivana
iglesias	iglesias
augsburg	augsburg
manutd	manutd
kyi	kyi
gmatch	gmatch
wmflabs	wmflabs
prec	prec
primetime	primetime
outre	outre
zaw	zaw
องคชาติ	penis
nsw	nsw
hussain	hussain
tempor	tempor
cng	cng
wimax	wimax
duis	duis
aes	aes
reina	reina
afi	afi
csc	csc
cvn	cvn
andersson	andersson
albin	albin
เพลีย	umoran
maga	krav
svensson	svensson
ffb	ffb
apex	apex
เด็บ	deb
daw	daw
enwiki	enwiki
bubba	bubba
homme	homme
léopold	léopold
adp	adp
uzb	uzb
pwr	pwr
kwh	kwh
ramanujan	ramanujan
parserfunctions	parserfunctions
tcm	tcm
adv	adv
กยู	gyu
asturias	asturije
asc	asc
vaillant	vaillant
gadgets	gadgets
bund	bund
palacio	palacio
série	série
rutaceae	rutaceae
pka	pka
eros	eros
lgbt	lgbt
icann	icann
zanuck	zanuck
rihanna	rihanna
nur	nur
nazionale	nazionale
bouvier	bouvier
dictionnaire	dictionnaire
substantia	substantia
sylvia	sylvia
ptg	ptg
wolfsburg	wolfsburg
mycobacterium	mycobacterium
xix	xix
agb	agb
openbsd	openbsd
scc	scc
dolce	dolce
oto	oto
gbr	gbr
peterborough	peterborough
afs	afs
mdd	mdd
barker	barker
thalberg	thalberg
vivo	vivo
buch	buch
bibcode	bibcode
opengl	opengl
consolidation	konsolidacije
sixty	šezdeset
federalism	federalizam
politique	politique
ซุปเปอร์มาร์เก็ต	supermarketa
ซุปเปอร์มาร์เก็ต	supermarket
volvo	volvo
disambig	disambig
deus	deus
piedmont	pijemont
clostridium	clostridium
phineas	phineas
psk	psk
hpv	hpv
dylan	dylan
oldid	oldid
pgm	pgm
mollis	mollis
puy	puy
battista	battista
milo	milo
pollutant	pollutant
hylobates	hylobates
เฮ้	hej
nikon	nikon
prk	prk
sana	sana
คอแห้ง	žedan
nowiki	nowiki
ไพค์	pike
freenode	freenode
gerd	gerd
guilford	guilford
kari	kari
pharm	pharm
naoh	naoh
momoiro	momoiro
หนึบ	sticky
flava	flava
pte	pte
nes	nes
uptown	uptown
ไวต์ฮอล	whitehall
ansi	ansi
soccerway	soccerway
wada	wada
tts	tts
เคอร์เซอร์	kursor
ragtime	ragtime
prinz	prinz
imo	imo
richelieu	richelieu
tenth	deseti
tenth	deseta
naa	naa
ymca	ymca
localisation	localisation
ssb	ssb
copyleft	copyleft
adj	adj
staffordshire	staffordshire
paix	paix
xinhua	xinhua
getty	getty
tunguska	tunguska
facies	facies
สมิทธ์	smith
ทำครัว	kuhinje
ทำครัว	kuhinja
ทำครัว	kuhinji
jerkins	jerkins
sfr	sfr
rtl	rtl
vir	vir
tnf	tnf
compositae	compositae
เบ็ท	bet
rosetta	rosetta
suomen	suomen
utm	utm
trump	trump
nach	nach
syr	syr
pteropus	pteropus
kunst	kunst
madagascariensis	madagascariensis
cero	cero
plainlist	plainlist
radialis	radialis
cpn	cpn
rté	rté
eutheria	eutheria
bbb	bbb
hoa	hoa
earn	stiču
adolph	adolph
yama	yama
navi	navi
hilton	hilton
abdel	abdel
ไฟร์เบิร์ด	firebird
wrc	wrc
regency	regency
vos	vos
donau	donau
accumbens	accumbens
lago	lago
spyder	spyder
lycée	lycée
texture	teksturi
suppressplaceholder	suppressplaceholder
sigurd	sigurd
scn	scn
ota	ota
boomerang	bumerang
stephan	stephan
wikilinks	wikilinks
thunb	thunb
lfp	lfp
ksc	ksc
jeju	jeju
clr	clr
epac	epac
mls	mls
trofeo	trofeo
tem	tem
ดุค	vojvoda
sfc	sfc
tres	tres
หลวย	skupova
หลวย	skupovi
origyear	origyear
spiegel	spiegel
preprocess	preprocess
cheers	živjeli
consectetur	consectetur
fen	fen
sergio	sergio
เฮ็ค	heck
cwc	cwc
markus	markus
triomphe	triomphe
chanel	chanel
niosh	niosh
oliveira	oliveira
eazy	eazy
hermes	hermes
bernhard	bernhard
voluptate	voluptate
mus	mus
herrera	herrera
sven	sven
kirov	kirov
ลอตเตอรี่	lutrija
astrakhan	astrahan
tms	tms
หือ	ha
บริกส์	briggs
ฟรอสท์	mraz
func	func
koala	koala
vlsi	vlsi
cml	cml
forte	forte
grape	grožđe
dioguardi	dioguardi
blum	blum
photoshop	photoshop
bartolomeo	bartolomeo
nutt	nutt
msx	msx
systema	systema
ebook	ebook
asn	asn
falciparum	falciparum
openoffice	openoffice
leno	leno
digitorum	digitorum
iis	iis
tui	tui
dra	dra
sws	sws
prostaglandin	prostaglandin
ว่างๆ	prazan
ว่างๆ	prazna
cassatt	cassatt
symphonic	symphonic
ontology	ontologija
lse	lse
mentor	mentor
nep	nep
selena	selena
pauling	pauling
ses	ses
chemspiderid	chemspiderid
boucher	boucher
tyrol	tyrol
pam	pam
deadurl	deadurl
qaboos	qaboos
publ	publ
swat	swat
cns	cns
psg	psg
intermedius	intermedius
แม็ต	met
แม็ต	matt
aso	aso
catalunya	catalunya
chelyabinsk	čeljabinska
tmp	tmp
pes	pes
rhineland	porajnje
noël	noël
chukotka	čukotski
kcal	kcal
avi	avi
mallorca	mallorca
shima	shima
dap	dap
perugino	perugino
rhein	rhein
nhl	nhl
csf	csf
mariano	mariano
rhs	rhs
concacaf	concacaf
loxodonta	loxodonta
autosomal	autosomal
icc	icc
nobilis	nobilis
เฝอ	vergilije
masato	masato
natvar	natvar
aix	aix
github	github
โบนส์	kosti
ยูนิฟอร์ม	ujednačen
zim	zim
bfa	bfa
metabolite	metabolit
selassie	selassie
wikispecies	wikispecies
recherche	recherche
isr	isr
wav	wav
kaup	kaup
tay	tay
icu	intenzivnoj
icu	icu
miley	miley
gmp	gmp
ctx	ctx
atx	atx
bioinformatics	bioinformatika
คลอโรฟอร์ม	hloroform
mainsnak	mainsnak
westport	westport
labore	labore
palmas	palmas
vitae	vitae
moa	moa
bicornis	bicornis
eba	eba
diaz	diaz
amine	amine
himalayan	himalayan
xviii	xviii
แอ๊ปเปิ้ล	jabuke
callsign	callsign
gridcolor	gridcolor
cll	cll
hieronymus	hijeronim
wmo	wmo
landsat	landsat
acp	acp
bofors	bofors
ise	ise
fabricius	fabricius
villars	villars
monash	monash
cinerea	cinerea
mrc	mrc
awd	awd
rebels	pobunjenicima
rebels	pobunjenici
rebels	pobunjenika
ode	ode
regensburg	regensburg
comune	comune
msk	msk
xxi	xxi
scribner	scribner
maris	maris
ทรัมพ์	trump
ffk	ffk
pokemon	pokemon
clade	kladus
arista	arista
polymerization	polimerizacija
gerry	gerry
thuringia	tiringija
ฉาวโฉ่	zloglasni
fab	fab
xxii	xxii
tvm	tvm
deutscher	deutscher
xxvi	xxvi
bhr	bhr
dall	dall
ier	ier
zeit	zeit
horner	horner
gentile	gentile
mtdna	mtdna
galleria	galleria
iffhs	iffhs
searchlight	searchlight
malthus	malthus
nsa	nsa
eget	eget
veniam	veniam
ludovic	ludovic
pvt	pvt
kha	kha
cmr	cmr
reprehenderit	reprehenderit
fugiat	fugiat
pariatur	pariatur
vadis	vadis
arctan	arctan
rufa	rufa
chf	chf
wikimapia	wikimapia
taxonomic	taxonomic
theresia	theresia
polaris	polaris
édition	édition
qasim	qasim
tomica	tomica
ciao	ciao
zin	zin
esc	esc
smp	smp
athlon	athlon
pbk	pbk
swf	swf
sauropsida	sauropsida
uli	uli
ornithischia	ornithischia
footballdatabase	footballdatabase
adenine	adenin
mips	mips
ktx	ktx
tos	tos
cee	cie
crm	crm
artiodactyla	artiodactyla
moderato	moderato
hidalgo	hidalgo
abba	abba
pneumoniae	pneumoniae
xxv	xxv
dll	dll
aze	aze
cpa	cpa
acd	acd
messagebox	messagebox
cbe	cbe
persson	persson
เซสชั่น	sjednicu
เซสชั่น	sjednici
เซสชั่น	sjednica
เซสชั่น	sjednica
castello	castello
seitz	seitz
mubarak	mubaraka
mubarak	mubarak
girolamo	girolamo
pripyat	pripjat
général	général
ics	ics
igg	igg
afa	afa
rashomon	rashomon
gareth	gareth
cnc	cnc
msc	msc
iea	iea
militaire	militaire
หนาๆ	gusta
aran	aran
zia	zia
cindy	sindi
phenol	fenol
benedetto	benedetto
nusa	nusa
nmda	nmda
bgm	bgm
recombination	rekombinacija
อัลม่า	alma
krupp	krupp
phylogenetics	filogenetika
ลอว์เรน	lauren
ลอว์เรน	loren
cowboys	cowboys
nhc	nhc
sergey	sergey
sergey	sergej
chatto	chatto
perrin	perrin
ฮาร์ฟ	harv
californica	californica
agrobacterium	agrobacterium
โชโช	cho
deu	deu
caco	caco
higgins	higgins
verizon	verizon
strangelove	strangelove
waterhouse	waterhouse
oao	oao
maj	maj
sps	sps
supérieure	supérieure
intron	intron
orientales	orientales
rostov	rostov
fmt	fmt
kiki	kiki
lactobacillus	lactobacillus
amt	amt
แมช	mash
modulo	modulo
carolus	carolus
ramsar	ramsar
sbk	sbk
tandem	tandem
hfc	hfc
yousef	yousef
oic	oic
miao	miao
opéra	opéra
เมโย	mayo
iczn	iczn
wikipedians	wikipedians
hydrolysis	hidroliza
ฟอลส์	pada
ฟอลส์	spada
ฟอลส์	vodopadi
icj	icj
unep	unep
แรนดอล	randall
activision	activision
osce	osce
jacobus	jacobus
tampere	tampere
แอพพลิเคชัน	primjenu
แอพพลิเคชัน	aplikacija
แอพพลิเคชัน	prijavu
แอพพลิเคชัน	prijavi
แอพพลิเคชัน	aplikativni
แอพพลิเคชัน	prijave
fifteen	petnaest
postfix	postfix
นูร	nuh
universidad	universidad
tah	tah
clh	clh
étoile	étoile
wesleyan	wesleyan
typus	typus
smr	smr
machina	machina
comcast	comcast
messe	messe
brigitte	brigitte
kamel	kamel
fuck	fuck
zeitung	zeitung
gib	gib
uwf	uwf
ftv	ftv
angie	angie
parlophone	parlophone
minima	minima
diaeresis	diaeresis
dunlop	dunlop
pag	pag
methionine	metionin
giuliano	giuliano
uus	uus
ชอล์ค	krede
bernoulli	bernoulli
bernoulli	bernoullijeva
stroud	stroud
กีซ	kees
orthogonal	orthogonal
dope	dope
awm	awm
nei	nei
acinetobacter	acinetobacter
ascap	ascap
bahnhof	bahnhof
borg	borg
cité	cité
nox	nox
kool	kool
sugiyama	sugiyama
haemophilus	haemophilus
methylation	methylation
stéphane	stephane
jawa	jawa
martius	martius
alireza	alireza
nicht	nicht
collège	collège
niu	niu
zoster	zoster
beatrix	beatrix
krajina	krajine
krajina	krajini
krajina	krajina
tiff	tif
mtu	mtu
