ยางลบ	அழிப்பான்
นมวัว	மாடு
นมวัว	பசு
sdn	sdn
pizza	பீசா
pizza	பீட்சா
เซรามิค	செராமிக்
nrt	nrt
bhd	bhd
cotton	பஞ்சு
cotton	காட்டன்
cotton	பருத்தி
cze	cze
emerg	emerg
ไซนัส	சைனஸ்
setmetatable	setmetatable
ips	ips
domesticpartner	domesticpartner
chennai	சென்னை
peng	பெங்
hrh	hrh
hcl	hcl
baba	பாபா
ems	ems
เทียนไข	மெழுகுவர்த்தி
hoc	hoc
บู้	பூ
subfamilia	subfamilia
eos	eos
tidal	ஓத
เพียซ	துளைத்து
เพียซ	பியர்ஸ்
pdp	pdp
เมก	மெக்
shtml	shtml
sue	சூ
als	als
birdlife	birdlife
emerald	மரகதம்
emerald	மரகத
bas	bas
percussion	தாள
แฮ็ค	ஹேக்
รีซ	ரீஸ்
จอร์น	ஜான்
plantae	plantae
lccn	lccn
oecd	oecd
subclassis	subclassis
disp	disp
ตูด	பட்
racer	ரேசர்
วิสกี้	விஸ்கி
วิสกี้	விஸ்கி
benth	benth
basestyle	basestyle
afp	afp
ฟอร์แมต	வடிவமைப்பு
ฟอร์แมต	வடிவம்
คิงสตัน	கிங்ஸ்டன்
จิ๋ม	புஸ்ஸி
ไดร์ฟ	டிரைவ்
ไดร์ฟ	இயக்கி
bacillus	கோலுயிரி
wifi	wifi
wifi	வைஃபை
getcurrenttitle	getcurrenttitle
ambox	ambox
msv	msv
ipad	ipad
สำลัก	அடைக்கிறது
cmos	cmos
gmelin	gmelin
เบรค	பிரேக்
ดอท	டாட்
ดอท	dot
marksize	marksize
กลมๆ	வட்ட
nist	nist
มัดจำ	வைப்பு
มัดจำ	டெபாசிட்
trigramme	trigramme
vhs	விஎச்எஸ்
kde	kde
medlineplus	medlineplus
alternativemap	alternativemap
อีเมล์	மின்னஞ்சலை
อีเมล์	மின்னஞ்சல்
ไนลอน	நைலான்
ทะลึ่ง	ஆணவ
ปมด้อย	தாழ்வு
lopez	லோபஸ்
gre	gre
เขย่ง	லேமன்
ลินช์	லிஞ்ச்
กิกิ	கிகி
datastyle	datastyle
apa	apa
ต้อกระจก	கண்புரை
gpa	gpa
lightsteelblue	lightsteelblue
อินเตอร์เฟส	இடைமுகப்பு
อินเตอร์เฟส	இடைமுகம்
stardust	ஸ்டார்டஸ்ட்
aol	aol
ลอเรล	லாரல்
factsheet	factsheet
ก๊าด	மண்ணெண்ணெய்
rss	ஆர்எஸ்எஸ்
rss	rss
rheum	பூளை
แบส	பாஸ்
ฝักบัว	குளிக்க
ฝักบัว	சாரல்
คลัสเตอร์	குழுமங்கள்
tee	tee
nom	நோம்
avec	avec
อีสุกอีใส	pox
nano	நானோ
casting	நடிக்க
iss	iss
bamboo	மூங்கில்
miq	miq
gmail	ஜிமெயில்
ผ้าเช็ดหน้า	கைக்குட்டை
ipcc	ipcc
nong	நாங்
geoffroy	ஜெப்ராய்
มอลต์	மால்ட்
เหยือก	கோப்பை
เหยือก	குவளை
เหยือก	கூஜா
เหยือก	ஜக்
monobook	monobook
gprs	gprs
fips	fips
watt	வாட்
โปรโมชัน	புரோமோ
โปรโมชัน	விளம்பரம்
โปรโมชัน	விளம்பரப்படுத்துதல்
psu	psu
editpage	editpage
citationclass	citationclass
อมยิ้ม	லாலிபாப்
yves	yves
kin	கின்
อุ้งมือ	பாதங்கள்
nyc	nyc
publicationdate	publicationdate
gee	கீ
ทรัมป์	டிரம்ப்
timeshift	timeshift
johan	ஜொஹான்
อรรถประโยชน์	உபயோகம்
rsa	rsa
ฮิบ	இடுப்பு
โบรกเกอร์	தரகர்கள்
cms	cms
abcd	abcd
biz	biz
dude	நண்பா
deutsch	deutsch
subpages	subpages
hotcat	hotcat
pga	pga
mont	மோண்ட்
svk	svk
ccccc	ccccc
เซสชัน	அமர்வு
เซสชัน	அமர்வுகள்
capo	capo
บัดดี้	நண்பா
itc	itc
tko	tko
vlan	vlan
panasonic	பேனசோனிக்
infraordo	infraordo
kaon	kaon
พาธ	பாதை
ดุลยพินิจ	discretion
คอมมูน	commune
aac	aac
dia	dia
adr	adr
util	util
globalsecurity	globalsecurity
imageright	imageright
ไฮไลต์	சிறப்புகள்
ไฮไลต์	சிறப்பம்சங்கள்
ลูกวัว	கன்று
ซีรี่ส์	தொடர்கள்
longman	longman
mah	mah
aps	aps
แชต	அரட்டை
capensis	capensis
quis	quis
cfm	cfm
cccc	cccc
kew	kew
pardus	pardus
joker	ஜோக்கர்
fcc	fcc
stadion	stadion
demospace	demospace
pog	pog
อืม	நன்று
อืม	சரி
อืม	நன்கு
อืม	நலம்
mundo	முண்டோ
titlebackground	titlebackground
เธน	தானே
ถาก	மேய
แท่	டே
tel	டெல்
ฟิค	fig
delle	delle
gam	gam
coco	கோகோ
palgrave	palgrave
titleforeground	titleforeground
osama	ஒசாமா
japonica	japonica
อัลเฟร็ด	அல்பிரட்
nec	nec
cdt	cdt
nvidia	nvidia
isi	isi
pubmed	பப்மெட்
ส่วนลด	தள்ளுபடி
ส่วนลด	தள்ளுபடிகள்
xvi	பதினாறாம்
hdl	hdl
arxiv	arxiv
csv	csv
gin	ஜின்
buttonlabel	buttonlabel
muay	முயாய்
bayern	பேயர்ன்
mis	mis
amorphous	சீருறாத்
anhalt	anhalt
immunoglobulin	immunoglobulin
ati	ati
psy	psy
intl	intl
eso	eso
ปฐมนิเทศ	முன்வைப்பு
ปฐมนิเทศ	நாட்டம்
africana	africana
tam	tam
โบกมือ	அலை
โบกมือ	வேவ்
อัลลอฮฺ	ஆண்டவர்
อัลลอฮฺ	தெய்வமே
อัลลอฮฺ	கடவுளின்
อัลลอฮฺ	கடவுள்
อัลลอฮฺ	தேவன்
อัลลอฮฺ	அல்லாஹ்
württemberg	வுயர்ட்டம்பெர்கு
lepus	lepus
มอซ	moz
utama	உத்தமன்
subsid	subsid
harpercollins	harpercollins
ไลค์	போல்
ไลค์	போல
ไลค์	விரும்பு
ไลค์	விருப்பம்
ไลค์	பிடித்திருக்கிறது
domenico	domenico
เดนี	டானி
ไฟแนนซ์	நிதி
เฝือก	எறிந்து
ppi	பிபிஐ
colstyle	colstyle
mayo	மாயோ
proc	proc
dcc	dcc
nicholson	நிக்கல்சன்
jfk	jfk
vga	vga
scr	scr
บล็อค	தடு
บล็อค	தடை
บล็อค	தடுக்கப்பட்டது
บล็อค	தடுக்கப்பட்டுள்ளது
บล็อค	தடைசெய்யப்பட்டது
proud	பெருமை
proud	பெருமையாக
tokamak	டோகாமாக்
slr	slr
cfc	cfc
trend	trend
outlook	outlook
outlook	அவுட்லுக்
ลูปัส	லூபஸ்
ชีก	sheik
inflow	inflow
บลูเบิร์ด	bluebird
trna	trna
meshnumber	meshnumber
มโนธรรม	மனசாட்சி
cmu	cmu
palatinate	palatinate
ร้อนๆ	ஹாட்
ร้อนๆ	சூடு
ร้อนๆ	சூடாக
ร้อนๆ	சூடான
inset	inset
archiveurl	archiveurl
chrtitle	chrtitle
nadh	nadh
mgrtitle	mgrtitle
ecu	ecu
ขนลุก	தவழும்
bcd	bcd
nobelprize	nobelprize
dev	தேவ்
dev	dev
แล็ป	ஆய்வக
แล็ป	ஆய்வகம்
แล็ป	லேப்
som	சோம்
พุช	புஸ்
stm	stm
msds	msds
pod	pods
insight	insight
lyn	லின்
formatdate	formatdate
gcc	gcc
yugra	yugra
ซักรีด	சலவை
pcall	pcall
tyson	டைசன்
แฮก	ஹேக்
คูปอง	கூப்பன்கள்
hug	அரவணைப்பு
hug	அணைப்பு
ราจ	ராஜ்
เย็นๆ	குளிரில்
เย็นๆ	சளி
เย็นๆ	ஜலதோஷம்
เย็นๆ	குளிர்
pst	pst
dante	டான்டே
colhead	colhead
jelly	ஜெல்லி
cassini	cassini
république	république
slip	slip
backgroundcolors	backgroundcolors
สต๊อก	இருப்பு
sfsr	sfsr
aspergillus	aspergillus
pulp	காகிதக்கூழ்
doubleday	doubleday
sortkey	sortkey
metallicity	metallicity
uni	uni
dab	dab
whispertome	whispertome
กระดก	கல்ப்
agassiz	agassiz
lac	lac
นมผง	சூத்திரம்
srb	srb
nulla	nulla
subtemplate	subtemplate
nrc	nrc
seds	seds
wikibase	wikibase
isnotempty	isnotempty
aviator	ஏவியேட்டர்
philips	பிலிப்ஸ்
utrecht	utrecht
tsu	tsu
mango	மா
mango	மாம்பழம்
milne	milne
theodor	தியோடோர்
uncollapsed	uncollapsed
rec	ரெக்
kbps	kbps
lightblue	lightblue
taxa	taxa
ordovician	ordovician
puma	பூமா
syed	சையத்
syed	சையது
syed	syed
giotto	giotto
hatnote	hatnote
caretta	caretta
โป๊ป	போப்
โป๊ป	திருத்தந்தை
voip	voip
rotterdam	ராட்டர்டாம்
คอแดง	செங்கழுத்து
pargs	pargs
mein	mein
coauthors	coauthors
filmfare	பிலிம்பேர்
grus	grus
sco	sco
ppt	ppt
fern	fern
ไบเบิ้ล	பைபிள்
ไบเบิ้ล	பைபிளில்
spam	ஸ்பேம்
spam	ஸ்பாம்
เทอร์โมมิเตอร์	வெப்பமானி
cervus	cervus
honneur	honneur
sis	sis
sis	சகோதரி
mdi	mdi
otc	otc
gts	gts
fanny	fanny
electrophoresis	electrophoresis
txt	txt
เลินเล่อ	அலட்சியம்
tdi	tdi
อ่างอาบน้ำ	குளியல்
อ่างอาบน้ำ	பாத்
phylogenetic	phylogenetic
checktype	checktype
ssl	ssl
streptococcus	streptococcus
atr	atr
mpc	mpc
dst	dst
tachi	தாச்சி
abusefilter	abusefilter
burger	பர்கர்
anaerobic	anaerobic
arkive	arkive
ucl	ucl
แท็ป	தட்டி
คาร์ลอ	காரல்
molly	மோலி
ฮอง	ஹாங்
soa	soa
isis	isis
mistyrose	mistyrose
sampa	sampa
bmi	bmi
umts	umts
contribs	contribs
ไฟแช็ก	மென்மை
wikiquote	விக்கிமேற்கோள்
รังแค	பொடுகு
bruxelles	bruxelles
แรนดัล	ராண்டல்
moments	moments
moments	தருணங்கள்
moments	கணங்கள்
moments	தருணங்களை
poj	poj
ceeb	ceeb
แม็ท	மாட்
แม็ท	மேட்
hobby	பொழுதுபோக்கு
datavalue	datavalue
พุส	புஸ்
sar	sar
nbr	nbr
deutschen	deutschen
willd	willd
plainlinks	plainlinks
mainz	mainz
csa	csa
เคอร์ฟิว	ஊரடங்கு
ชักช้า	lag
thirteen	பதின்மூன்று
thirteen	பதிமூன்று
บารอมิเตอร์	காற்றழுத்தமானி
vevent	vevent
chapelle	chapelle
alb	alb
ไลล์	லைல்
ncc	ncc
bbs	bbs
geograph	geograph
beats	தாளங்கள்
beats	துடிக்கிறது
pda	pda
aura	ஆரா
pliocene	pliocene
eduardo	eduardo
bing	பிங்
iptv	iptv
mun	mun
msm	msm
flex	flex
atl	atl
nacl	nacl
bpm	bpm
hystrix	hystrix
angiosperm	angiosperm
deutsches	deutsches
fes	fes
ams	ams
nco	nco
wiesbaden	wiesbaden
vitis	vitis
imd	imd
บางเบา	சிறகுகள்
srt	srt
nin	நின்
pubchem	பப்கெம்
tev	tev
dora	டோரா
firewire	firewire
peterson	பீட்டர்சன்
หนักๆ	கனமான
หนักๆ	கனரக
หนักๆ	கனமாக
หนักๆ	கடும்
kao	kao
std	std
wolfram	wolfram
acta	acta
muller	முல்லர்
imax	ஐமேக்ஸ்
bung	பங்
archivedate	archivedate
kerry	கெர்ரி
cups	cups
blink	இமை
blink	இமைக்கும்
liner	லைனர்
iarc	iarc
magnet	காந்தம்
toon	டூன்
nrhp	nrhp
bild	bild
gbp	gbp
cooh	cooh
bam	பாம்
exodus	யாத்திராகமம்
arthropoda	arthropoda
igf	igf
nct	nct
tabi	டாபி
มัลแวร์	தீப்பொருள்
plosive	plosive
inst	inst
อัพเดท	புதுப்பிக்கப்பட்டது
pax	pax
gta	gta
nas	நாஸ்
ups	ups
บอกใบ้	ஹிந்தி
cod	cod
เคเบิ้ล	வடம்
เคเบิ้ล	கேபிள்
เลขาฯ	பொருளாளர்
เลขาฯ	செயலர்
เลขาฯ	செயலாளர்
leben	leben
deutschland	deutschland
lisbon	லிஸ்பன்
tpe	tpe
topographic	topographic
เมี้ยว	மியாவ்
dyk	dyk
gesellschaft	gesellschaft
fernandez	பெர்னாண்டஸ்
transcluded	transcluded
mir	மிர்
bismuth	பிசுமத்
korn	கோர்ன்
ochotona	ochotona
dickson	டிக்சன்
taxoboxes	taxoboxes
nok	நோக்
ญาติๆ	உறவினர்கள்
toolserver	toolserver
jalan	ஜலான்
zimmermann	zimmermann
wikt	wikt
abovebelow	abovebelow
ชอปปิ้ง	கொள்வனவு
ชอปปิ้ง	ஷாப்பிங்
citrate	citrate
superfamilia	superfamilia
dsrna	dsrna
uru	uru
ksa	ksa
เบย	பேயை
เบย	bae
cfa	cfa
crocodylus	crocodylus
ไมโล	மிலோ
nucleotide	nucleotide
kirchner	கிர்ச்னர்
เปียนโน	பியானோ
collagen	கொலாஜன்
ดอยช์	deutsche
sina	sina
macbook	மேக்புக்
sac	sac
ferreira	ஃபெரேரா
ดินเนอร์	டின்னர்
ไกส์	ஸ்கைப்
ไกส์	skype
mimi	மிமி
nenets	nenets
avatar	அவதாரம்
avatar	அவதார்
omim	omim
ssc	ssc
powerpc	powerpc
coe	கோ
pennsylvanian	pennsylvanian
อุทาหรณ์	உவமை
อุทาหรณ์	ஊதாரி
ย่อมเยา	மலிவு
chitra	சித்ரா
dvořák	டுவோராக்
เลอะเทอะ	அசுத்தமாக
เลอะเทอะ	மெஸ்
เลอะเทอะ	குழப்பம்
barincrement	barincrement
taxon	taxon
cta	cta
chapterurl	chapterurl
fai	fai
ติดตลก	அறிவாற்றல்
fia	fia
adb	adb
ejective	ejective
ดรอป	விடு
ดรอป	துளி
postgrad	postgrad
henrik	ஹென்ரிக்
hoang	ஹோங்
loc	loc
angiosperms	angiosperms
bonn	பான்
เมกะเฮิรตซ์	mhz
sixteen	பதினாறு
nadph	nadph
oro	oro
พุซ	புஸ்
นู่	நூஹ்
กระเด้ง	குதிக்கும்
dpr	dpr
dns	dns
cristatus	cristatus
แชท	அரட்டை
africanus	africanus
vishwanath	விசுவநாதர்
evenodd	evenodd
moo	மூ
sma	sma
เอเย่นต์	முகவர்
เอเย่นต์	ஏஜென்ட்
oed	மாணவராகவும்
mississippian	மிசிசிப்பிப்
msu	msu
ตูส	stu
shockley	ஷாக்லி
germplasm	germplasm
infraclassis	infraclassis
lemonchiffon	lemonchiffon
outdoor	வெளிப்புற
antineutrino	antineutrino
เปเป	பெரு
hodder	hodder
bodyguard	மெய்க்காப்பாளர்
nfc	nfc
samba	சம்பா
samba	சாம்பா
velit	velit
raion	raion
csd	csd
eaba	eaba
csu	csu
mcv	mcv
subunit	subunit
pur	புர்
gaba	gaba
ช๊อค	அதிர்ச்சி
เตารีด	இரும்பு
voc	voc
subphylum	subphylum
หวานๆ	இனிமை
หวานๆ	இனிமையான
หวานๆ	இனிப்பு
หวานๆ	இனிமையாக
tyrosine	டைரோசின்
dunam	dunam
wikivoyage	wikivoyage
mms	mms
consequat	consequat
bara	பாரா
vin	வின்
vin	vin
gpp	gpp
มึนงง	பலவீனமாக
nike	நைக்
เนธาน	நாதன்
iter	iter
paleocene	paleocene
ops	ops
degeneres	டிஜெனிரெஸ்
enim	enim
blackberry	பிளாக்பெர்ரி
oligocene	oligocene
bsc	bsc
commuter	commuter
บังกะโล	பங்களா
บังกะโล	பங்களாவில்
mps	mps
hrsg	hrsg
ซื่อๆ	அப்பாவி
rip	ரிப்
rip	rip
alamos	alamos
smtp	smtp
diffusivity	diffusivity
pedersen	pedersen
nadar	நாடார்
nadar	நாடார்கள்
nsdap	nsdap
pang	பாங்
ngn	ngn
nicky	நிக்கி
meryl	மெரில்
hspa	hspa
เบลิซ	பெலிஸ்
mita	மிட்டா
prc	prc
parque	parque
amr	amr
sachsen	sachsen
เหยาะ	யாவ்
catedral	catedral
iglesias	iglesias
augsburg	augsburg
kyi	கி
gmatch	gmatch
wmflabs	wmflabs
prec	prec
affricate	affricate
องคชาติ	ஆண்குறி
nsw	nsw
hussain	ஹுசைன்
tempor	tempor
fbid	fbid
neanderthalensis	neanderthalensis
nail	நகம்
nail	ஆணி
wimax	வைமாக்ஸ்
duis	duis
aes	aes
zum	zum
afi	afi
csc	csc
เพลีย	சோர்வு
เพลีย	சோர்வாக
maga	கிராவ்
emporis	emporis
ffb	ffb
poptime	poptime
barnstar	barnstar
เด็บ	டெப்
daw	daw
enwiki	enwiki
adp	adp
uzb	uzb
pwr	pwr
catchment	catchment
ether	ஈதர்
kwh	kwh
tdma	tdma
ramanujan	ராமானுஜன்
bwr	bwr
parserfunctions	parserfunctions
tcm	tcm
asc	asc
bund	bund
palacio	palacio
beverley	beverley
pka	pka
eros	ஈரோஸ்
lgbt	lgbt
hkg	hkg
icann	icann
taxobox	taxobox
blitz	பிளிட்ஸ்
dictionnaire	dictionnaire
dprk	dprk
kendall	கெண்டல்
stripe	stripe
esse	esse
หลานๆ	பேரப்பிள்ளைகள்
mycobacterium	மைக்கோபாக்டீரியம்
omg	கடவுளே
xix	xix
openbsd	openbsd
pitta	கபம்
antiquark	antiquark
highestsinglesranking	highestsinglesranking
gbr	gbr
civ	civ
buch	buch
careerprizemoney	careerprizemoney
bibcode	bibcode
opengl	பேனா
doublesrecord	doublesrecord
currentnumber	currentnumber
treron	treron
fútbol	fútbol
hamer	ஹாமர்
sixty	அறுபது
sixty	அறுபத்து
pskov	pskov
volvo	வோல்வோ
disambig	disambig
deus	deus
hpv	hpv
blainville	blainville
dylan	டிலான்
oldid	oldid
puy	puy
battista	battista
เปล่งปลั่ง	ஒளிரும்
milo	மிலோ
pollutant	pollutant
varanus	varanus
เฮ้	ஏய்
เฮ้	ஹே
sana	சனா
คอแห้ง	தாகம்
atrium	ஏட்ரியம்
nowiki	nowiki
ไพค์	pike
ไพค์	பைக்
freenode	freenode
qam	qam
kari	காரி
kari	kari
singlesrecord	singlesrecord
เดบิต	டெபிட்
naoh	naoh
chembox	chembox
หนึบ	நீளமாக
หนึบ	ஒட்டும்
cvd	cvd
snak	snak
pte	pte
nes	nes
wada	தருகிறது
imo	imo
tenth	பத்தாவது
tenth	பத்தாம்
naa	naa
ymca	ymca
localisation	localisation
copyleft	அளிப்புரிமை
motilal	மோதிலால்
staffordshire	staffordshire
khamis	கமீசு
paix	பைக்ஸ்
hsdpa	hsdpa
สมิทธ์	ஸ்மித்
ทำครัว	சமையலறை
bmj	bmj
sfr	sfr
rtl	rtl
tnf	tnf
nativename	nativename
เบ็ท	பெத்
suomen	suomen
trump	டிரம்ப்
othernames	othernames
pron	pron
mordovia	mordovia
syr	syr
columnwidth	columnwidth
pteropus	pteropus
sungai	சுங்கை
bose	போஸ்
sivan	சிவன்
madagascariensis	madagascariensis
plainlist	plainlist
eutheria	eutheria
bbb	bbb
highestdoublesranking	highestdoublesranking
tif	tif
hoa	ஓவா
hoa	கூத்து
ฟินช์	பறவை
ฟินช์	finch
kuw	kuw
adolph	adolph
yama	யமன்
navi	நவி
hilton	ஹில்டன்
regency	பதிலாட்புலம்
eer	eer
texture	நுட்பம்
suppressplaceholder	suppressplaceholder
scn	scn
coriacea	coriacea
wikilinks	wikilinks
ksc	ksc
aldansky	aldansky
epac	epac
fibrous	fibrous
mls	mls
uma	உமா
ดุค	டியூக்
asm	asm
tres	ட்ரெஸ்
ces	ces
origyear	origyear
preprocess	preprocess
cheers	ஆரவாரம்
cheers	சியர்ஸ்
consectetur	consectetur
fen	fen
nld	nld
italicized	italicized
sergio	செர்ஜியோ
เฮ็ค	கர்மம்
cwc	cwc
markus	மார்க்கஸ்
nwo	nwo
niosh	niosh
australianopenresult	australianopenresult
cbm	சிபிஎம்
voluptate	voluptate
sven	ஸ்வென்
อาลิ	அலி
ลอตเตอรี่	லாட்டரி
ipo	ipo
tms	tms
ฟรอสท์	ஃப்ரோஸ்ட்
func	func
lgpl	lgpl
เซจ	முனிவர்
koala	கோலா
vlsi	vlsi
shiki	shiki
anura	அனுர
grape	திராட்சை
wimbledonresult	wimbledonresult
usopenresult	usopenresult
blum	ப்ளூம்
photoshop	photoshop
maggi	மேகி
bartolomeo	bartolomeo
vit	vit
systema	systema
ebook	ebook
asn	asn
antwerp	antwerp
iis	iis
ว่างๆ	காலி
ว่างๆ	காலியான
ว่างๆ	வெற்று
putra	புத்ரா
extrapolated	extrapolated
cassatt	கசாட்
ontology	ontology
lse	lse
mentor	ஆசான்
nep	nep
pauling	பாலிங்
ses	ses
chemspiderid	chemspiderid
deadurl	deadurl
mof	mof
publ	publ
npt	npt
cns	cns
psg	psg
frenchopenresult	frenchopenresult
biol	biol
แม็ต	மாட்
แม็ต	மேட்
catalunya	catalunya
accelerometer	முடுக்கமானி
relax	ரிலாக்ஸ்
relax	வெயிலில்
relax	ஓய்வெடுக்க
imagecaption	imagecaption
tmp	tmp
pes	pes
wwii	wwii
kcal	kcal
avi	avi
dap	dap
nhl	nhl
csf	csf
mariano	mariano
rhs	rhs
concacaf	concacaf
icc	icc
aix	aix
github	github
โบนส์	எலும்புகள்
ยูนิฟอร์ม	சீருடை
ยูนิฟอร์ม	சீரான
dhoom	தூம்
zim	zim
bfa	bfa
bdnf	bdnf
selassie	செலாசி
recherche	recherche
isr	isr
skyscraperpage	skyscraperpage
crs	crs
kuntze	kuntze
regex	regex
wav	wav
megan	மேகன்
tay	tay
miley	மைலி
ctx	ctx
bioinformatics	bioinformatics
mainsnak	mainsnak
westport	westport
labore	labore
vitae	vitae
petaurista	petaurista
bicornis	bicornis
fazer	கியாஸ்
anim	anim
pyotr	பியோத்தர்
diaz	டியாஸ்
himalayan	இமாலய
xviii	xviii
แอ๊ปเปิ้ล	ஆப்பிள்கள்
callsign	callsign
gridcolor	gridcolor
tid	tid
maler	maler
acp	acp
bofors	போபர்ஸ்
fabricius	பப்ரிசியஸ்
monash	மொனாஷ்
cinerea	cinerea
cnet	cnet
พิมพ์เขียว	blueprint
comune	comune
msk	msk
xxi	xxi
uncia	uncia
scribner	scribner
ทรัมพ์	டிரம்ப்
rrna	rrna
shy	வெட்கம்
setter	செட்டர்
longmans	longmans
cmyk	cmyk
thuringia	thuringia
fab	விவாதிக்கலாம்
xxii	xxii
pty	pty
obe	obe
deutscher	deutscher
fairuse	fairuse
xxvi	xxvi
bhr	bhr
lag	lag
alsos	alsos
sourcebook	sourcebook
mtdna	mtdna
retroflex	retroflex
nsa	nsa
eget	eget
veniam	veniam
paradisi	paradisi
spurious	spurious
pvt	பிரைவேட்
pvt	pvt
kha	kha
kha	கா
cmr	cmr
reprehenderit	reprehenderit
fugiat	fugiat
pariatur	pariatur
arctan	arctan
chf	chf
wikimapia	விக்கிமேப்பியா
qasim	காசிம்
notableworks	notableworks
esc	எஸ்கேப்
esc	esc
smp	smp
hmg	hmg
schoolnet	schoolnet
athlon	அத்லோன்
pbk	pbk
iws	iws
banarsidass	banarsidass
swf	swf
uli	உலி
mips	mips
cee	சீ
crm	crm
nasser	நாசர்
prada	பிராடா
xxv	xxv
dll	dll
cpa	cpa
acd	acd
messagebox	messagebox
cbe	cbe
เซสชั่น	அமர்வு
เซสชั่น	அமர்வுகள்
mubarak	முபாரக்
australasian	australasian
ics	ics
splendens	splendens
igg	igg
xperia	எக்ஸ்பீரியா
gareth	காரெத்
cnc	cnc
msc	msc
iea	iea
punctatus	punctatus
หนาๆ	தடித்த
หนาๆ	தடிமனான
หนาๆ	அழுத்தமான
zia	ஜியா
cindy	சிண்டி
bur	பர்
phenol	பீனால்
ดรูว	ட்ரூ
benedetto	benedetto
recombination	recombination
krupp	க்ரூப்
ลอว์เรน	லாரன்
nhc	nhc
aeronautical	aeronautical
perrin	பெரென்
joshi	ஜோஷி
agrobacterium	agrobacterium
โชโช	சோ
higgins	ஹிக்கின்ஸ்
waterhouse	waterhouse
cdm	cdm
sps	sps
orientales	orientales
jerdon	ஜெர்டன்
dth	dth
fmt	fmt
kiki	கிகி
lactobacillus	lactobacillus
amt	amt
modulo	modulo
mbe	mbe
ramsar	ramsar
userboxes	userboxes
hfc	hfc
pycnonotus	pycnonotus
miao	miao
jal	ஜல்
เมโย	மாயோ
ถูกๆ	மலிவான
wikipedians	wikipedians
hydrolysis	நீராற்பகுப்பு
pstn	pstn
ฟอลส์	அருவி
ฟอลส์	அருவியில்
udmurtia	udmurtia
coor	coor
unep	unep
pavo	pavo
แรนดอล	ராண்டல்
peerage	peerage
saarland	saarland
แอพพลิเคชัน	பயன்பாட்டை
แอพพลิเคชัน	செயலி
แอพพลิเคชัน	பயன்பாடு
fifteen	பதினைந்து
nia	நியா
นูร	நூஹ்
universidad	universidad
tah	tah
clh	clh
scs	scs
irst	irst
wesleyan	wesleyan
dbms	dbms
fuck	விழுங்க
zeitung	zeitung
gib	gib
ออสซี่	ஆசி
angie	எஞ்சி
bjt	bjt
acad	acad
ผ้าดิบ	துணிகள்
dunlop	டன்லப்
pag	pag
jbl	jbl
methionine	மெத்தியோனின்
uus	uus
bernoulli	bernoulli
onca	onca
actinides	actinides
ris	ரிஸ்
nei	nei
sheldon	ஷெல்டன்
เริงร่า	சந்தோஷமான
physique	physique
niu	niu
subfamily	subfamily
mauris	mauris
tiff	tiff
mtu	mtu
dts	dts
อัยย์	அயூப்
ceres	சிரிஸ்
ไพธอน	பைத்தான்
ดุ๊ค	டியூக்
tyumen	tyumen
latifolia	latifolia
audi	ஆடி
iupacname	iupacname
psc	psc
domesticus	domesticus
mrp	mrp
uup	uup
hayabusa	ஹயபுசா
delisted	delisted
tuck	டக்
dato	டத்தோ
exec	exec
cav	cav
bayan	பயான்
turnedpro	turnedpro
powerpoint	பவர்பாயிண்ட்
sharma	சர்மா
sharma	ஷர்மா
goin	கோயிங்
tethys	தெதைஸ்
อิตาลี่	இத்தாலி
smolensk	smolensk
wiltshire	wiltshire
yuzhno	yuzhno
popplace	popplace
json	json
worldstatesmen	worldstatesmen
incididunt	incididunt
aliqua	aliqua
orenburg	orenburg
pygmaeus	pygmaeus
glock	glock
padam	padam
petrus	petrus
strada	strada
subcat	subcat
sayyid	சையிது
อัพเดต	புதுப்பிப்பு
อัพเดต	புதுப்பிக்கவும்
praeger	praeger
aute	aute
pel	pel
เกษียน	ஓய்வு
เกษียน	ஓய்வை
feo	feo
corpora	corpora
partof	partof
ทักซิโด	tux
transclusion	transclusion
ilo	ilo
mcs	mcs
skype	ஸ்கைப்
skype	skype
maji	மாஜி
pura	புரா
pki	pki
mactutor	mactutor
nylon	நைலான்
ascorbic	அஸ்கார்பிக்
ira	இரா
hcard	hcard
wysiwyg	wysiwyg
rowe	ரோவ்
csm	csm
mhnt	mhnt
xxxxx	xxxxx
kris	க்ரிஸ்
seventeenth	seventeenth
mobutu	மொபுட்டு
virgo	கன்னி
qid	qid
palustris	palustris
cerro	செர்ரோ
thc	thc
bundesarchiv	bundesarchiv
unrounded	unrounded
waleed	வலீத்
almanac	பஞ்சாங்கம்
rainer	ரெய்னர்
penza	penza
pci	பிசிஐ
sverdlovsk	sverdlovsk
aum	aum
mmhg	mmhg
pcc	pcc
tva	tva
ggt	ggt
smalltext	smalltext
asl	asl
charan	சரண்
imap	imap
oav	oav
hybridization	hybridization
pushpin	குண்டூசி
afb	afb
gazetteer	gazetteer
shawshank	ஷாவ்ஷாங்க்
philippensis	philippensis
aquino	அக்கினோ
purine	பியூரின்
สเปรดชีต	விரிதாள்
wireshark	வயர்ஷார்க்
uga	uga
pelecaniformes	pelecaniformes
fiesta	ஃபீஸ்டா
eiusmod	eiusmod
คาโล	கார்லோ
ambedkar	அம்பேத்கர்
exercitation	exercitation
cps	cps
หยง	யோங்
แหวะ	அருவருப்பு
studien	studien
clp	clp
nineteen	பத்தொன்பது
butyl	பியூட்டைல்
krause	krause
perlis	பெர்லிஸ்
ceramic	செராமிக்
paniculata	paniculata
eines	eines
pgc	pgc
mgr	mgr
ผ้าเช็ดตัว	துண்டு
officia	officia
deserunt	deserunt
patrimoine	patrimoine
tcl	tcl
mollit	mollit
laborum	laborum
imt	imt
vldl	vldl
ils	ils
mdt	mdt
pdb	pdb
otherparty	otherparty
pulchella	pulchella
suc	suc
hardback	hardback
tambov	tambov
adipisicing	adipisicing
zac	சாக்
ferric	ferric
zno	zno
wayback	wayback
usgov	usgov
tribus	tribus
diy	diy
msi	msi
mila	மிலா
centropus	centropus
ferrer	ஃபெரர்
dmca	dmca
kcb	kcb
indef	indef
herrmann	ஹெர்மான்
vologda	vologda
usc	usc
hno	hno
sinica	sinica
ruf	ruf
lea	லியா
colwidth	colwidth
tunku	துங்கு
taf	taf
uut	uut
brics	பிரிக்ஸ்
daa	daa
คลัตช์	கிளட்ச்
farrar	ஃபரார்
nyu	nyu
cmmi	cmmi
acl	acl
schulze	சூல்ட்சு
creoles	creoles
westview	westview
arkhangelsk	arkhangelsk
regnal	regnal
xxiv	xxiv
gruyter	gruyter
remi	ரெமி
brassica	brassica
physik	physik
sdk	நிமிடங்களிலேயே
sdk	sdk
nndb	nndb
tempus	tempus
yog	யோக்
mainspace	mainspace
ihs	ihs
mcmillan	மெக்மிலன்
tavor	tavor
rphrases	rphrases
gsfc	gsfc
ary	அரி
nsaid	nsaid
mlb	mlb
kirchhoff	கிர்க்காஃப்
ktm	ktm
othertournaments	othertournaments
bwf	bwf
kyiv	கிவ்
npov	npov
motacilla	motacilla
lyle	லைல்
tjk	tjk
mems	mems
oceanography	கடலியல்
nsf	nsf
squamous	squamous
eir	eir
lek	லெக்
unsortable	unsortable
heinemann	heinemann
aic	aic
obverse	obverse
nmr	nmr
hansa	hansa
tga	tga
nob	நாப்
uvb	uvb
blg	blg
ssd	ssd
wikified	wikified
pliny	pliny
categorise	categorise
lagrange	லாக்ராஞ்சி
donum	donum
abstracts	abstracts
martes	martes
irure	irure
aliquip	aliquip
notability	notability
taman	தாமான்
cag	cag
ifbb	ifbb
cillum	cillum
nostrud	nostrud
excepteur	excepteur
née	née
dac	dac
occaecat	occaecat
webm	webm
tft	tft
elton	எல்டன்
proident	proident
ผ้าปูที่นอน	தாள்கள்
ผ้าปูที่นอน	தாள்
cherkessia	cherkessia
firma	firma
cupidatat	cupidatat
ullamco	ullamco
oryol	oryol
helmholtz	helmholtz
portuguesa	portuguesa
vorpommern	vorpommern
lol	lol
unsourced	unsourced
jimi	ஜிமி
pidgins	pidgins
locmapin	locmapin
saratov	saratov
laboris	laboris
horta	horta
nytimes	nytimes
pwm	pwm
natureserve	natureserve
เบเบ	பேயை
เบเบ	bae
lensky	lensky
incertae	incertae
sedis	sedis
hessen	hessen
grb	grb
souza	சோசா
ctc	ctc
wehrmacht	wehrmacht
skn	skn
psv	psv
rusa	rusa
gwp	gwp
burm	burm
คอมเมนท์	கருத்துகளில்
คอมเมนท์	கருத்துக்களில்
คอมเมนท์	கருத்துகள்
คอมเมนท์	கருத்துக்கள்
bef	bef
zeitschrift	zeitschrift
faff	faff
ganga	கங்கா
nagorno	nagorno
clef	clef
kuhl	kuhl
australianopendoublesresult	australianopendoublesresult
anion	anion
nis	nis
orci	orci
yangtze	yangtze
unc	unc
gli	gli
saccharomyces	saccharomyces
mec	மக்
azad	ஆசாத்
belknap	belknap
tomsk	tomsk
storia	storia
kimberley	kimberley
cie	cie
เพ็ค	peck
senegalensis	senegalensis
nrw	nrw
yamalo	yamalo
zabaykalsky	zabaykalsky
phenylalanine	பினைல்அலனின்
ttf	ttf
talkpage	talkpage
pcf	pcf
paleo	paleo
kochi	கொச்சி
secam	secam
ccb	ccb
dasypus	dasypus
categorizes	categorizes
โค้ท	கோட்
จอส	ஜோஸ்
jyutping	jyutping
cpv	cpv
bhu	bhu
fasciculus	fasciculus
glotto	glotto
qantas	குவாண்டாஸ்
uso	uso
carassius	carassius
cef	cef
ecmascript	ecmascript
agro	வேளாண்
ulu	ulu
brst	brst
ulyanovsk	ulyanovsk
darul	darul
atf	atf
ibc	ibc
conf	conf
colossus	colossus
molarmass	molarmass
olpc	olpc
เนบ	நவா
จอยส์	ஜாய்ஸ்
smalltalk	smalltalk
pontifical	pontifical
wikimedians	wikimedians
dba	dba
olap	olap
tkm	tkm
gustaf	gustaf
nicki	நிக்கி
nyse	nyse
soares	சோர்ஸ்
badius	badius
tetracycline	டெட்ராசைக்ளின்
natal	நடால்
iafd	iafd
lva	lva
worldcat	worldcat
wildstorm	wildstorm
capsicum	மிளகாய்
sigi	சிகி
posix	posix
lhs	lhs
stereoscopic	stereoscopic
lak	இலகு
lak	lak
osmium	ஓசுமியம்
adc	ஏடிசி
smt	ஸ்ரீமதி
kabila	கபிலா
เศร้าๆ	சோகம்
เศร้าๆ	வருத்தமளிக்கிறது
tver	திவெர்
smrt	smrt
jolly	ஜாலி
marinus	marinus
appl	appl
pge	pge
kant	காந்த்
afferent	afferent
cobe	cobe
navboxes	navboxes
encapsulation	உறைபொதியாக்கம்
bambang	பாம்பாங்
wlan	wlan
vlc	vlc
simbad	simbad
cln	cln
เพค	peck
maja	மஜா
บร็อค	ப்ராக்
endash	endash
fascia	fascia
moor	மூர்
adidas	அடிடாஸ்
wikipedian	wikipedian
pdc	pdc
