ind	ind
clover	クローバー
aaaaaa	aaaaaa
cheese	チーズ
riaj	riaj
wto	wto
เบลโล	bello
เบลโล	ベロ
turismo	turismo
ing	ing
pfc	pfc
dota	dota
sortable	sortable
nums	nums
ufc	ufc
requiem	レクイエム
รปภ	セキュリティ
รปภ	セキュリティー
emma	エマ
หัวนม	乳首
หัวนม	乳首
หัวนม	おっぱい
หัวนม	オッパイ
plc	plc
raven	レイヴン
lorem	lorem
เบลก	ブレイク
lucy	ルーシー
gnis	gnis
กานพลู	クローブ
โป๊กเกอร์	ポーカー
nfl	nfl
moss	コケ
ปลอกคอ	首輪
โฮล์มส์	ホームズ
ไมลส์	マイル
civic	シビック
leiden	ライデン
iec	iec
tlc	tlc
carmen	カルメン
ท็อปส์	tops
ท็อปส์	トップス
lgn	lgn
ตื้นๆ	浅い
ตื้นๆ	浅瀬
retval	retval
หนองใน	淋病
ลินซ์	リンチ
คีท	キース
topscorer	topscorer
dubai	ドバイ
ทรัมเปต	トランペット
กระวนกระวาย	不安
กระวนกระวาย	気がかり
gis	gis
สวยๆ	美しい
สวยๆ	ビューティフル
สวยๆ	可愛い
sdtv	sdtv
ภาพยนต์	映画
ภาพยนต์	ムービー
ภาพยนต์	映画
cma	cma
mep	mep
spec	スペック
spec	spec
asa	asa
ฉุบ	ハサミ
ฉุบ	はさみ
mou	mou
นํ้า	ウォーター
psr	psr
slim	スリム
curry	カレー
scaleminor	scaleminor
stp	stp
templatedata	templatedata
rft	rft
exp	exp
det	det
loaddata	loaddata
osprey	ミサゴ
luca	ルカ
ตาชั่ง	スケール
ตาชั่ง	ウロコ
familycolor	familycolor
evergreen	エバーグリーン
ใคร่ครวญ	反映
titleclass	titleclass
mmorpg	mmorpg
nic	nic
ขวนขวาย	獲得
ขวนขวาย	稼ぐ
njpw	njpw
คังนัม	江南
tls	tls
mtc	mtc
wmf	wmf
pwg	pwg
idn	idn
ucla	ucla
เอทีเอ็ม	atm
เอทีเอ็ม	atm
wta	wta
แรนด์	ランド
omniglot	omniglot
ยางลบ	イレイザー
ยางลบ	消しゴム
นมวัว	カウ
ped	ped
sdn	sdn
จรจัด	ホームレス
pizza	ピザ
rem	レム
rem	rem
เซรามิค	セラミック
เซรามิค	陶磁器
cis	cis
dek	デック
phuket	プーケット
nrt	nrt
thx	thx
bhd	bhd
cotton	木綿
cotton	コットン
cze	cze
ipod	ipod
ทำหมัน	殺菌
setmetatable	setmetatable
hokusai	北斎
ole	ole
chennai	チェンナイ
solaris	solaris
ดีซ่าน	黄疸
comp	コンプ
บาร์บีคิว	バーベキュー
บาร์บีคิว	焼肉
บาร์บีคิว	バーベキュー
บาร์บีคิว	bbq
บาร์บีคิว	バーベキュー
baba	ババ
baba	馬場
ems	エムス
ems	ems
sohc	sohc
เทียนไข	ろうそく
เทียนไข	キャンドル
เทียนไข	蝋燭
rafinesque	rafinesque
โคไซน์	コサイン
regie	regie
เก๊าท์	痛風
บู้	ブー
บู้	boo
เพียซ	ピアス
เพียซ	ピアース
pdp	pdp
เมก	メグ
shtml	shtml
sue	スー
terme	テルメ
emerald	エメラルド
percussion	打楽器
แฮ็ค	ハッキング
จอร์น	ジョン
ตะคริว	けいれん
ตะคริว	けいれん
lccn	lccn
oecd	oecd
sig	sig
ตูด	ass
racer	レーサー
พลั่ว	シャベル
linecolor	linecolor
bodyslam	lmfao
irn	irn
วิสกี้	ウィスキー
วิสกี้	ウイスキー
วิสกี้	ウィスキー
วิสกี้	ウイスキー
benth	benth
basestyle	basestyle
afp	afp
ฟอร์แมต	フォーマット
ฟอร์แมต	書式
จิ๋ม	プッシー
ไดร์ฟ	ドライブ
lpg	lpg
wifi	wifi
getcurrenttitle	getcurrenttitle
ambox	ambox
msv	msv
ipad	ipad
สำลัก	チョーク
cmos	cmos
เบรค	ブレーキ
เบรค	ブレーキ
ดอท	ドット
ดอท	dot
marksize	marksize
กลมๆ	ラウンド
กลมๆ	round
กลมๆ	丸い
mcdonald	マクドナルド
nist	nist
มัดจำ	預金
มัดจำ	デポジット
vhs	vhs
kde	kde
asst	asst
medlineplus	medlineplus
wikibooks	wikibooks
alternativemap	alternativemap
อีเมล์	メールアドレス
อีเมล์	メール
ไนลอน	ナイロン
lopez	ロペス
ลินช์	リンチ
กิกิ	キキ
sato	佐藤
datastyle	datastyle
apa	apa
kloster	kloster
ต้อกระจก	白内障
forsskål	forsskål
lightsteelblue	lightsteelblue
อินเตอร์เฟส	インターフェース
อินเตอร์เฟส	インタフェース
sao	sao
ministère	ministère
aol	aol
ลอเรล	ローレル
factsheet	factsheet
ยาสลบ	麻酔
ก๊าด	灯油
rss	rss
aec	aec
แบส	バス
แบส	ベース
ฝักบัว	シャワー
ฝักบัว	にわか
ฝักบัว	シャワー
คลัสเตอร์	クラスタ
tee	ティー
nom	nom
kmc	kmc
อีสุกอีใส	水痘
nano	ナノ
nano	nano
casting	鋳造
miq	miq
gmail	gmail
ผ้าเช็ดหน้า	ハンカチ
เมดเลย์	メドレー
itf	itf
มอลต์	麦芽
เหยือก	マグカップ
เหยือก	ピッチャー
เหยือก	投手
gprs	gprs
fips	fips
watt	ワット
โปรโมชัน	プロモ
โปรโมชัน	プロモーション
โปรโมชัน	宣伝
psu	psu
eka	eka
dodge	ダッジ
dodge	ドッジ
eia	eia
citationclass	citationclass
ซ้า	サーブ
ซอด	ゾッド
actualuse	actualuse
originalairdate	originalairdate
นัมบะ	難波
ras	ラス
อุ้งมือ	前足
sprint	スプリント
nyc	nyc
otome	乙女
publicationdate	publicationdate
mma	mma
panoramio	panoramio
สะเต๊ะ	サテ
แพม	pam
australopithecus	アウストラロピテクス
vhf	vhf
shinee	shinee
ทรัมป์	切り札
ich	ich
คีบ	鉗子
bust	バスト
อรรถประโยชน์	ユーティリティー
อรรถประโยชน์	ユーティリティ
อรรถประโยชน์	効用
อรรถประโยชน์	ユーティリティー
อรรถประโยชน์	ユーティリティ
rsa	rsa
ฮิบ	股関節
ฮิบ	ヒップ
metacritic	metacritic
โบรกเกอร์	ブローカー
พาราฟิน	パラフィン
cms	cms
abcd	abcd
arp	arp
biz	ビズ
ต้อหิน	緑内障
subpages	subpages
pga	pga
ไมก้า	マイカ
svk	svk
จัว	chua
ccccc	ccccc
เซสชัน	セッション
เซสชัน	セッションズ
เซสชัน	セッション
บัดดี้	バディ
เอะอะ	大騒ぎ
itc	itc
tko	tko
vlan	vlan
panasonic	パナソニック
guideline	指針
guideline	ガイドライン
odbc	odbc
พาธ	パス
nds	nds
gogo	ゴゴ
aac	aac
dia	dia
adr	adr
globalsecurity	globalsecurity
kentucky	ケンタッキー
imageright	imageright
ไฮไลต์	ハイライト
ไฮไลต์	ハイライト
ไฮไลต์	見どころ
ไฮไลต์	ハイライト
ซีรี่ส์	シリーズ
ipc	ipc
mah	mah
aps	aps
แชต	チャット
แชต	雑談
quis	quis
cfm	cfm
contentcat	contentcat
cccc	cccc
fps	fps
cwa	cwa
กรน	いびき
joker	ジョーカー
fcc	fcc
เสริฟ	サーブ
ataxia	失調
demospace	demospace
cpe	cpe
pog	pog
bash	バッシュ
อืม	まあ
hdmi	hdmi
ถาก	放牧
tel	tel
ฟิค	イチジク
gam	gam
coco	ココ
palgrave	palgrave
kinki	近畿
japonica	ジャポニカ
kinase	キナーゼ
อัลเฟร็ด	アルフレッド
nec	nec
cdt	cdt
duomo	ドゥオーモ
halign	halign
nvidia	nvidia
isi	isi
pubmed	pubmed
ส่วนลด	割引
ส่วนลด	ディスカウント
ส่วนลด	割引
ส่วนลด	ディスカウント
ส่วนลด	割引き
xvi	xvi
hdl	hdl
arxiv	arxiv
csv	csv
gin	ジン
วัตถุนิยม	唯物論
parc	parc
eco	エコ
nida	nida
amor	アモール
tis	tis
fernández	フェルナンデス
ผิวปาก	ホイッスル
ผิวปาก	口笛
mis	mis
ใสๆ	ドウ
saab	サーブ
vtr	vtr
aeu	aeu
amorphous	アモルファス
anhalt	アンハルト
immunoglobulin	抗体
shortsummary	shortsummary
ati	ati
gmbh	gmbh
psy	psy
tnt	tnt
ปฐมนิเทศ	方向
ปฐมนิเทศ	向き
ปฐมนิเทศ	オリエンテーション
tam	tam
โบกมือ	波動
โบกมือ	ウェーブ
อัลลอฮฺ	ゴッド
württemberg	ヴュルテンベルク
มอซ	moz
subsid	subsid
domenico	ドメニコ
ชอล์ก	チョーク
เดนี	ダニ
ไฟแนนซ์	融資
ไฟแนนซ์	財務
ไฟแนนซ์	金融
ไฟแนนซ์	財政
ไฟแนนซ์	ファイナンス
เฝือก	出演
เฝือก	キャスト
เฝือก	ギプス
ppi	ppi
colstyle	colstyle
moulin	ムーラン
mayo	マヨ
proc	proc
proc	poc
dbt	dbt
uht	uht
rhizopus	クモノスカビ
dcc	dcc
primer	プライマー
mov	mov
ฟลุ๊ค	フルーク
mpv	mpv
กระเจี๊ยบ	ガンボ
vga	vga
scr	scr
บล็อค	ブロック
proud	誇らしい
proud	自慢
proud	誇り
slr	slr
ppv	ppv
บาดทะยัก	破傷風
cfc	cfc
trend	トレンド
trend	流行
outlook	outlook
ชีก	シーク
lounge	ラウンジ
trna	trna
checkuser	checkuser
meshnumber	meshnumber
มโนธรรม	良心
cmu	cmu
เหน็บแนม	嘲笑
ร้อนๆ	熱い
ร้อนๆ	ホット
ร้อนๆ	暑い
เงินผ่อน	融資
hpa	hpa
โรงนา	バーン
โรงนา	納屋
archiveurl	archiveurl
nadh	nadh
ecu	ecu
ขนลุก	不気味
bcd	bcd
แปรงสีฟัน	歯ブラシ
แปรงสีฟัน	歯ブラシ
nobelprize	nobelprize
dev	dev
แล็ป	研究室
แล็ป	研究室
แล็ป	ラボ
oxidase	オキシダーゼ
stm	stm
msds	msds
irq	irq
musashi	ムサシ
musashi	武蔵
formatdate	formatdate
gcc	gcc
ซักรีด	洗濯
ซักรีด	ランドリー
pcall	pcall
tyson	タイソン
coo	coo
คูปอง	クーポン
reductase	レダクターゼ
hug	ハグ
ราจ	ラジ
เย็นๆ	風邪
เย็นๆ	コールド
เย็นๆ	冷たい
เย็นๆ	寒い
pst	pst
dante	ダンテ
colhead	colhead
jelly	ゼリー
cassini	カッシーニ
slip	スリップ
npv	npv
คนสวน	庭師
kawasaki	川崎
backgroundcolors	backgroundcolors
iep	iep
สต๊อก	株式
สต๊อก	ストック
pulp	パルプ
sortkey	sortkey
amg	amg
uni	uni
whispertome	whispertome
quicktime	quicktime
agassiz	アガシー
นมผง	公式
นมผง	数式
srb	srb
nulla	nulla
sevilla	セビリア
sevilla	セビージャ
nrc	nrc
seds	seds
wikibase	wikibase
isnotempty	isnotempty
swu	swu
andante	アンダンテ
philips	フィリップス
พุดดิ้ง	プディング
พุดดิ้ง	プリン
utrecht	ユトレヒト
gainsboro	gainsboro
mango	マンゴ
mango	マンゴー
kato	加藤
theodor	テオドール
uncollapsed	uncollapsed
rec	rec
kbps	kbps
lightblue	lightblue
scopus	scopus
แรงๆ	バッター
แรงๆ	打者
แรงๆ	生地
ttv	ttv
kiseki	キセキ
ติวเตอร์	家庭教師
ติวเตอร์	チューター
puma	プーマ
fnn	fnn
syed	サイイド
โป๊ป	教皇
ลมกรด	旋風
emp	emp
ddd	ddd
kappa	カッパ
rotterdam	ロッテルダム
mild	軽度
aqm	aqm
confed	confed
sco	sco
ppt	ppt
fern	シダ
ไบเบิ้ล	聖書
spam	スパム
lite	lite
futbolme	futbolme
sis	sis
rina	リナ
mdi	mdi
seishun	青春
rta	rta
otc	otc
gts	gts
txt	txt
เลินเล่อ	怠慢
เลินเล่อ	過失
tdi	tdi
อ่างอาบน้ำ	風呂
อ่างอาบน้ำ	入浴
checktype	checktype
wwa	wwa
ssl	ssl
atr	atr
wmc	wmc
mpc	mpc
เกบ	ゲイブ
dst	dst
tachi	太刀
abusefilter	abusefilter
burger	バーガー
burger	ハンバーガー
ucl	ucl
แท็ป	tap
แท็ป	蛇口
แท็ป	タップ
archaeopteryx	archaeopteryx
molly	モリー
ฮอง	ホン
gimp	gimp
valentin	ヴァレンティン
smf	smf
soa	soa
isis	イシス
ncsoft	ncsoft
contribs	contribs
ไฟแช็ก	ライター
wikiquote	ウィキクォート
รังแค	ふけ
getz	ゲッツ
województwo	województwo
moments	moments
moments	モーメント
poj	poj
edda	エッダ
ceeb	ceeb
แม็ท	マット
hobby	趣味
gaiden	外伝
sar	sar
nbr	nbr
ucs	ucs
willd	willd
plainlinks	plainlinks
mainz	マインツ
csa	csa
เคอร์ฟิว	門限
ชักช้า	ラグ
เทท	テート
เทท	テイト
thirteen	thirteen
mecha	メカ
surrealism	シュルレアリスム
leisure	レジャー
leisure	余暇
ผายลม	オナラ
ait	ait
münster	ミュンスター
alb	alb
ไลล์	ライル
ncc	ncc
bbs	bbs
geograph	geograph
beats	ビーツ
tvn	tvn
pda	pda
pda	pda
aura	オーラ
bing	ビング
msm	msm
shm	shm
fef	fef
flex	flex
flex	フレックス
atl	atl
bba	bba
stadio	スタディオ
fta	fta
bpm	bpm
sto	sto
skyblue	skyblue
lgv	lgv
ngv	ngv
ryū	リュウ
fes	fes
ams	ams
wiesbaden	ヴィースバーデン
imd	imd
บางเบา	羽毛
srt	srt
spreng	spreng
pubchem	pubchem
innsbruck	インスブルック
weibo	weibo
tottenham	トッテナム
dora	ドーラ
mime	mime
firewire	firewire
หนักๆ	重い
หนักๆ	ヘビー
std	std
wolfram	ヴォルフラム
muller	ミュラー
imax	imax
archivedate	archivedate
kerry	ケリー
qld	qld
cups	cups
cups	カップ
dnp	dnp
illu	illu
msnbc	msnbc
tve	tve
blink	点滅
sixteenth	sixteenth
liner	ライナー
iarc	iarc
magnet	磁石
magnet	マグネット
toon	トゥーン
nrhp	nrhp
bild	bild
dct	dct
bam	バム
exodus	exodus
rvr	rvr
msj	msj
rwd	rwd
igf	igf
nct	nct
tabi	足袋
ora	オラ
ucode	ucode
goto	五島
goto	後藤
pax	pax
gta	gta
ups	ups
บอกใบ้	ヒント
cod	コッド
cod	タラ
เคเบิ้ล	電線
เคเบิ้ล	ケーブル
เลขาฯ	秘書
deutschland	ドイッチュラント
lisbon	リスボン
tpe	tpe
tbm	tbm
เมี้ยว	ニャー
เมี้ยว	ニャン
zoids	ゾイド
mbta	mbta
cdu	cdu
nabo	nabo
fernandez	フェルナンデス
kunth	kunth
mir	ミール
girard	ジラード
girard	ジラール
medien	medien
bismuth	ビスマス
korn	korn
michele	ミケーレ
ochotona	ochotona
dickson	ディクソン
ตอแหล	でたらめ
nok	ノック
apec	apec
ญาติๆ	親族
ญาติๆ	親戚
toolserver	toolserver
köln	ケルン
btob	btob
nnn	nnn
zimmermann	ジマーマン
zimmermann	ツィンメルマン
ชอปปิ้ง	ショッピング
ชอปปิ้ง	買い物
ชอปปิ้ง	買物
bom	bom
กรีส	グリース
dbd	dbd
noi	noi
kuniyoshi	国芳
ksa	ksa
เบย	bae
cfa	cfa
ไมโล	milo
งีบ	昼寝
nucleotide	ヌクレオチド
ano	阿野
vim	vim
quantitative	定量
kirchner	キルチネル
เปียนโน	ピアノ
dlc	dlc
utagawa	歌川
collagen	コラーゲン
prolog	prolog
slalom	スラローム
macbook	macbook
sac	sac
unitary	ユニタリ
ดินเนอร์	ディナー
ดินเนอร์	夕食
mazda	マツダ
ไกส์	skype
mimi	ミミ
avatar	アヴァターラ
avatar	アバター
yaroslavl	ヤロスラヴリ
omim	omim
ssc	ssc
fcb	fcb
accademia	アカデミア
powerpc	powerpc
coe	coe
เลอะเทอะ	混乱
barincrement	barincrement
cta	cta
chapterurl	chapterurl
ทัณฑ์บน	仮釈放
petite	ぷち
quint	クイント
broker	ブローカー
ซิการ์	シガー
adb	adb
ดรอป	ドロップ
henrik	ヘンリク
การขนส่งมวลชน	トランジット
bonn	ボン
เมกะเฮิรตซ์	mhz
glutamate	グルタミン酸
khabarovsk	ハバロフスク
oakland	オークランド
nadph	nadph
tensor	テンソル
oro	オロ
นู่	ヌーフ
กระเด้ง	バウンス
ขาอ่อน	太もも
dpr	dpr
dns	dns
ttl	ttl
acn	acn
แชท	チャット
แชท	雑談
evenodd	evenodd
moo	moo
zap	ザップ
sma	sma
เอเย่นต์	エージェント
เอเย่นต์	代理人
oed	oed
msu	msu
outdoor	アウトドア
outdoor	屋外
gakuin	学院
imc	imc
เปเป	ペルー
bodyguard	ボディーガード
bodyguard	ボディガード
nfc	nfc
gpb	gpb
samba	サンバ
velit	velit
wikiversity	ウィキバーシティ
minimal	最小限
ntsc	ntsc
sop	sop
csd	csd
czw	czw
torii	鳥居
csu	csu
cagematch	cagematch
casio	カシオ
barron	バロン
bopp	ボップ
özil	エジル
pur	pur
ช๊อค	ショック
ช๊อค	衝撃
เตารีด	アイロン
voc	voc
เครป	クレープ
göttingen	ゲッティンゲン
asahina	朝比奈
atk	atk
หวานๆ	スウィート
หวานๆ	甘い
micky	ミッキー
tyrosine	チロシン
céline	セリーヌ
wikivoyage	wikivoyage
mms	mms
cgmp	cgmp
dmc	dmc
montréal	モントリオール
vue	vue
consequat	consequat
spica	スピカ
bara	薔薇
webos	webos
gpp	gpp
มึนงง	クラクラ
humboldt	フンボルト
nike	ナイキ
nike	nike
เนธาน	ネイサン
iter	iter
ops	ops
enim	enim
blackberry	blackberry
โชคลาง	迷信
marius	マリウス
bsc	bsc
commuter	通勤
cbn	cbn
บังกะโล	バンガロー
mps	mps
hrsg	hrsg
นิกิ	ニキ
rip	リッピング
rip	rip
rip	リップ
smtp	smtp
sus	sus
diffusivity	diffusivity
dag	dag
fila	フィラ
pang	ホウ
ngn	ngn
nicky	ニッキー
motogp	motogp
palermo	パレルモ
เบลิซ	ベリーズ
rdf	rdf
prc	中華人民共和国
parque	パルケ
rondo	ロンド
amr	アムル
truss	トラス
moma	moma
hannover	ハノーファー
iglesias	イグレシアス
mobygames	mobygames
augsburg	アウクスブルク
gmatch	gmatch
wmflabs	wmflabs
prec	prec
sdb	sdb
อาร์ตี้	アーティ
องคชาติ	陰茎
องคชาติ	ペニス
hussain	フセイン
tempor	tempor
acs	acs
nail	ネイル
wimax	wimax
aes	aes
zum	zum
reina	レイナ
csc	csc
emporis	emporis
ffb	ffb
tpp	tpp
poptime	poptime
apex	頂点
เด็บ	deb
daw	daw
enwiki	enwiki
bubba	ババ
toho	東宝
adp	adp
offical	職員
uzb	uzb
ether	エーテル
kwh	kwh
tdma	tdma
bwr	bwr
tcm	tcm
adv	adv
กยู	ギュ
mde	mde
asc	asc
gsp	gsp
palacio	パラシオ
beverley	ビヴァリー
pka	pka
eros	エロス
lgbt	lgbt
hkg	hkg
icann	icann
rihanna	リアーナ
blitz	ブリッツ
nur	ヌール
nsaids	nsaids
shoten	聖天
thành	thành
stripe	ストライプ
sylvia	シルヴィア
sylvia	シルビア
ptg	ptg
wolfsburg	ヴォルフスブルク
omg	omg
xix	xix
quân	クアン
openbsd	openbsd
scc	scc
dolce	ドルチェ
ffi	ffi
oto	オト
gbr	gbr
afs	afs
civ	civ
mdd	mdd
buch	ブーフ
bibcode	bibcode
opengl	opengl
บลูเบอร์รี	ブルーベリー
mtb	mtb
consolidation	併合
megaforce	メガフォース
sixty	sixty
nzl	nzl
ซุปเปอร์มาร์เก็ต	スーパーマーケット
ซุปเปอร์มาร์เก็ต	スーパーマーケット
volvo	ボルボ
deus	デウス
phineas	フィニアス
psk	psk
ทิงเจอร์	チンキ
dylan	ディラン
oldid	oldid
pgm	pgm
ddot	ddot
puy	ピュイ
เปล่งปลั่ง	発光
milo	milo
สะอึก	しゃっくり
เฮ้	ヘイ
nikon	ニコン
prk	prk
sana	サナ
atrium	atrium
nowiki	nowiki
freenode	freenode
gucci	グッチ
guilford	ギルフォード
kari	カリ
naoh	naoh
gourmet	グルメ
chembox	chembox
flava	flava
cvd	cvd
snak	snak
swainson	swainson
pte	pte
hbv	hbv
ansi	ansi
soccerway	soccerway
wada	和田
tts	tts
เคอร์เซอร์	カーソル
ragtime	ラグタイム
kawaii	カワイイ
prinz	プリンツ
richelieu	リシュリュー
naa	naa
ymca	ymca
ssb	ssb
adj	adj
paix	paix
tunguska	ツングースカ
hsdpa	hsdpa
สมิทธ์	スミス
rolfe	ロルフ
ทำครัว	キッチン
ทำครัว	台所
sfr	sfr
rtl	rtl
vir	vir
tnf	tnf
เบ็ท	ベス
rosetta	ロゼッタ
utm	utm
trump	切り札
othernames	othernames
pron	pron
nach	nach
bose	ボーズ
anchoring	アンカー
yonekura	米倉
tep	tep
plainlist	plainlist
cpn	cpn
bbb	bbb
tif	tif
ฟินช์	フィンチ
kuw	kuw
earn	獲得
earn	稼ぐ
adolph	アドルフ
hilton	ヒルトン
swa	swa
wrc	wrc
regency	摂政
protease	プロテアーゼ
vos	vos
hct	hct
spyder	spyder
texture	テクスチャー
texture	テクスチャ
suppressplaceholder	suppressplaceholder
prestel	prestel
scn	scn
lcc	lcc
ota	太田
boomerang	ブーメラン
stephan	ステファン
networth	networth
tvk	tvk
thunb	thunb
shōjo	少女
lfp	lfp
ksc	ksc
jeju	済州
clr	clr
iguaçu	イグアス
eme	eme
โฮลท์	ホルト
mls	mls
tem	tem
ดุค	公爵
ดุค	デューク
sfc	sfc
asm	asm
onsen	温泉
tres	トレス
ces	ces
soccernet	soccernet
origyear	origyear
tfg	tfg
phosphatase	ホスファターゼ
nld	nld
sergio	セルジオ
เฮ็ค	ヘック
cwc	cwc
faf	faf
chanel	シャネル
niosh	niosh
hermes	ヘルメース
bernhard	ベルナルド
cbm	cbm
mus	mus
herrera	エレーラ
อาลิ	アリー
อาลิ	アリ
อาลิ	ali
kirov	キーロフ
ลอตเตอรี่	宝くじ
ลอตเตอรี่	抽選
jdbc	jdbc
astrakhan	アストラハン
tms	tms
หือ	はぁ
บริกส์	ブリッグス
ฟรอสท์	フロスト
func	func
lgpl	lgpl
เซจ	セージ
koala	コアラ
vlsi	vlsi
cml	cml
atsuko	敦子
naver	ネイバー
forte	フォルテ
ทะนุถนอม	チェリッシュ
grape	ぶどう
grape	ブドウ
docomo	docomo
photoshop	photoshop
bartolomeo	バルトロメオ
gatsby	ギャツビー
msx	msx
โฮลต์	ホルト
ebook	ebook
asn	asn
dsa	dsa
openoffice	openoffice
antwerp	アントワープ
iis	iis
tui	tui
dra	dra
sws	sws
ว่างๆ	空っぽ
cassatt	カサット
lse	lse
ยกนิ้ว	親指
สเต็ก	ステーキ
สเต็ก	ステーキ
nep	nep
selena	セレーナ
ses	ses
chemspiderid	chemspiderid
boucher	バウチャー
tyrol	チロル
pam	pam
deadurl	deadurl
mof	mof
zepp	zepp
publ	publ
npt	npt
swat	swat
swat	スワット
cns	cns
yokoyama	横山
lantis	lantis
psg	psg
แม็ต	マット
aso	阿蘇
aso	麻生
catalunya	カタルーニャ
relax	リラックス
chelyabinsk	チェリャビンスク
tmp	tmp
pes	pes
noël	ノエル
coating	コーティング
kcal	kcal
avi	avi
shima	志摩
dap	dap
perugino	ペルジーノ
nhl	nhl
mariano	マリアーノ
rhs	rhs
fsa	fsa
glee	グリー
fujibayashi	藤林
concacaf	concacaf
holthuis	holthuis
icc	icc
pwa	pwa
lipase	リパーゼ
เฝอ	ウェルギリウス
เฝอ	ヴァージル
masato	雅人
natvar	natvar
github	github
dte	dte
mezzo	mezzo
ยูนิฟอร์ม	ユニフォーム
ยูนิฟอร์ม	制服
zim	zim
bfa	bfa
novosti	novosti
งงงวย	当惑
wikispecies	wikispecies
isr	isr
fnc	fnc
skyscraperpage	skyscraperpage
crs	crs
regex	regex
wav	wav
bunko	文庫
megan	メーガン
tay	テイ
icu	icu
rafale	rafale
gmp	gmp
atx	atx
คลอโรฟอร์ม	クロロホルム
mainsnak	mainsnak
labore	labore
palmas	パルマス
moa	モア
fazer	fazer
anim	anim
diaz	ディアス
xviii	xviii
แอ๊ปเปิ้ล	リンゴ
แอ๊ปเปิ้ล	りんご
gingham	ギンガム
tmf	tmf
cmll	cmll
gridcolor	gridcolor
vivace	vivace
suphanburi	スパンブリー
cll	cll
sut	sut
wmo	wmo
tid	tid
เทพพยากรณ์	oracle
เทพพยากรณ์	オラクル
เทพพยากรณ์	神託
maler	maler
acp	acp
farnese	ファルネーゼ
bofors	ボフォース
ise	伊勢
presto	プレスト
monash	モナシュ
mrc	mrc
cnet	cnet
awd	awd
พิมพ์เขียว	blueprint
ddf	ddf
ode	ode
reds	レッズ
regensburg	レーゲンスブルク
msk	msk
gonzo	ゴンゾ
gonzo	ゴンゾー
nami	ナミ
ทรัมพ์	切り札
ffk	ffk
rrna	rrna
shy	人見知り
shy	シャイ
setter	セッター
cmyk	cmyk
thuringia	テューリンゲン
ฉาวโฉ่	汚名
ฉาวโฉ่	infamous
könig	ケーニヒ
fab	fab
xxii	xxii
pty	pty
tvm	tvm
fairuse	fairuse
abf	abf
xxvi	xxvi
bhr	bhr
oca	oca
horner	ホーナー
lag	ラグ
sourcebook	sourcebook
galleria	galleria
iffhs	iffhs
matsumura	松村
fns	fns
searchlight	サーチライト
nsa	nsa
spf	spf
eget	eget
pvt	pvt
taiping	太平
allstars	オールスターズ
cmr	cmr
arctan	arctan
chf	chf
wikimapia	wikimapia
édition	édition
qasim	カシム
notableworks	notableworks
tomica	トミカ
zin	zin
esc	esc
smp	smp
hmg	hmg
athlon	athlon
pbk	pbk
iws	iws
swf	swf
presl	presl
mugen	夢幻
uli	ウリ
hemsl	hemsl
allegretto	allegretto
footballdatabase	footballdatabase
tsurugi	つるぎ
tos	tos
cee	cee
crm	crm
royaume	royaume
nasser	ナーセル
prada	プラダ
moderato	moderato
hidalgo	イダルゴ
abba	アバ
xxv	xxv
dll	dll
aze	aze
cpa	cpa
สะเพร่า	無謀
สะเพร่า	ずさん
acd	acd
messagebox	messagebox
lfc	lfc
spx	spx
เซสชั่น	セッション
เซสชั่น	セッションズ
เซสชั่น	セッション
castello	カステッロ
girolamo	ジローラモ
saitō	斎藤
ffebcd	ffebcd
ubisoft	ubisoft
igg	igg
tpl	tpl
afa	afa
rashomon	羅生門
msc	msc
iea	iea
adt	adt
หนาๆ	厚い
หนาๆ	太い
zia	ジア
cindy	シンディ
bur	bur
phenol	フェノール
ดรูว	ドリュー
phtml	phtml
benedetto	ベネデット
bgm	bgm
อัลม่า	アルマ
krupp	クルップ
ลอว์เรน	ローレン
cowboys	カウボーイ
mwf	mwf
คาร์เนชั่น	カーネーション
spacy	spacy
vorbis	vorbis
deu	deu
caco	caco
เฟช	fae
strangelove	strangelove
oao	oao
vertices	頂点
cdm	cdm
rso	rso
tainan	台南市
vac	vac
sps	sps
supérieure	supérieure
dth	dth
rostov	ロストフ
fmt	fmt
kiki	キキ
dexamethasone	デキサメタゾン
lactobacillus	乳酸菌
pcv	pcv
แมช	マッシュ
pdu	pdu
enwp	enwp
scw	scw
sbk	sbk
tandem	タンデム
tetsuya	哲也
jal	jal
เมโย	マヨ
ถูกๆ	安い
iczn	iczn
mouton	ムートン
pstn	pstn
unsc	unsc
weidenfeld	weidenfeld
nus	nus
icj	icj
peerage	爵位
lwb	lwb
kps	kps
แอพพลิเคชัน	出願
แอพพลิเคชัน	アプリケーション
fifteen	fifteen
fifteen	十五
nia	ニア
fdm	fdm
นูร	ヌーフ
tah	tah
clh	clh
scs	scs
irst	irst
smr	smr
sourceforge	sourceforge
messe	メッセ
sassy	奇抜
ปิกนิก	ピクニック
dbms	dbms
brigitte	ブリジット
kamel	カメル
dinh	ディン
fuck	ファック
gib	gib
officier	officier
ashgate	ashgate
uwf	uwf
ftv	ftv
angie	アンジー
bjt	bjt
ผ้าดิบ	生地
pag	pag
sle	sle
methionine	メチオニン
giuliano	ジュリアーノ
uus	uus
ชอล์ค	チョーク
bernoulli	ベルヌーイ
orthogonal	直交
dope	ドープ
awm	awm
ris	ris
icw	icw
ascap	ascap
nox	nox
ghc	ghc
phaidon	phaidon
yukihiro	幸広
sugiyama	杉山
physique	体格
tiff	tiff
mtu	mtu
dts	dts
snh	snh
ceres	ケレス
trf	trf
ไพธอน	python
ไพธอน	ニシキヘビ
tsr	tsr
ดุ๊ค	公爵
ดุ๊ค	デューク
esprit	エスプリ
tyumen	チュメニ
kurata	倉田
bcc	bcc
audi	アウディ
niche	ニッチ
iupacname	iupacname
psc	psc
kazumi	かずみ
planar	プラナー
mrp	mrp
hayabusa	はやぶさ
kazuki	一樹
viaf	viaf
tuck	タック
wetland	湿地
bpi	bpi
ludacris	ludacris
vulgate	ヴルガータ
exec	exec
fogarty	フォガティ
ldp	ldp
schwarzschild	シュヴァルツシルト
agp	agp
ijf	ijf
bayan	バヤン
powerpoint	powerpoint
jours	jours
fink	fink
sharma	シャルマ
อิตาลี่	イタリア
smolensk	スモレンスク
wiltshire	ウィルトシャー
yuzhno	ホム
auflage	auflage
json	json
krasnoyarsk	クラスノヤルスク
tsui	ツイ
มอร์ฟ	モーフ
snr	snr
hanabi	hanabi
glock	グロック
mui	ムイ
gladys	グラディス
mmc	mmc
goodwill	親善
goodwill	のれん
iwf	iwf
อัพเดต	アップデート
อัพเดต	更新
praeger	praeger
trujillo	トルヒーヨ
เกษียน	退職
nbk	nbk
mfa	mfa
voronezh	ヴォロネジ
ทักซิโด	タックス
ทักซิโด	タキシード
ilo	ilo
mcs	mcs
skype	skype
maji	マジ
soccerbase	soccerbase
nijhoff	nijhoff
adf	adf
pki	pki
กิกะไบต์	ギガバイト
nylon	ナイロン
xxvii	xxvii
ira	アイラ
openstreetmap	openstreetmap
wysiwyg	wysiwyg
csm	csm
mhnt	mhnt
xxxxx	xxxxx
kris	クリス
jct	jct
qid	qid
biophysics	biophysics
azur	アズール
cerro	セロ
steud	steud
bloomsbury	bloomsbury
thc	thc
bundesarchiv	bundesarchiv
président	président
gtl	gtl
rainer	ライナー
misawa	三沢
penza	ペンザ
postgresql	postgresql
sechs	sechs
pci	pci
senki	戦記
ooo	ooo
sverdlovsk	スヴェルドロフスク
unk	unk
amoxicillin	アモキシシリン
plasmodium	plasmodium
rpe	rpe
fip	fip
ngr	ngr
mmhg	mmhg
esm	esm
ugo	羽後
patrie	patrie
nycsubway	nycsubway
pcc	pcc
tva	tva
smalltext	smalltext
portail	portail
asl	asl
lautrec	ロートレック
botanique	botanique
kaluga	カルーガ
imap	imap
ipx	ipx
dafif	dafif
aquino	アキノ
สเปรดชีต	スプレッドシート
pistoia	ピストイア
nishimura	西村
uga	uga
fiesta	fiesta
rge	rge
คาโล	カルロ
cps	cps
bayes	ベイズ
studien	studien
clp	clp
kurgan	クルガン
nineteen	nineteen
butyl	ブチル
scape	scape
ceramic	セラミック
nigripes	nigripes
massa	マッサ
pgc	pgc
mgr	mgr
pob	pob
akatsuki	あかつき
svc	svc
ผ้าเช็ดตัว	タオル
libertadores	リベルタドーレス
นอกชาน	パティオ
patrimoine	patrimoine
tcl	tcl
imt	imt
kolmogorov	コルモゴロフ
vldl	vldl
