รังสีวิทยา	رادیولوژی
โนห์	نوو
transfermarkt	transfermarkt
ปลาบปลื้ม	نشئه
rai	رای
โอ๊ย	آخ
dateformat	dateformat
dino	دینو
tattoo	خالکوبی
tattoo	تاتو
mev	mev
กว้าน	وینچ
gpcm	gpcm
ping	پینگ
melbourne	ملبورن
undef	undef
บังเกอร์	سنگر
vicepresident	vicepresident
mia	mia
mia	میا
bride	عروس
chuck	چاک
noaa	noaa
สลิป	لغزش
cruz	کروز
cruz	کروس
finale	اختتامیه
maya	مایا
dolby	دالبی
เบลค	بلیک
เน็ด	ند
ล็อบบี้	لابی
ซ้าบ	ساب
aki	آکی
palestine	فلسطین
palestine	فلسطینی
kate	kate
กรี๊ด	جیغ
pmc	pmc
อีเจียน	اژه
vita	vita
belowclass	belowclass
ซิบ	زیپ
โพส	پست
โพส	پستی
โพส	post
โพส	ژست
โพส	پوز
แฮ็ก	هک
แฮ็ก	نفوذ
แฮ็ก	هک
แฮ็ก	هک
แฮ็ก	hack
icao	ایکائو
นอกใจ	تقلب
nextseason	nextseason
ขายส่ง	عمده
sap	ساپ
einecs	einecs
บดขยี้	کوبیده
textcolor	textcolor
licensor	licensor
isp	isp
gpu	gpu
gpu	گرافیک
cvt	cvt
pframe	pframe
สปา	چشمه
สปา	اسپا
ลค	بلیک
cyp	cyp
origargs	origargs
nbt	nbt
duty	وظیفه
sphrases	sphrases
prevseason	prevseason
คอรัปชั่น	فاسد
din	الدین
din	din
spd	spd
phylogeny	فیلوژنی
che	che
แพ็คเกจ	پک
แพ็คเกจ	فشردن
แพ็คเกจ	تدبیر
แพ็คเกจ	پلان
แพ็คเกจ	نقشه
แพ็คเกจ	بسته
แพ็คเกจ	بستۀ
autocollapse	autocollapse
บอยด์	بوید
วอลเล่ย์	والیبال
sans	sans
โซนาร์	سونار
ccff	ccff
gym	باشگاه
gym	ورزشگاه
gym	ورزش
ncaa	ncaa
ช่ำชอง	حاذق
headman	کدخدا
singlechart	singlechart
seventeen	هفده
เซอร์ไพรส์	غافلگیری
เซอร์ไพรส์	surprise
เซอร์ไพรส์	سورپرایز
เซอร์ไพรส์	سوپرایز
rune	رونه
อาเมน	آمین
ฟลอเรส	فلورس
เท็ต	تیت
ความเฉื่อย	لختی
ฮาร์ป	چنگ
ดิ๊ก	دیک
แคลอรี่	کالری
univ	univ
bdfutbol	bdfutbol
พล็อต	رسم
พล็อต	نیرنگ
getparent	getparent
roca	رکا
เป๊ะ	دقیقا
เป๊ะ	دقیقأ
เป๊ะ	دقیقاً
annie	آنی
ไถนา	شخم
bella	بلا
เมอร์ลิน	مرلین
แชด	چاد
แชด	چد
มูส	موس
มูส	گوزن
vpn	vpn
resistivity	resistivity
imagestyle	imagestyle
chelsea	چلسی
chelsea	chelsea
coin	سکه
หอน	زوزه
หอน	نیزه
หอน	اسپیر
ทรัม	ترامپ
titan	تیتان
titan	تایتان
wet	مرطوب
wet	خیس
หลงลืม	غفلت
หลงลืม	غافل
seealso	seealso
เตาผิง	شومینه
บาร์บูดา	باربودا
อัลฟ่า	آلفا
ขนมอบ	پختن
ขนมอบ	شیرینی
ndregional	ndregional
สดๆ	تازه
subst	subst
ukr	ukr
mpa	mpa
หวีด	سوت
บรูก	bru
ลูค	لوقا
ลูค	لوک
สวมรอย	باتلاقها
ปู่ย่า	گرن
mbf	mbf
ppp	ppp
funky	بدبو
aut	aut
อาร์เรย์	آرایه
อินเตอร์เน็ต	اینترنت
อินเตอร์เน็ต	اینترنتی
nominator	nominator
อินเดียนา	ایندیانا
แฮกเกอร์	هکرها
แฮกเกอร์	هکر
แฮกเกอร์	هکرها
nikki	نیکی
benz	بنز
benz	benz
scalemajor	scalemajor
piaget	پیاژه
nocat	nocat
adsl	adsl
hdtv	hdtv
termstart	termstart
burton	برتون
burton	بارتون
lcd	lcd
gakuen	gakuen
hay	علف
hay	hay
แอป	اپ
แอป	برنامه
นกหวีด	سوت
termend	termend
ต้นคอ	نک
ต้นคอ	گردن
chrome	کروم
taoiseach	taoiseach
sim	سیم
amp	amp
แลป	آزمایشگاه
แลป	ازمایشگاه
ขี้เหร่	زشته
ขี้เหร่	زشتی
ขี้เหร่	زشت
พรีเมียม	اضافی
aru	aru
uri	اوری
uri	uri
เทด	تد
ชาร์ล็อตต์	شارلوت
มีดโกน	تیغی
sophie	سوفی
ลูกเห็บ	تگرگ
iro	iro
อุ้งเท้า	پنجه
ploceus	ploceus
ลิปสติก	ماتیک
ronaldo	رونالدو
casa	کاسا
sos	sos
อายัด	منجمد
ssp	ssp
ซุซุ	زاوش
ซุซุ	زئوس
cts	cts
pgp	pgp
visa	روادید
visa	ویزا
visa	ویزای
ขนตา	مژگان
ขนตา	مژه
ขนตา	مژه
ขนตา	تازیانه
อาร์กิวเมนต์	آرگومان
อาร์กิวเมนต์	دلایل
อาร์กิวเมนต์	استدلال
uhf	uhf
crush	پایمال
crush	کراش
reg	رج
reg	رگ
ซอฟแวร์	نرمافزار
ocinsoutput	ocinsoutput
แฟนซี	محبوبی
แฟนซี	پندار
แฟนซี	گمان
lancer	لنسر
mda	mda
อะเดล	ادل
อะเดล	آدل
alignbars	alignbars
concepts	مفاهیم
temminck	تمینک
skill	مهارتی
skill	مهارت
sud	سود
โฮมเพจ	آغازه
โลชั่น	لوسیون
โลชั่น	شویه
มอเตอร์เวย์	آزادراه
ลาเวนเดอร์	اسطوخودوس
ลาเวนเดอร์	سنبل
ฟีด	تغذیه
ฟีด	خوراندن
viva	viva
sql	sql
meshname	meshname
bodystyle	bodystyle
ตรรก	معقول
ตรรก	عقلانی
ตรรก	منطقی
ตรรก	منطق
ตรรก	منطقی
lte	lte
passive	غیرفعال
passive	منفعل
dao	dao
pascal	پاسکال
ขยะแขยง	چندش
burke	برک
โลเวลล์	لول
โลเวลล์	لوول
โลเวลล์	لاول
kitty	پیشی
หลาบ	یارد
เต๋	teh
มัสตาร์ด	خردل
มัสตาร์ด	خردلی
ดอกจิก	خاج
hood	هود
autoconfirmed	autoconfirmed
schott	شوت
หลงกล	گول
eur	eur
กุญแจมือ	دستبند
โปรไฟล์	profile
โปรไฟล์	نمایه
โปรไฟล์	پروفایل
โปรไฟล์	profile
sais	sais
ind	ind
clover	شبدر
aaaaaa	aaaaaa
cheese	پنیر
จู๊ด	جود
wto	wto
บูกิต	بوکیت
เบลโล	بیو
turismo	توریسمو
ctrl	مهار
pac	پک
pac	pac
sortable	sortable
nums	nums
ufc	ufc
requiem	مرثیه
requiem	فاتحه
รปภ	امنیتی
รปภ	حراست
รปภ	امنیت
emma	اِما
หัวนม	پستان
หัวนม	ممه
heuristic	اکتشافی
mohd	mohd
plc	plc
raven	کلاغ
raven	ریون
lorem	lorem
แล็ปท็อป	لپ
เบลก	بلیک
lucy	لوسی
gnis	gnis
กานพลู	میخک
ordre	ordre
โป๊กเกอร์	پوکر
nfl	nfl
dengeki	فامیتسو
lip	لبش
lip	لیپ
lip	لب
moss	ماس
moss	خزه
ปลอกคอ	قلاده
ปลอกคอ	یقه
โฮล์มส์	هولمز
โฮล์มส์	هلمز
ไมลส์	مایل
ไมลส์	مایلز
civic	مدنی
civic	سیویک
leiden	لیدن
iec	iec
naruto	ناروتو
carmen	کارمن
ท็อปส์	حداکثر
lgn	lgn
ตื้นๆ	سطحی
retval	retval
หนองใน	سوزاک
mustela	mustela
ลินซ์	لینچ
คีท	کیث
topscorer	topscorer
dubai	دبی
dubai	dubai
dubai	دوبی
ทรัมเปต	شیپور
ทรัมเปต	ترومپت
ทรัมเปต	صور
กระวนกระวาย	دلواپس
tao	تائو
gis	gis
opentheme	opentheme
สวยๆ	زیباست
สวยๆ	زیبا
สวยๆ	خوشگل
สวยๆ	قشنگ
สวยๆ	خوشگل
สวยๆ	خوشگله
สวยๆ	خیلی
sdtv	sdtv
ภาพยนต์	فیلمی
ภาพยนต์	فیلم
ภาพยนต์	فیلمش
ภาพยนต์	سینمایی
ภาพยนต์	سینما
ภาพยนต์	فیلمهایی
ภาพยนต์	فیلم
ภาพยนต์	فیلمها
cma	cma
mep	mep
asa	آسا
ฉุบ	قیچی
mou	mou
พุพอง	تاول
นํ้า	آب
คราง	ناله
uprising	خونتا
slim	اسلیم
curry	نان
scaleminor	scaleminor
stp	stp
templatedata	templatedata
exp	exp
det	det
corticosteroids	کورتیکواستروئیدها
loaddata	loaddata
osprey	اوسپری
directx	directx
merriam	مریام
miocene	میوسن
luca	لوکا
ตาชั่ง	ترازوی
familycolor	familycolor
evergreen	اورگرین
ใคร่ครวญ	اندیشه
ใคร่ครวญ	منعکس
titleclass	titleclass
nic	nic
rubiaceae	روناسیان
ขวนขวาย	کسب
tls	tls
mtc	mtc
pwg	pwg
idn	idn
มิจฉาชีพ	کروک
มิจฉาชีพ	کروکس
ucla	ucla
เอทีเอ็ม	خودپرداز
เอทีเอ็ม	atm
wta	wta
แรนด์	رند
นมวัว	گاوه
นมวัว	گاوی
นมวัว	گاو
terma	terma
ped	ped
sdn	sdn
pizza	پیتزای
pizza	پیتزا
เซรามิค	سرامیک
เซรามิค	سرامیک
cis	سیس
dek	dek
phuket	پوکت
nrt	nrt
bhd	bhd
cotton	کاتن
cotton	کتان
cotton	پنبه
cze	cze
ipod	آیپاد
emerg	emerg
ทำหมัน	سترون
ไซนัส	سینوس
setmetatable	setmetatable
hokusai	هوکوسائی
ole	اوله
domesticpartner	domesticpartner
chennai	چنای
peng	پنگ
solaris	سولاریس
ดีซ่าน	زردی
บาร์บีคิว	کباب
hrh	hrh
hcl	hcl
baba	baba
ems	امس
sohc	sohc
เทียนไข	شمع
hoc	hoc
โคไซน์	کسینوس
เก๊าท์	نقرس
บู้	بو
บู้	بوو
subfamilia	subfamilia
tidal	کشندی
เพียซ	پیرس
เมก	مگ
shtml	shtml
sue	سو
terme	ترمه
als	als
cites	میزند
birdlife	birdlife
emerald	زمرد
emerald	زمردی
bas	باس
bas	bas
percussion	دق
แฮ็ค	هک
รีซ	ریسی
รีซ	ریس
จอร์น	جان
จอร์น	یوحنا
ตะคริว	پیچه
plantae	plantae
จำนอง	رهن
lccn	lccn
oecd	oecd
subclassis	subclassis
disp	disp
sig	زیگ
ตูด	کون
ตูด	باسن
ตูด	بات
linecolor	linecolor
esrb	esrb
irn	irn
วิสกี้	ویسکی
วิสกี้	ھم
วิสกี้	ویسکی
basestyle	basestyle
afp	afp
ฟอร์แมต	قالب
ฟอร์แมต	قالبی
จิ๋ม	دخترک
จิ๋ม	ترسو
ไดร์ฟ	درایو
ไดร์ฟ	رانندگی
ไดร์ฟ	سوق
lpg	lpg
bacillus	باسیلوس
wifi	wifi
getcurrenttitle	getcurrenttitle
ambox	ambox
msv	msv
ipad	آیپد
สำลัก	خفگی
cmos	cmos
gmelin	گملین
เบรค	ترمز
เบรค	ترمز
ดอท	دات
marksize	marksize
mcdonald	مکدونالد
nist	nist
มัดจำ	سپرده
trigramme	trigramme
vhs	vhs
kde	kde
asst	asst
medlineplus	medlineplus
alternativemap	alternativemap
ไนลอน	نایلون
ทะลึ่ง	پررو
lopez	لوپز
ลินช์	لینچ
goldblatt	گولدبلات
กิกิ	کیکی
sato	ساتو
datastyle	datastyle
kloster	kloster
ifpi	ifpi
gpa	معدل
lightsteelblue	lightsteelblue
อินเตอร์เฟส	واسط
อินเตอร์เฟส	رابط
aol	aol
ลอเรล	لارل
ลอเรล	لورل
perrow	perrow
factsheet	factsheet
ยาสลบ	موضعی
rss	rss
aec	aec
แบส	بیس
แบส	باس
ฝักบัว	دوش
ฝักบัว	رگبار
ฝักบัว	بارانی
ฝักบัว	دوش
ฝักบัว	رگبار
ปาโล	پالو
คลัสเตอร์	خوشه
tee	tee
nom	nom
wittgenstein	ویتگنشتاین
avec	avec
อีสุกอีใส	آبله
nano	نانو
iss	iss
bamboo	بامبو
gmail	gmail
cyworld	cyworld
ผ้าเช็ดหน้า	دستمال
เมดเลย์	مدلی
ipcc	ipcc
itf	itf
nong	نانگ
มอลต์	مالت
byp	byp
เนด	ند
เหยือก	لیوان
เหยือก	پارچ
gprs	gprs
fips	fips
watt	وات
โปรโมชัน	promo
โปรโมชัน	ترویج
โปรโมชัน	ارتقاء
โปรโมชัน	ترفیع
โปรโมชัน	تبلیغ
โปรโมชัน	ارتقای
โปรโมชัน	ارتقا
psu	psu
editpage	editpage
eka	اکا
dodge	دوج
dodge	داج
eia	eia
citationclass	citationclass
ซ้า	ساب
ซอด	زاد
actualuse	actualuse
amet	amet
kin	خویشاوند
kin	خویشاوندان
ras	ras
sprint	اسپرینت
nyc	nyc
publicationdate	publicationdate
mma	mma
panoramio	پانورامیو
แพม	پم
จดจ่อ	متمرکز
จดจ่อ	تمرکز
vhf	vhf
shinee	شاینی
ทรัมป์	ترامپ
timeshift	timeshift
ich	ich
johan	یوهان
bust	بالاتنه
อรรถประโยชน์	تسهیلات
อรรถประโยชน์	سودمندی
rsa	rsa
ฮิบ	باسن
ฮิบ	هیپ
metacritic	متاکریتیک
โบรกเกอร์	دلال
โบรกเกอร์	کارگزار
พาราฟิน	پارافین
cms	cms
abcd	abcd
arp	arp
biz	بیز
dude	رفیق
deutsch	دویچ
subpages	subpages
hotcat	hotcat
geniculate	geniculate
pga	pga
ไมก้า	میکا
svk	svk
จัว	چوا
ccccc	ccccc
เซสชัน	جلسه
เซสชัน	نشست
เซสชัน	نشستهای
เซสชัน	جلسات
capo	کاپو
บัดดี้	رفیق
บัดดี้	بادی
เอะอะ	نق
itc	itc
panasonic	پاناسونیک
guideline	راهبرد
infraordo	infraordo
naka	ناکا
พาธ	راه
พาธ	مسیر
คอมมูน	کمون
nds	nds
gogo	گوگو
société	société
dia	dia
dia	دیا
adr	adr
globalsecurity	globalsecurity
kentucky	کنتاکی
imageright	imageright
ไฮไลต์	مشخص
ไฮไลต์	مشخص
ไฮไลต์	highlights
ลูกวัว	گوساله
raiders	مهاجمان
ซีรี่ส์	سری
longman	longman
ipc	ipc
mah	mah
mah	مه
aps	aps
แชต	گپ
แชต	گپی
capensis	capensis
österreich	österreich
quis	quis
cfm	cfm
contentcat	contentcat
cccc	cccc
fps	fps
kew	kew
cwa	cwa
joker	جوکر
fcc	fcc
เสริฟ	خدمت
เสริฟ	سرو
demospace	demospace
cpe	cpe
pog	pog
bash	bash
bash	بش
อืม	خب
อืม	خوب
hdmi	hdmi
mundo	موندو
titlebackground	titlebackground
เธน	تانه
sumatrana	sumatrana
staphylococcus	استافیلوکوک
แท่	تایی
แท่	تائی
tel	تل
tel	tel
ฟิค	انجیر
coco	کوکو
titleforeground	titleforeground
osama	اسامه
kinki	kinki
kinase	کیناز
อัลเฟร็ด	آلفرد
อัลเฟร็ด	الفرد
nec	nec
cdt	cdt
duomo	duomo
nvidia	انویدیا
isi	isi
ส่วนลด	تخفیف
ค่าสัมบูรณ์	مطلق
tung	تونگ
xvi	شانزدهم
hdl	hdl
foto	foto
arxiv	آرخیو
csv	csv
gin	گین
buttonlabel	buttonlabel
eco	اکو
nida	نایدا
liebe	liebe
เล้าโลม	عشقبازی
amor	amor
amor	آمور
fernández	فرناندز
bayern	بایرن
ผิวปาก	سوت
ผิวปาก	سوت
mis	mis
saab	ساب
vtr	vtr
amorphous	امورف
anhalt	آنهالت
immunoglobulin	پادتن
shortsummary	shortsummary
ati	جماعتی
ati	ati
gmbh	gmbh
แฮ่	هائه
psy	psy
intl	intl
ปฐมนิเทศ	جهت
africana	africana
tam	تم
amadeus	آمادئوس
โบกมือ	موج
โบกมือ	موجی
อัลลอฮฺ	خداوند
อัลลอฮฺ	خدا
อัลลอฮฺ	الهی
อัลลอฮฺ	خدایی
อัลลอฮฺ	الله
württemberg	وورتمبرگ
มอซ	moz
subsid	subsid
ไลค์	شبیه
ไลค์	لایک
ไลค์	مثل
ไลค์	like
ไลค์	مانند
domenico	دومنیکو
ชอล์ก	گچ
ไฟแนนซ์	مالی
เฝือก	گچ
เฝือก	بیندازید
ppi	ppi
berhad	برحد
colstyle	colstyle
moulin	مولن
mayo	مایو
proc	proc
dbt	dbt
dcc	dcc
nicholson	نیکلسون
bashkortostan	باشقیرستان
mov	mov
const	const
fallax	fallax
mpv	mpv
mee	mee
vga	vga
บล็อค	بلوک
บล็อค	بلاک
proud	مغرور
proud	سرافراز
proud	افتخار
proud	سربلند
tokamak	توکاماک
ppv	ppv
บาดทะยัก	کزاز
cfc	cfc
trend	ترند
trend	گرایش
trend	روند
outlook	outlook
ลูปัส	لوپوس
ชีก	شیخ
eis	eis
lounge	استراحتگاه
บลูเบิร์ด	بلوبرد
trna	trna
พิธีรีตอง	تشریفات
gaon	gaon
checkuser	checkuser
meshnumber	meshnumber
มโนธรรม	وجدان
cmu	cmu
palatinate	فالتس
เหน็บแนม	استهزاء
เหน็บแนม	ریشخند
เหน็บแนม	تمسخر
ร้อนๆ	گرم
ร้อนๆ	داغ
โรงนา	انبار
โรงนา	طویله
inset	inset
archiveurl	archiveurl
chrtitle	chrtitle
endtheme	endtheme
mgrtitle	mgrtitle
arius	هریرود
ecu	ecu
ขนลุก	چندش
bcd	bcd
แปรงสีฟัน	مسواک
แปรงสีฟัน	مسواک
nobelprize	nobelprize
แล็ป	آزمایشگاهی
แล็ป	لابراتوار
แล็ป	آزمایشگاه
แล็ป	آزمایشگاه
แล็ป	ازمایشگاه
som	ثم
suzumiya	سوزومیا
oxidase	اکسیداز
msds	msds
whitesmoke	whitesmoke
irq	irq
insight	اندیشیدن
insight	بصیرت
musashi	موساشی
ohv	ohv
formatdate	formatdate
gcc	gcc
ซักรีด	رختشویی
ซักรีด	رخت
ซักรีด	لباسشویی
pcall	pcall
tyson	تایسون
relegation	relegation
แฮก	هک
แฮก	hack
coo	coo
hug	بغل
เย็นๆ	سرما
เย็นๆ	سرد
เย็นๆ	سرماخوردگی
dante	دانته
colhead	colhead
jelly	ژله
cassini	کاسینی
slip	لغزش
och	اخ
ter	تر
npv	npv
คนสวน	باغبان
kawasaki	کاوازاکی
backgroundcolors	backgroundcolors
iep	iep
สต๊อก	موجودی
สต๊อก	سهام
pulp	پالپ
voivodeship	gmina
voivodeship	ویوودشیپ
sortkey	sortkey
งุนงง	گیجه
metallicity	فلزیگی
amg	amg
dab	dab
กระดก	قورت
นมผง	فرمول
srb	srb
nulla	nulla
sevilla	sevilla
subtemplate	subtemplate
nrc	nrc
wikibase	wikibase
isnotempty	isnotempty
swu	swu
aviator	aviator
philips	فیلیپس
gba	gba
พุดดิ้ง	پودینگ
utrecht	اوترخت
gainsboro	gainsboro
พาโล	پالو
ute	اوته
tsu	tsu
mango	انبه
mango	mango
milne	میلن
kato	کاتو
พิมเสน	نعناع
uncollapsed	uncollapsed
lightblue	lightblue
scopus	اسکوپوس
taxa	تاکسون
ordovician	اردویسین
puma	پوما
puma	یوزپلنگ
giotto	giotto
hatnote	hatnote
โป๊ป	پاپ
โป๊ป	پوپ
interscope	اینتراسکوپ
ลมกรด	گردباد
kappa	کاپا
voip	voip
rotterdam	روتردام
pargs	pargs
mein	mein
sono	sono
teatro	teatro
coauthors	coauthors
mild	خفیف
mild	ملایم
ppt	ppt
fern	فرن
fern	سرخس
ไบเบิ้ล	انجیل
annales	annales
spam	هرزنامه
spam	اسپم
lite	لایت
เทอร์โมมิเตอร์	دماسنج
honneur	honneur
schleswig	شلسویگ
hangman	جلاد
sis	آبجی
sis	سیس
hendrik	هندریک
rina	رینا
mdi	mdi
rta	rta
otc	otc
gts	gts
decca	دکا
fanny	فنی
fanny	فانی
electrophoresis	الکتروفورز
txt	txt
kabardino	کاباردینو
tdi	tdi
อ่างอาบน้ำ	حمام
phylogenetic	فیلوژنتیک
checktype	checktype
wwa	wwa
ssl	ssl
streptococcus	استرپتوکوک
atr	atr
mpc	mpc
เกบ	گیب
zingiberaceae	زنجبیلیان
abusefilter	abusefilter
burger	برگر
burger	همبرگر
cacatua	cacatua
arkive	arkive
จุกจิก	نق
ucl	ucl
molly	مولی
molly	مالی
ฮอง	هونگ
ฮอง	هوانگ
ฮอง	هانگ
ฮอง	هنگ
schloss	اشلوس
smf	smf
soa	soa
lindbergh	لیندبرگ
isis	مطلب
isis	isis
réunion	رئونیون
mistyrose	mistyrose
hist	هیست
bmi	bmi
umts	umts
contribs	contribs
ไฟแช็ก	سبکتر
ไฟแช็ก	روشنتر
ไฟแช็ก	فندک
รังแค	شوره
getz	گتز
bruxelles	بروکسل
województwo	województwo
แรนดัล	رندل
แรนดัล	راندال
moments	لحظاتی
moments	لحظات
poj	poj
ceeb	ceeb
แม็ท	مَت
hobby	سرگرمی
hobby	hobby
datavalue	datavalue
gaiden	گایدن
maison	maison
sar	sar
sar	سر
nbr	nbr
willd	willd
jojo	جوجو
plainlinks	plainlinks
mainz	ماینتس
csa	csa
accord	آکورد
accord	میل
ชักช้า	lag
เทท	تیت
thirteen	سیزده
thirteen	thirteen
mecha	مکا
บารอมิเตอร์	فشارسنج
vevent	vevent
chapelle	شاپل
leisure	فراغت
ferromagnetic	فرومغناطیسی
ผายลม	گوزو
ผายลม	گوز
ait	ایت
ait	آیت
münster	مونستر
île	ایل
alb	الب
ไลล์	لایل
ncc	ncc
bbs	bbs
geograph	geograph
beats	تپش
beats	میزنه
ronda	روندا
unforgiven	نابخشوده
tvn	tvn
pda	pda
pda	pda
aura	هاله
aura	آئورا
neue	نویه
rosso	روسو
eduardo	ادواردو
bing	بینگ
méxico	مکزیکو
iptv	iptv
mun	مان
msm	msm
chō	chō
shm	shm
fef	fef
flex	فلکس
atl	atl
ก้นกบ	دنبالچه
bba	bba
dagestan	داغستان
fta	fta
nacl	nacl
lozano	لوزانو
fes	fes
radeon	radeon
wiesbaden	ویسبادن
ria	ria
imd	imd
บางเบา	پر
บางเบา	پرهای
nin	نین
daum	daum
innsbruck	اینسبروک
weibo	ویبو
tottenham	تاتنهام
dora	دورا
mime	mime
peterson	پترسون
peterson	پیترسون
cong	کانگ
หนักๆ	سنگینی
หนักๆ	سنگین
std	std
wolfram	ولفرم
acta	آکتا
muller	مولر
escherichia	اشریشیا
archivedate	archivedate
unhcr	unhcr
generalized	تعمیم
qld	qld
cups	cups
cups	جامی
cups	قدح
dnp	dnp
pars	pars
pars	پارس
illu	illu
guerra	گوئرا
pong	پونگ
blink	چشمک
kanye	کانیه
sixteenth	شانزدهمین
sixteenth	sixteenth
magnet	مغناطیس
magnet	آهنربا
nrhp	nrhp
bild	bild
courbet	کوربه
gbp	gbp
dct	dct
dunk	دانک
bam	bam
bam	بم
rwd	rwd
acipenser	acipenser
igf	igf
nct	nct
มัลแวร์	بدافزار
ora	اورا
ucode	ucode
plosive	plosive
inst	inst
goto	گوتو
pax	پکس
gta	gta
nas	ناس
cod	cod
เคเบิ้ล	کابلی
เคเบิ้ล	کابل
เลขาฯ	دبیر
เลขาฯ	منشی
leben	leben
deutschland	deutschland
lisbon	لیسبون
ptsd	ptsd
haeckel	هکل
topographic	توپوگرافی
tbm	tbm
เมี้ยว	میو
livre	livre
zita	زیتا
ไซปัน	سایپان
jnn	jnn
fernandez	فرناندز
transcluded	transcluded
mir	میر
mir	mir
medien	medien
bismuth	بیسموت
droit	droit
mainichi	ماینیچی
overdrive	اوردرایو
ochotona	ochotona
dickson	دیکسون
ญาติๆ	نزدیکان
ญาติๆ	خویشان
ญาติๆ	خویشاوندان
toolserver	toolserver
köln	کلن
คูต	چنگر
jalan	jalan
nnn	nnn
hotspur	هاتسپر
zimmermann	زیمرمن
wikt	wikt
église	église
abovebelow	abovebelow
ชอปปิ้ง	shopping
ชอปปิ้ง	خرید
citrate	سیترات
superfamilia	superfamilia
miramax	میرامکس
noi	noi
ksa	ksa
siècle	siècle
เบย	بایه
cfa	cfa
república	república
crocodylus	گاندوها
ไมโล	میلو
ไมโล	مایلو
nucleotide	نوکلئوتید
ichigo	ایچیگو
ano	ano
vim	vim
moctezuma	موکتزومای
kirchner	کیرشنر
เปียนโน	piano
เปียนโน	پیانوی
เปียนโน	پیانو
utagawa	اوتاگاوا
collagen	کلاژن
prolog	prolog
ดอยช์	دویچه
sina	سینا
sina	sina
sac	سک
ferreira	فریرا
ดินเนอร์	شام
bvm	bvm
mazda	مزدا
ไกส์	اسکایپ
garman	گارمان
mimi	میمی
กิลเลส	گیلسپی
avatar	آواتار
somersault	پشتک
yaroslavl	یاروسلاول
omim	omim
ssc	ssc
fcb	fcb
accademia	accademia
powerpc	powerpc
ย่อมเยา	متناسب
dvořák	دورژاک
nosferatu	نوسفراتو
เลอะเทอะ	شلوغ
barincrement	barincrement
cta	cta
chapterurl	chapterurl
fai	fai
petite	پتیت
quint	کوینت
études	études
broker	دلال
broker	کارگزار
ดรอป	افت
ดรอป	قطره
electronegativity	الکترونگاتیوی
henrik	هنریک
การขนส่งมวลชน	گذر
การขนส่งมวลชน	عبور
การขนส่งมวลชน	عبوری
loc	loc
เมกะเฮิรตซ์	mhz
sixteen	sixteen
sixteen	شانزده
galerie	galerie
glutamate	گلوتامات
khabarovsk	خاباروفسک
nadph	nadph
tensor	تانسور
oro	اورو
นู่	نوح
heidelbergensis	هایدلبرگی
dns	dns
ttl	ttl
cristatus	cristatus
shonen	shonen
แชท	گپ
แชท	گپی
internazionale	internazionale
evenodd	evenodd
moo	moo
sma	sma
buryatia	بوریاتیا
เอเย่นต์	مامور
เอเย่นต์	کارگزار
เอเย่นต์	مأمور
espada	اسپادا
oed	oed
mississippian	mississippian
msu	msu
ตูส	stu
shockley	شاکلی
germplasm	germplasm
infraclassis	infraclassis
lemonchiffon	lemonchiffon
rechts	rechts
polydor	پالیدور
intermedia	intermedia
antineutrino	antineutrino
imc	imc
เปเป	پپه
เปเป	پرو
bodyguard	بادیگارد
nfc	nfc
samba	samba
samba	سامبا
velit	velit
minimal	کمترین
minimal	کمینه
csd	csd
eaba	eaba
czw	czw
viz	viz
csu	csu
mcv	mcv
จู้จี้	نق
casio	کاسیو
özil	اوزیل
subunit	زیرواحد
pur	پور
gaba	gaba
ช๊อค	شوکه
ช๊อค	شوک
yami	یامی
เตารีด	آهن
coturnix	coturnix
voc	voc
prefectural	prefectural
subphylum	زیرشاخه
เครป	کرپ
governorate	مهدیه
göttingen	گوتینگن
atk	atk
tjm	tjm
saya	سایا
หวานๆ	شیرین
upn	upn
micky	میکی
tyrosine	تیروزین
samguk	سامگوک
céline	سلین
theropoda	ددپایان
lexikon	lexikon
montréal	مونترآل
vue	vue
consequat	consequat
spica	اسپایسا
bara	bara
bara	بارا
vin	وین
gpp	gpp
humboldt	هومبولت
nike	نایک
nike	nike
เนธาน	نیتن
เนธาน	ناتان
abdulrahman	عبدالرحمن
abdulrahman	عبدالرحمان
iter	iter
paleocene	پالئوسن
nisi	nisi
enim	enim
blackberry	blackberry
โชคลาง	خرافاتی
โชคลาง	خرافات
tapirus	tapirus
oligocene	الیگوسن
bsc	bsc
commuter	مسافری
cbn	cbn
บังกะโล	بنگله
hrsg	hrsg
rip	ریپ
rip	پاره
rip	پارش
rip	شکافتن
rip	rip
alamos	آلاموس
smtp	smtp
diffusivity	diffusivity
pedersen	پدرسن
nadar	ندر
utd	utd
dag	dag
animenewsnetwork	animenewsnetwork
fila	فیلا
torr	torr
phasianidae	قرقاولان
pang	پانگ
pang	پنگ
ngn	ngn
motogp	motogp
palermo	پالرمو
เบลิซ	بلیز
vojvodina	وویوودینا
rdf	rdf
abbaye	abbaye
dukes	دوکس
mita	میتا
prc	prc
rondo	راندو
amr	عمرو
truss	خرپا
spielberg	اسپیلبرگ
เหยาะ	یائو
catedral	catedral
hannover	هانوفر
joanna	جوآنا
joanna	جوانا
iglesias	ایگلسیاس
uncredited	uncredited
augsburg	آوگسبورگ
historiography	تاریخنگاری
manutd	manutd
gmatch	gmatch
wmflabs	wmflabs
prec	prec
sdb	sdb
affricate	affricate
zaw	zaw
องคชาติ	آلت
hussain	حسین
tempor	tempor
cng	cng
nail	nail
nail	ناخن
nail	میخ
wimax	وایمکس
aes	aes
reina	رینا
kalmykia	قالموقستان
andersson	آندرشون
เพลีย	خسته
svensson	سونسن
ffb	ffb
tpp	tpp
poptime	poptime
barnstar	barnstar
apex	apex
เด็บ	دب
daw	داو
enwiki	enwiki
homme	homme
uzb	uzb
helgi	هلگی
catchment	catchment
ether	اتر
kwh	kwh
tdma	tdma
ramanujan	رامانوجان
bwr	bwr
parserfunctions	parserfunctions
tcm	tcm
adv	adv
asturias	آستوریاس
asc	asc
bund	bund
palacio	پالاسیو
rutaceae	سدابیان
pka	pka
eros	اروس
lgbt	lgbt
hkg	hkg
icann	icann
zanuck	زانوک
taxobox	taxobox
rihanna	ریانا
blitz	بلیتز
nur	nur
nur	نور
bouvier	بوویه
dictionnaire	dictionnaire
aniplex	انیپلکس
nsaids	nsaids
shoten	شوتن
oxidative	اکسیداتیو
situ	درجا
kendall	کندال
monodelphis	monodelphis
sylvia	سیلویا
esse	esse
ptg	ptg
wolfsburg	وولفسبورگ
mycobacterium	مایکوباکتریوم
omg	omg
agb	agb
scc	الشارجه
pitta	pitta
dolce	dolce
vachellia	واچلیا
ffi	ffi
highestsinglesranking	highestsinglesranking
peterborough	پیتربورو
civ	civ
mdd	mdd
barker	بارکر
thalberg	تالبرگ
vivo	vivo
buch	بوخ
truncatus	truncatus
careerprizemoney	careerprizemoney
opengl	opengl
doublesrecord	doublesrecord
currentnumber	currentnumber
consolidation	تحکیم
sixty	شصت
pskov	پسکوف
nzl	نزل
federalism	فدرالیسم
ซุปเปอร์มาร์เก็ต	سوپرمارکت
ซุปเปอร์มาร์เก็ต	سوپرمارکت
volvo	ولوو
disambig	disambig
deus	deus
piedmont	پیدمانت
clostridium	کلوستریدیوم
phineas	فینیاس
psk	psk
hpv	hpv
blainville	بلنویل
dylan	دیلان
dylan	دیلن
oldid	oldid
puy	پوی
battista	باتیستا
เปล่งปลั่ง	درخشیدن
เปล่งปลั่ง	درخشان
เปล่งปลั่ง	براق
เปล่งปลั่ง	درخشش
milo	میلو
milo	مایلو
hylobates	هیلوبات
สะอึก	سکسکه
nikon	نیکون
nikon	nikon
prk	prk
sana	sana
คอแห้ง	تشنه
atrium	دهلیز
nowiki	nowiki
ไพค์	پایک
gucci	گوچی
gerd	گرد
qam	qam
kari	kari
singlesrecord	singlesrecord
เดบิต	بدهی
gourmet	گورمه
momoiro	موموئیرو
chembox	chembox
หนึบ	چسبناک
หนึบ	چسبنده
humilis	humilis
cvd	cvd
pte	pte
nes	nes
plunkett	پلانکت
hydrocortisone	هیدروکورتیزون
ansi	ansi
soccerway	soccerway
wada	وادا
tts	tts
ragtime	رگتایم
prinz	پرینز
derm	derm
imo	imo
richelieu	ریشولیو
tenth	دهم
tenth	دهمین
naa	naa
roadster	رودستر
ymca	ymca
saku	ساکو
ssb	ssb
adj	adj
staffordshire	استافوردشر
khamis	خمیس
paix	په
primorsky	primorsky
helloworld	helloworld
getty	گتی
tunguska	تونگوسکا
hsdpa	hsdpa
สมิทธ์	اسمیت
ทำครัว	آشپزخانه
bmj	bmj
rtl	rtl
roundel	roundel
nativename	nativename
เบ็ท	بت
เบ็ท	بث
rosetta	روزتا
utm	utm
trump	ترامپ
othernames	othernames
pron	pron
nach	nach
mordovia	موردوویا
sungai	سونگای
bose	بوز
kunst	kunst
sivan	سیوان
plainlist	plainlist
cpn	cpn
eutheria	هوددان
bbb	bbb
highestdoublesranking	highestdoublesranking
tif	tif
hoa	hoa
ฟินช์	سهره
ฟินช์	فینچ
ฟินช์	فنچ
kuw	kuw
earn	کسب
adolph	آدولف
yama	یاما
yama	یما
navi	ناوی
hilton	هیلتون
swa	swa
becc	becc
wrc	دبلیوآرسی
regency	رگنسی
protease	پروتئاز
vos	vos
donau	دانوب
lago	lago
spyder	spyder
clubnumber	clubnumber
texture	بافت
kaval	کوال
suppressplaceholder	suppressplaceholder
sigurd	زیگفرید
piezoelectric	پیزوالکتریک
ota	ota
ota	اوتا
boomerang	بومرنگ
networth	networth
wikilinks	wikilinks
lfp	lfp
ksc	ksc
haliaeetus	haliaeetus
clr	clr
iguaçu	ایگواسو
eme	eme
fibrous	فیبری
โฮลท์	هالت
โฮลท์	هولت
uma	uma
tem	tem
ดุค	دیوک
ดุค	دوک
sfc	sfc
asm	asm
shueisha	شوئیشا
prx	prx
ces	ces
origyear	origyear
spiegel	اشپیگل
preprocess	preprocess
cheers	نوش
cheers	سلامتی
consectetur	consectetur
phosphatase	فسفاتاز
insignis	insignis
italicized	italicized
sergio	سرجیو
sergio	سرخیو
เฮ็ค	هک
cwc	cwc
faf	faf
chanel	شنل
chanel	شانل
niosh	niosh
australianopenresult	australianopenresult
oliveira	اولیویرا
jassim	جاسم
hermes	هرمس
bernhard	برنهارد
teres	teres
cbm	cbm
voluptate	voluptate
mappings	mappings
mus	mus
herrera	هررا
sven	اسون
sven	سون
listn	listn
อาลิ	علی
อาลิ	ali
kirov	کیروف
ใจแข็ง	سنگدل
ลอตเตอรี่	لاتاری
astrakhan	آستراخان
ipo	ipo
bbd	bbd
tms	tms
หือ	ها
ฟรอสท์	یخی
ฟรอสท์	فراست
func	func
lgpl	lgpl
เซจ	سیج
koala	کوالا
vlsi	vlsi
cml	cml
atsuko	آتسوکو
naver	naver
uwa	uwa
shiki	شیکی
forte	فورته
grape	انگور
wimbledonresult	wimbledonresult
usopenresult	usopenresult
vaginal	مهبل
vaginal	مهبلی
blum	بلام
photoshop	فتوشاپ
photoshop	فوتوشاپ
bartolomeo	بارتولومئو
gatsby	گتسبی
nutt	nutt
vit	vit
โฮลต์	هالت
โฮลต์	هولت
asn	asn
falciparum	فالسیپاروم
dsa	dsa
openoffice	openoffice
leno	لنو
antwerp	آنتورپ
tui	tui
dra	dra
sws	sws
prostaglandin	پروستاگلاندین
ว่างๆ	خالی
ว่างๆ	تهی
putra	پوترا
cassatt	کست
symphonic	سمفونیک
lse	lse
mentor	مرشد
ยกนิ้ว	حراجی
สเต็ก	استیک
nep	nep
selena	سلنا
pauling	پاولینگ
ses	ses
chemspiderid	chemspiderid
lundin	لوندین
boucher	بوشه
tyrol	landgemeinde
swartz	سوارتز
pam	پم
deadurl	deadurl
mof	mof
qaboos	قابوس
merci	merci
swat	ضربت
cns	cns
chokeslam	chokeslam
yokoyama	یوکویاما
psg	psg
frenchopenresult	frenchopenresult
biol	biol
แม็ต	مَت
aso	آسو
postcode	postcode
catalunya	کاتالونیا
chelyabinsk	چلیابینسک
imagecaption	imagecaption
tmp	tmp
pes	pes
rhineland	راینلاند
hsu	hsu
coating	دورانی
kcal	kcal
avi	آوی
mallorca	مایورکا
shima	شیما
dap	دپ
dap	dap
perugino	پروجینو
csf	csf
mariano	ماریانو
fsa	fsa
glee	گلی
concacaf	کونکاکاف
czechia	czechia
autosomal	اتوزوم
icc	icc
pwa	pwa
