lil	lil
michelle	michelle
บุคลิกลักษณะ	personalidad
บุคลิกลักษณะ	pagkatao
echo	echo
nmb	nmb
pcr	pcr
โพลล์	botohan
โพลล์	botohan
โพลล์	poll
โบลท์	bolt
credit	credit
ffe	ffe
nguyen	nguyen
ก๊อก	knock
ไฮไลท์	highlight
ไฮไลท์	highlights
ไฮไลท์	highlight
seo	seo
springer	springer
ovw	ovw
ฮิป	hip
ฮิป	balakang
เครื่องร่อน	glider
มันเทศ	yam
reuters	reuters
mansi	mansi
khanty	khanty
confederations	confederations
macau	macau
rey	rey
copper	tanso
mas	mas
faq	faq
แฮมเบอร์เกอร์	hamburger
ลีห์	leigh
sekai	sekai
เฮโรอีน	heroin
mrt	mrt
sting	sting
zhao	zhao
kpa	kpa
vols	vols
airplay	airplay
tar	tar
กะพริบ	kukurap
กะพริบ	blink
เอ็มม่า	emma
attitude	ugali
attitude	attitude
attitude	saloobin
โรงรถ	garahe
โรงรถ	garage
len	len
nest	pugad
layout	layout
gadget	gadget
ภวังค์	trance
มอร์ฟีน	morphine
เฟร็ด	fred
พูห์	pooh
ying	ying
โฟลเดอร์	folder
hai	hai
rockman	rockman
ffa	ffa
รื่นรมย์	kaaya
เท่ห์	astig
เท่ห์	cool
นุง	nung
ไขควง	birador
bon	bon
exo	exo
ยุ่น	jap
sqmi	sqmi
premium	premium
mst	mst
exe	exe
pagasa	pagasa
tsunami	tsunami
eest	eest
เดลาแวร์	delaware
ล้วนๆ	pulos
ล้วนๆ	panay
หนุ่มๆ	boys
arsenal	arsenal
xiv	xiv
triumph	pagtatagumpay
crest	crest
ฟีเจอร์	tampok
ฟีเจอร์	itampok
ฟอยล์	foil
infoboxes	infoboxes
เคอร์เนล	kernel
แอสไพริน	aspirin
adm	adm
cash	cash
คอนโทรล	kontrol
คอนโทรล	kontrolin
หดหู่	depression
หดหู่	depresyon
aboveclass	aboveclass
boo	boo
hoya	hoya
transformers	eksibisyon
สุขใจ	masaya
boku	boku
ซูม	zoom
ncbi	ncbi
thesis	thesis
เทต	tate
utf	utf
jang	jang
โคเคน	coke
โคเคน	cocaine
frozen	frozen
frozen	nagyeyelo
mammalia	mammalia
initiative	inisyatiba
plotarea	plotarea
เบ็ดเตล็ด	trivia
เบ็ดเตล็ด	misc
เบ็ดเตล็ด	miscellaneous
เบ็ดเตล็ด	kalokohan
npc	npc
sysop	sysop
xyz	xyz
ดาการ์	dakar
safari	safari
รังสีวิทยา	radiology
โนห์	noh
rai	rai
dateformat	dateformat
dino	dino
ชอล	chul
tattoo	tattoo
เคฟ	kev
gpcm	gpcm
ping	ping
melbourne	melbourne
nbn	nbn
undef	undef
vicepresident	vicepresident
อิสลามาบัด	islamabad
mia	mia
bride	bride
chuck	chuck
ไฝ	nunal
ไฝ	mole
ไฝ	moles
petit	petit
noaa	noaa
สลิป	slip
cruz	cruz
finale	finale
maya	maya
เบลค	blake
jstor	jstor
เน็ด	ned
ล็อบบี้	lobby
ซ้าบ	saab
aki	aki
palestine	palestine
kate	kate
fhm	fhm
pmc	pmc
อีเจียน	aegean
vita	vita
belowclass	belowclass
โพส	post
โพส	poste
โพส	pose
แฮ็ก	hack
แฮ็ก	hack
icao	icao
sap	dagta
sap	sap
dmy	dmy
einecs	einecs
บดขยี้	dinurog
บดขยี้	durog
textcolor	textcolor
licensor	licensor
หวงแหน	cherish
isp	isp
pframe	pframe
สปา	spa
สปา	spa
tbl	tbl
ลค	blake
chill	chill
cyp	cyp
origargs	origargs
pid	pid
duty	duty
duty	tungkulin
sphrases	sphrases
คอรัปชั่น	corrupt
คอรัปชั่น	kurakot
spd	spd
orbiter	orbiter
phylogeny	phylogeny
che	che
แพ็คเกจ	pack
แพ็คเกจ	plano
แพ็คเกจ	plan
แพ็คเกจ	magplano
แพ็คเกจ	pakete
แพ็คเกจ	package
autocollapse	autocollapse
บอยด์	boyd
shopping	romantica
วอลเล่ย์	volleyball
sans	sans
acm	acm
โซนาร์	sonar
ccff	ccff
ก้ำกึ่ง	borderline
gym	gym
ncaa	ncaa
ช่ำชอง	matatas
seventeen	seventeen
เซอร์ไพรส์	surprise
เซอร์ไพรส์	pagkagulat
เซอร์ไพรส์	sorpresa
rune	rune
ars	ars
อาเมน	amen
ฟลอเรส	flores
เท็ต	tate
ความเฉื่อย	inertia
ฮาร์ป	harp
memphis	memphis
ดิ๊ก	dick
ดิ๊ก	titi
แคลอรี่	calorie
univ	univ
พล็อต	balangkas
getparent	getparent
roca	roca
เป๊ะ	sakto
annie	annie
ucb	ucb
xtreme	xtreme
bella	bella
เมอร์ลิน	merlin
แชด	chad
มูส	mus
vpn	vpn
resistivity	resistivity
imagestyle	imagestyle
chelsea	chelsea
coin	barya
coin	coin
หอน	spear
ทรัม	trump
titan	titan
wet	basa
บาร์บูดา	barbuda
อัลฟ่า	alpha
ขนมอบ	baking
ขนมอบ	pastry
สดๆ	fresh
สดๆ	sariwa
subst	subst
ukr	ukr
mpa	mpa
prof	prof
หวีด	whistle
บรูก	bru
ลูค	luke
ลูค	lucas
สวมรอย	bogs
บาร์เลย์	barley
ปู่ย่า	gran
ppp	ppp
aut	aut
pete	pete
อาร์เรย์	array
อินเตอร์เน็ต	internet
nominator	nominator
อินเดียนา	indiana
namida	namida
แฮกเกอร์	hacker
nikki	nikki
benz	benz
scalemajor	scalemajor
nocat	nocat
adsl	adsl
hdtv	hdtv
termstart	termstart
burton	burton
ทอนซิล	tonsil
lcd	lcd
gakuen	gakuen
hay	hay
แอป	app
แอป	apps
cid	cid
นกหวีด	whistle
termend	termend
ต้นคอ	leeg
chrome	chrome
taoiseach	taoiseach
sim	sim
vec	vec
amp	amp
blason	blason
แลป	lab
ขี้เหร่	pangit
ขี้เหร่	panget
พรีเมียม	premium
aru	aru
เทด	ted
ชาร์ล็อตต์	charlotte
wikimania	wikimania
มีดโกน	razor
sophie	sophie
ลูกเห็บ	bati
ลูกเห็บ	hail
iro	iro
อุ้งเท้า	paw
ลิปสติก	lipstick
ronaldo	ronaldo
ergaster	ergaster
casa	casa
reptilia	reptilia
sos	sos
ฮวา	hwa
อายัด	frozen
อายัด	nagyeyelo
ssp	ssp
ซุซุ	zeus
มุทะลุ	reckless
สังเกตุ	pansinin
สังเกตุ	paunawa
eddy	eddy
visa	visa
อาร์กิวเมนต์	argumento
uhf	uhf
crush	crush
reg	reg
ซอฟแวร์	software
ocinsoutput	ocinsoutput
แฟนซี	magarang
lancer	lancer
mda	mda
mari	mari
อะเดล	adele
alignbars	alignbars
concepts	konsepto
skill	skill
skill	kasanayan
skill	kakayahan
sud	sud
โฮมเพจ	homepage
ลาเวนเดอร์	lavender
ฟีด	feed
ฟีด	feeds
บัซ	buzz
viva	viva
sql	sql
meshname	meshname
bodystyle	bodystyle
ตรรก	talino
ตรรก	lohikal
ตรรก	lohika
ตรรก	logic
อาร์ตี	artie
dao	dao
pascal	pascal
burke	burke
transcript	transcript
โลเวลล์	lowell
kitty	kitty
senbatsu	senbatsu
หลาบ	yard
เต๋	teh
มัสตาร์ด	mustard
hood	hood
autoconfirmed	autoconfirmed
หลงกล	niloko
หลงกล	pinaglalaruan
eur	eur
โปรไฟล์	profile
จาว	shao
ind	ind
linn	linn
clover	clover
cheese	keso
riaj	riaj
จู๊ด	hudas
จู๊ด	jude
wto	wto
perciformes	perciformes
moe	moe
เบลโล	bello
ing	ing
ctrl	ctrl
dota	dota
pac	pac
ชุล	chul
sortable	sortable
nums	nums
ufc	ufc
requiem	requiem
รปภ	security
รปภ	seguridad
elsevier	elsevier
emma	emma
หัวนม	suso
หัวนม	utong
mohd	mohd
plc	plc
raven	uwak
raven	raven
lorem	lorem
แล็ปท็อป	laptop
เบลก	blake
lucy	lucy
gnis	gnis
กานพลู	clove
dinosauria	dinosauria
โป๊กเกอร์	poker
nfl	nfl
dengeki	dengeki
lip	lip
moss	mos
moss	moss
moss	lumot
โฮล์มส์	holmes
ไมลส์	milya
civic	civic
leiden	leiden
naruto	naruto
carmen	carmen
ท็อปส์	tops
ท็อปส์	talbos
ตื้นๆ	mababaw
retval	retval
หนองใน	gonorrhea
ลินซ์	lynch
bce	bce
คีท	keith
dubai	dubai
ทรัมเปต	trumpeta
กระวนกระวาย	sabik
opentheme	opentheme
สวยๆ	ganda
สวยๆ	maganda
สวยๆ	pretty
sdtv	sdtv
ภาพยนต์	pelikula
ภาพยนต์	sine
ภาพยนต์	movie
ภาพยนต์	movies
cma	cma
mep	mep
spec	spec
asa	asa
rue	rue
ฉุบ	gunting
mou	mou
พุพอง	paltos
นํ้า	tubig
uprising	junta
slim	slim
curry	curry
scaleminor	scaleminor
stp	stp
rft	rft
det	det
orientalis	orientalis
corticosteroids	corticosteroids
loaddata	loaddata
osprey	osprey
merriam	merriam
รัดรูป	rudd
miocene	mioseno
slammy	slammy
luca	luca
ตาชั่ง	scales
familycolor	familycolor
evergreen	evergreen
ใคร่ครวญ	ipakita
titleclass	titleclass
mmorpg	mmorpg
nic	nic
ผสมเทียม	inseminasyon
ขวนขวาย	kumita
คังนัม	gangnam
rae	rae
tls	tls
mtc	mtc
wmf	wmf
idn	idn
bandai	bandai
ucla	ucla
เอทีเอ็ม	atm
แรนด์	rand
omniglot	omniglot
นมวัว	baka
ped	ped
sdn	sdn
pizza	pizza
rem	rem
cis	cis
nrt	nrt
cotton	bulak
cotton	cotton
bonsang	bonsang
cze	cze
ipod	ipod
emerg	emerg
ทำหมัน	isterilisasyon
ไซนัส	sinus
ไซนัส	gilagid
setmetatable	setmetatable
hokusai	hokusai
ole	ole
tobu	tobu
chennai	chennai
peng	peng
ดีซ่าน	paninilaw
comp	comp
บาร์บีคิว	barbecue
hcl	hcl
baba	baba
เทียนไข	kandila
hoc	hoc
โคไซน์	cosine
เก๊าท์	gout
บู้	boo
subfamilia	subfamilia
eos	eos
tidal	tidal
เพียซ	pierce
pdp	pdp
เมก	meg
shtml	shtml
sue	sue
terme	terme
als	als
cites	cites
emerald	emerald
bas	bas
percussion	instrumentong
แฮ็ค	hack
รีซ	reese
จอร์น	juan
จอร์น	john
plantae	plantae
lccn	lccn
oecd	oecd
subclassis	subclassis
disp	disp
sig	sig
ตูด	asno
ตูด	puwet
linecolor	linecolor
esrb	esrb
bodyslam	lmfao
irn	irn
วิสกี้	whisky
basestyle	basestyle
afp	afp
ฟอร์แมต	format
คิงสตัน	kingston
จิ๋ม	puki
ไดร์ฟ	magmaneho
ไดร์ฟ	drive
bacillus	bacillus
wifi	wifi
getcurrenttitle	getcurrenttitle
ambox	ambox
msv	msv
ipad	ipad
gmelin	gmelin
เบรค	preno
ดอท	tuldok
ดอท	dot
marksize	marksize
กลมๆ	round
กลมๆ	bilog
mcdonald	mcdonald
มัดจำ	deposito
มัดจำ	deposit
vhs	vhs
kde	kde
asst	asst
medlineplus	medlineplus
wikibooks	wikibooks
alternativemap	alternativemap
อีเมล์	email
ไนลอน	naylon
ทะลึ่ง	cheeky
lopez	lopez
gre	gre
ลินช์	lynch
กิกิ	kiki
sato	sato
datastyle	datastyle
apa	apa
forsskål	forsskål
gpa	gpa
lightsteelblue	lightsteelblue
อินเตอร์เฟส	interface
stardust	stardust
sao	sao
aol	aol
ลอเรล	laurel
factsheet	factsheet
hon	hon
rss	rss
แบส	bass
ฝักบัว	shower
ฝักบัว	paliguan
ฝักบัว	paliguan
ปาโล	palo
คลัสเตอร์	kumpol
คลัสเตอร์	cluster
คลัสเตอร์	clusters
nom	nom
wittgenstein	wittgenstein
nano	nano
casting	casting
iss	iss
bamboo	bamboo
bamboo	kawayan
nigra	nigra
miq	miq
gmail	gmail
cyworld	cyworld
ผ้าเช็ดหน้า	panyo
เมดเลย์	medley
ipcc	ipcc
nong	nong
geoffroy	geoffroy
เนด	ned
เหยือก	mug
เหยือก	pitsel
monobook	monobook
fips	fips
watt	watt
โปรโมชัน	promo
โปรโมชัน	promotion
โปรโมชัน	promosyon
psu	psu
editpage	editpage
habilis	habilis
eka	eka
dodge	dodge
eia	eia
citationclass	citationclass
อมยิ้ม	lollipop
yves	yves
ซ้า	saab
originalairdate	originalairdate
amet	amet
kin	kin
kyaw	kyaw
ras	ras
sprint	sprint
nyc	nyc
otome	otome
publicationdate	publicationdate
gee	gee
แพม	pam
จดจ่อ	nakatuon
จดจ่อ	nakatutok
australopithecus	australopithecus
vhf	vhf
evo	evo
shinee	shinee
ทรัมป์	trump
ich	ich
doki	doki
johan	johan
bust	bust
อรรถประโยชน์	utilidad
อรรถประโยชน์	utility
rsa	rsa
ฮิบ	hip
ฮิบ	balakang
metacritic	metacritic
โบรกเกอร์	broker
cms	cms
abcd	abcd
arp	arp
biz	biz
deutsch	deutsch
ฮโย	hyo
subpages	subpages
gotta	gotta
hotcat	hotcat
pga	pga
ไมก้า	micah
mont	mont
svk	svk
จัว	chua
ccccc	ccccc
เซสชัน	sesyon
เซสชัน	session
เซสชัน	sesyon
เซสชัน	session
เซสชัน	sessions
capo	capo
บัดดี้	pare
บัดดี้	buddy
guideline	alituntunin
infraordo	infraordo
kaon	kaon
naka	naka
พาธ	landas
พาธ	path
longus	longus
ดุลยพินิจ	diskresyon
cochrane	cochrane
คอมมูน	commune
nds	nds
gogo	gogo
société	société
dia	dia
adr	adr
globalsecurity	globalsecurity
kentucky	kentucky
imageright	imageright
ไฮไลต์	highlight
ไฮไลต์	highlight
ไฮไลต์	highlights
ลูกวัว	calf
raiders	raiders
ซีรี่ส์	serye
ซีรี่ส์	series
longman	longman
ipc	ipc
mah	mah
แชต	chat
capensis	capensis
quis	quis
cccc	cccc
kew	kew
pardus	pardus
chikara	chikara
joker	joker
fcc	fcc
เสริฟ	magsilbi
เสริฟ	paglingkuran
เสริฟ	serve
เสริฟ	maglingkod
ataxia	ataxia
demospace	demospace
pog	pog
อืม	well
อืม	mabuti
อืม	balon
mundo	mundo
titlebackground	titlebackground
staphylococcus	staphylococcus
แท่	tae
tel	tel
ฟิค	fig
delle	delle
gam	gam
coco	coco
palgrave	palgrave
titleforeground	titleforeground
osama	osama
japonica	japonica
kinase	kinase
อัลเฟร็ด	alfred
nec	nec
baeksang	baeksang
nbsp	nbsp
isi	isi
pubmed	pubmed
ส่วนลด	diskuwento
ส่วนลด	diskuwento
ค่าสัมบูรณ์	absolute
ค่าสัมบูรณ์	lubusang
tung	tung
xvi	xvi
arxiv	arxiv
gin	gin
parc	parc
eco	eco
kokoro	kokoro
université	université
nida	nida
liebe	liebe
amor	amor
tis	tis
fernández	fernández
bayern	bayern
ผิวปาก	whistle
mis	mis
ใสๆ	doe
saab	saab
anhalt	anhalt
shortsummary	shortsummary
ati	ati
แฮ่	hae
psy	psy
tnt	tnt
ปฐมนิเทศ	oryentasyon
ปฐมนิเทศ	orientation
tam	tam
amadeus	amadeus
ลงๆ	swings
โบกมือ	kumakaway
โบกมือ	alon
อัลลอฮฺ	god
อัลลอฮฺ	diyos
württemberg	württemberg
มอซ	moz
dcdcdc	dcdcdc
subsid	subsid
harpercollins	harpercollins
ไลค์	parang
ไลค์	like
ไลค์	gustuhin
domenico	domenico
ชอล์ก	chalk
เดนี	dani
ไฟแนนซ์	financing
ไฟแนนซ์	pananalapi
เฝือก	cast
colstyle	colstyle
moulin	moulin
mayo	mayo
dcc	dcc
nicholson	nicholson
jfk	jfk
bashkortostan	bashkortostan
ฟลุ๊ค	fluke
บล็อค	harangin
บล็อค	harang
บล็อค	block
บล็อค	hinarangan
proud	pinagmamalaki
proud	proud
proud	ipinagmamalaki
proud	maipagmamalaki
ssri	ssri
cfc	cfc
trend	uso
trend	trend
outlook	outlook
ลูปัส	lupus
ชีก	sheik
lounge	pahingahan
บลูเบิร์ด	bluebird
trna	trna
gaon	gaon
checkuser	checkuser
meshnumber	meshnumber
มโนธรรม	budhi
hominin	hominin
ร้อนๆ	hot
ร้อนๆ	mainit
เงินผ่อน	financing
hpa	hpa
โรงนา	kamalig
inset	inset
archiveurl	archiveurl
cena	cena
endtheme	endtheme
nadh	nadh
arius	arius
ecu	ecu
dev	dev
แล็ป	laboratory
แล็ป	laboratoryo
แล็ป	lab
som	som
saurischia	saurischia
suzumiya	suzumiya
oxidase	oxidase
msds	msds
irq	irq
lyn	lyn
musashi	musashi
formatdate	formatdate
gcc	gcc
ซักรีด	laba
pcall	pcall
tyson	tyson
sharpe	sharpe
แฮก	hack
coo	coo
reductase	reductase
hug	yakap
ราจ	raj
เย็นๆ	malamig
เย็นๆ	sipon
เย็นๆ	lamig
pst	pst
dante	dante
colhead	colhead
jelly	jelly
eigenmann	eigenmann
république	république
slip	slip
och	och
ter	ter
คนสวน	hardinero
kawasaki	kawasaki
backgroundcolors	backgroundcolors
สต๊อก	sapi
สต๊อก	stock
sfsr	sfsr
pulp	pulp
doubleday	doubleday
voivodeship	voivodeship
sortkey	sortkey
amg	amg
uni	uni
dab	dab
otoko	otoko
lac	lac
นมผง	formula
srb	srb
nulla	nulla
sevilla	sevilla
subtemplate	subtemplate
hatsukoi	hatsukoi
wikibase	wikibase
isnotempty	isnotempty
philips	philips
gba	gba
พุดดิ้ง	pudding
utrecht	utrecht
gainsboro	gainsboro
พาโล	palo
ute	ute
tsu	tsu
mango	mango
mango	mangga
milne	milne
kato	kato
theodor	theodor
uncollapsed	uncollapsed
rec	rec
lightblue	lightblue
scopus	scopus
taxa	taxa
hina	hina
megaman	megaman
ordovician	ordobisiyano
kiseki	kiseki
ติวเตอร์	tutor
puma	puma
syed	syed
giotto	giotto
hatnote	hatnote
โป๊ป	papa
interscope	interscope
kappa	kappa
voip	voip
rotterdam	rotterdam
pargs	pargs
mein	mein
sono	sono
coauthors	coauthors
mild	mild
mild	banayad
fern	pako
fern	fern
ไบเบิ้ล	biblia
ไบเบิ้ล	bibliya
ไบเบิ้ล	bible
annales	annales
spam	spam
lite	lite
cervus	cervus
schleswig	schleswig
coord	coord
sis	sis
hendrik	hendrik
carpi	carpi
rina	rina
seishun	seishun
rta	rta
otc	otc
decca	decca
fanny	fanny
sartre	sartre
txt	txt
kabardino	kabardino
อ่างอาบน้ำ	paliguan
อ่างอาบน้ำ	naliligo
checktype	checktype
ssl	ssl
streptococcus	streptococcus
atr	atr
mpc	mpc
เกบ	gabe
dst	dst
tachi	tachi
tenshi	tenshi
burger	burger
cacatua	cacatua
anaerobic	anaerobic
จุกจิก	nagging
แท็ป	tap
คาร์ลอ	carl
archaeopteryx	archaeopteryx
molly	molly
ฮอง	hong
valentin	valentin
lindbergh	lindbergh
isis	isis
bigbang	bigbang
jacq	jacq
bmi	bmi
ไฟแช็ก	lighter
wikiquote	wikiquote
รังแค	balakubak
bruxelles	bruxelles
แรนดัล	randall
moments	moments
moments	sandali
edda	edda
แม็ท	matt
hobby	hobby
hobby	hilig
hobby	libangan
datavalue	datavalue
gaiden	gaiden
maison	maison
deutschen	deutschen
willd	willd
jojo	jojo
plainlinks	plainlinks
mainz	mainz
csa	csa
accord	accord
เคอร์ฟิว	curfew
funimation	funimation
ชักช้า	lag
เทท	tate
thirteen	labintatlong
mecha	mecha
บารอมิเตอร์	barometro
vevent	vevent
leisure	leisure
ผายลม	utot
münster	münster
île	île
alb	alb
ไลล์	lyle
ชุย	chui
ncc	ncc
beats	beats
beats	pusong
ronda	ronda
pda	pda
aura	aura
pliocene	plioseno
rosso	rosso
eduardo	eduardo
bing	bing
méxico	méxico
iptv	iptv
mun	mun
msm	msm
atl	atl
dagestan	dagestan
nacl	nacl
olav	olav
sto	sto
skyblue	skyblue
shoujo	shoujo
lozano	lozano
deutsches	deutsches
centro	centro
wiesbaden	wiesbaden
ria	ria
บางเบา	feathers
srt	srt
nin	nin
daum	daum
pubchem	pubchem
innsbruck	innsbruck
weibo	weibo
tev	tev
dora	dora
อ๊ะ	oops
อ๊ะ	naku
mime	mime
peterson	peterson
cong	cong
หนักๆ	mabigat
geneon	geneon
kao	kao
std	std
wolfram	wolfram
acta	acta
muller	muller
escherichia	escherichia
imax	imax
bung	bung
archivedate	archivedate
kerry	kerry
unhcr	unhcr
cups	tasa
pars	pars
guerra	guerra
msnbc	msnbc
pong	pong
tve	tve
blink	kukurap
blink	blink
kanye	kanye
liner	liner
iarc	iarc
magnet	magnet
magnet	magneto
nrhp	nrhp
gbp	gbp
suru	suru
อุ๊ย	oops
อุ๊ย	naku
dunk	dunk
bam	bam
exodus	exodo
nen	nen
shounen	shounen
lettres	lettres
igf	igf
มัลแวร์	malware
plosive	plosive
goto	goto
อัพเดท	updated
pax	pax
gta	gta
nas	nas
ups	ups
บอกใบ้	pahiwatig
cod	cod
เคเบิ้ล	cable
เลขาฯ	sekretarya
เลขาฯ	kalihim
deutschland	deutschland
lisbon	lisboa
tpe	tpe
haeckel	haeckel
topographic	topographic
minna	minna
transliteration	transliteration
zoids	zoids
livre	livre
zita	zita
ไซปัน	saipan
gesellschaft	gesellschaft
cdu	cdu
fernandez	fernandez
transcluded	transcluded
mir	mir
girard	girard
korn	korn
mainichi	mainichi
overdrive	overdrive
michele	michele
ตอแหล	kalokohan
taxoboxes	taxoboxes
nok	kalinangang
ญาติๆ	relatives
ญาติๆ	kamaganak
salvelinus	salvelinus
jalan	jalan
nnn	nnn
abovebelow	abovebelow
ชอปปิ้ง	pamimili
ชอปปิ้ง	namimili
ชอปปิ้ง	shopping
citrate	citrate
superfamilia	superfamilia
bom	bom
กรีส	sebo
noi	noi
siècle	siècle
เบย	bae
cfa	cfa
jikan	jikan
ไมโล	milo
gangan	gangan
nucleotide	nucleotide
ichigo	ichigo
quantitative	quantitative
kirchner	kirchner
เปียนโน	piano
collagen	collagen
ดอยช์	deutsche
sina	sina
sac	apyak
pseudomonas	pseudomonas
unitary	unitary
ferreira	ferreira
ดินเนอร์	hapunan
michi	michi
mazda	mazda
ไกส์	skype
mimi	mimi
กิลเลส	gillespie
nenets	nenets
avatar	avatar
yaroslavl	yaroslavl
bokura	bokura
omim	omim
ssc	ssc
accademia	accademia
coe	coe
pennsylvanian	pennsylvanian
อุทาหรณ์	talinghaga
wikinews	wikinews
moderne	moderne
shinsengumi	shinsengumi
เลอะเทอะ	messy
เลอะเทอะ	kalat
เลอะเทอะ	magulo
เลอะเทอะ	gulo
barincrement	barincrement
botanic	botanic
taxon	taxon
cta	cta
chapterurl	chapterurl
ทัณฑ์บน	parole
fai	fai
petite	petite
romaji	romaji
études	études
broker	broker
continuum	continuum
adb	adb
ejective	ejective
ดรอป	drop
electronegativity	electronegativity
henrik	henrik
hoang	hoang
bafta	bafta
การขนส่งมวลชน	transit
loc	loc
angiosperms	angiosperms
เมกะเฮิรตซ์	mhz
sixteen	sixteen
galerie	galerie
glutamate	glutamate
khabarovsk	khabarovsk
oakland	oakland
nadph	nadph
tensor	tensor
emedicine	emedicine
oro	oro
นู่	nuh
heidelbergensis	heidelbergensis
ขาอ่อน	hita
dpr	dpr
แชท	chat
mcfarland	mcfarland
africanus	africanus
evenodd	evenodd
moo	moo
buryatia	buryatia
missingno	missingno
เอเย่นต์	ahente
เอเย่นต์	agent
oed	oed
mississippian	mississippian
shockley	shockley
infraclassis	infraclassis
lemonchiffon	lemonchiffon
outdoor	panlabas
polydor	polydor
influenzae	influenzae
sardinella	sardinella
antineutrino	antineutrino
เปเป	pepe
เปเป	peru
bodyguard	bodyguard
samba	samba
velit	velit
dreamworks	dreamworks
wikiversity	wikiversity
raion	raion
niloticus	niloticus
minimal	kaunti
minimal	minimal
ntsc	ntsc
sop	sop
csd	csd
eaba	eaba
viz	viz
csu	csu
mcv	mcv
จู้จี้	nagging
subunit	subunit
pur	pur
gaba	gaba
ช๊อค	shock
yami	lahing
เตารีด	bakal
เตารีด	iron
voc	voc
prefectural	kabiserang
subphylum	subphylum
göttingen	göttingen
hohenzollern	hohenzollern
saya	saya
หวานๆ	sweet
หวานๆ	matamis
tyrosine	tyrosine
samguk	samguk
céline	céline
theropoda	theropoda
tuva	tuva
wikivoyage	wikivoyage
montréal	montréal
vue	vue
consequat	consequat
spica	spica
bara	bara
vin	vin
humboldt	humboldt
nike	nike
เนธาน	nathan
cava	cava
paleocene	paleocene
ops	op
ops	ops
nisi	nisi
degeneres	degeneres
enim	enim
blackberry	blackberry
marius	marius
oligocene	oligoseno
bsc	bsc
commuter	commuter
cbn	cbn
mps	mps
ซื่อๆ	naive
rip	rip
alamos	alamos
sus	sus
diffusivity	diffusivity
muda	muda
dag	dag
nsdap	nsdap
torr	torr
phasianidae	phasianidae
nicky	nicky
palermo	palermo
เบลิซ	belize
vojvodina	vojvodina
rdf	rdf
dukes	dukes
mita	mita
prc	prc
parque	parque
rondo	rondo
amr	amr
sachsen	sachsen
spielberg	spielberg
เหยาะ	yao
zaft	zaft
catedral	catedral
hannover	hannover
joanna	joanna
iglesias	iglesias
augsburg	augsburg
historiography	historyograpiya
kyi	kyi
gmatch	gmatch
wmflabs	wmflabs
prec	prec
primetime	primetime
affricate	affricate
อาร์ตี้	artie
องคชาติ	titi
nsw	nsw
hussain	hussain
tempor	tempor
neanderthalensis	neanderthalensis
acs	acs
nail	nail
nail	kuko
duis	duis
zum	zum
reina	reina
afi	afi
kalmykia	kalmykia
andersson	andersson
เพลีย	pagod
เพลีย	napagod
emporis	emporis
tpp	tpp
barnstar	barnstar
apex	apex
daw	daw
enwiki	enwiki
homme	homme
léopold	léopold
toho	toho
adp	adp
borderline	borderline
uzb	uzb
catchment	imbakang
ether	ether
ramanujan	ramanujan
parserfunctions	parserfunctions
adv	adv
กยู	gyu
กยู	kyu
asturias	asturias
gadgets	gadgets
gadgets	gadget
bund	bund
eros	eros
lgbt	lgbt
hkg	hkg
taxobox	taxobox
rihanna	rihanna
blitz	blitz
nur	nur
nazionale	nazionale
dictionnaire	dictionnaire
aniplex	aniplex
nsaids	nsaids
substantia	substantia
shoten	shoten
situ	situ
dprk	dprk
kendall	kendall
castelnau	castelnau
thành	thành
sylvia	sylvia
esse	esse
หลานๆ	apo
mycobacterium	mycobacterium
xix	xix
agb	agb
quân	quân
dolce	dolce
antiquark	antiquark
highestsinglesranking	highestsinglesranking
gbr	gbr
civ	civ
barker	barker
vivo	vivo
buch	buch
careerprizemoney	careerprizemoney
bibcode	bibcode
doublesrecord	doublesrecord
mtb	mtb
consolidation	pagpapatatag
pskov	pskov
nzl	nzl
politique	politique
ซุปเปอร์มาร์เก็ต	supermarket
disambig	disambig
deus	deus
piedmont	piemonte
piedmont	piedmont
clostridium	clostridium
phineas	phineas
hpv	hpv
blainville	blainville
ทิงเจอร์	tintura
dylan	dylan
oldid	oldid
pgm	pgm
puy	puy
battista	battista
เปล่งปลั่ง	kumikinang
leonhard	leonhard
milo	milo
hylobates	hylobates
transcriptase	transcriptase
เฮ้	oy
prk	prk
คอแห้ง	uhaw
atrium	atrium
nowiki	nowiki
shita	shita
freenode	freenode
gerd	gerd
kari	kari
singlesrecord	singlesrecord
naoh	naoh
gourmet	gourmet
momoiro	momoiro
chembox	chembox
หนึบ	sticky
humilis	humilis
snak	snak
pte	pte
nes	nes
wada	wada
akai	akai
ragtime	ragtime
kawaii	kawaii
mola	mola
derm	derm
snes	snes
imo	imo
richelieu	richelieu
tenth	tenth
naa	naa
saku	saku
copyleft	copyleft
adj	adj
staffordshire	staffordshire
xinhua	xinhua
primorsky	primorsky
vesicle	vesicle
สมิทธ์	smith
rolfe	rolfe
dake	dake
ทำครัว	kusina
sfr	sfr
rtl	rtl
vir	vir
nativename	nativename
เบ็ท	beth
trump	trump
othernames	othernames
pron	pron
nach	nach
mordovia	mordovia
syr	syr
columnwidth	columnwidth
pteropus	pteropus
bose	bose
kunst	kunst
yonekura	yonekura
plainlist	plainlist
usher	usher
rté	rté
bbb	bbb
highestdoublesranking	highestdoublesranking
hoa	hoa
ฟินช์	finch
kuw	kuw
earn	kumita
kuni	kuni
adolph	adolph
yama	yama
kotoba	kotoba
hilton	hilton
abdel	abdel
swa	swa
ไฟร์เบิร์ด	firebird
protease	protease
vos	vos
lago	lago
lycée	lycée
naing	naing
texture	yari
suppressplaceholder	suppressplaceholder
scn	scn
ota	ota
boomerang	boomerang
stephan	stephan
networth	networth
desu	desu
wikilinks	wikilinks
shōjo	shōjo
aldansky	aldansky
jeju	jeju
tripitaka	tripitaka
epac	epac
โฮลท์	holt
uma	uma
ดุค	duke
malayan	malayan
onsen	onsen
tres	tres
shueisha	shueisha
ces	ces
origyear	origyear
spiegel	spiegel
preprocess	preprocess
cheers	mabuhay
fen	fen
insignis	insignis
nld	nld
italicized	italicized
sergio	sergio
markus	markus
triomphe	triomphe
faf	faf
chanel	chanel
australianopenresult	australianopenresult
oliveira	oliveira
hermes	hermes
bernhard	bernhard
cbm	cbm
herrera	herrera
sven	sven
อาลิ	ali
kirov	kirov
ใจแข็ง	puso
ลอตเตอรี่	lottery
astrakhan	astrakhan
ipo	ipo
tms	tms
หือ	huh
บริกส์	briggs
ฟรอสท์	frost
func	func
เซจ	sage
koala	koala
vlsi	vlsi
atsuko	atsuko
naver	naver
shiki	shiki
forte	forte
ทะนุถนอม	cherish
dioguardi	dioguardi
wimbledonresult	wimbledonresult
docomo	docomo
usopenresult	usopenresult
vaginal	vaginal
bartolomeo	bartolomeo
nutt	nutt
vit	vit
โฮลต์	holt
leno	leno
antwerp	amberes
iis	iis
tui	tui
dra	dra
sws	sws
prostaglandin	prostaglandin
ว่างๆ	vacant
ontology	ontolohiya
mentor	mentor
gassen	gassen
สเต็ก	steak
selena	selena
pauling	pauling
ses	ses
chemspiderid	chemspiderid
tyrol	tyrol
swartz	swartz
pam	pam
deadurl	deadurl
khakassia	khakassia
merci	merci
swat	swat
yokoyama	yokoyama
lantis	lantis
