piaget	piaget
adsl	adsl
hdtv	hdtv
burton	burton
lcd	roundup
lcd	lcd
hay	heina
hay	hein
hay	hay
แอป	app
แอป	rakendus
แอป	rakendused
นกหวีด	vile
ต้นคอ	kaela
ต้นคอ	kael
chrome	kroomi
chrome	kroom
taoiseach	taoiseach
sim	sim
amp	amp
แลป	lab
แลป	labor
ขี้เหร่	kole
ขี้เหร่	inetu
พรีเมียม	preemia
พรีเมียม	premium
พรีเมียม	lisatasu
uri	uri
เทด	ted
ชาร์ล็อตต์	charlotte
sophie	sophie
ลูกเห็บ	rahe
อุ้งเท้า	käpad
อุ้งเท้า	käpp
อุ้งเท้า	käppa
ronaldo	ronaldo
casa	casa
sos	sos
ฮวา	hwa
อายัด	külmutatud
อายัด	külmunud
ซุซุ	zeusi
ซุซุ	zeus
cts	cts
มุทะลุ	hooletu
สังเกตุ	märka
สังเกตุ	teade
eddy	eddy
visa	viisa
ขนตา	ripsmed
ขนตา	ripsmete
ขนตา	ripsmed
ขนตา	ripsmed
อาร์กิวเมนต์	väited
อาร์กิวเมนต์	argumendid
crush	armumine
crush	purustada
reg	reg
ซอฟแวร์	tarkvara
แฟนซี	uhke
lancer	lancer
เงินปันผล	dividendid
mari	mari
อะเดล	adele
temminck	temminck
skill	oskused
skill	oskus
skill	oskuste
โฮมเพจ	kodulehekülg
มอเตอร์เวย์	kiirtee
ลาเวนเดอร์	lavendel
ฟีด	sööt
ฟีด	sööta
ฟีด	sööda
ฟีด	toidab
บัซ	buzz
viva	viva
sql	sql
ไปรษณียบัตร	postkaart
ตรรก	ratsionaalne
ตรรก	loogiline
ตรรก	loogika
passive	passiivne
อาร์ตี	artie
pascal	pascal
ขยะแขยง	vastik
burke	burke
วิป	vahustatud
โลเวลล์	lowell
kitty	kiisu
หลาบ	jardi
มัสตาร์ด	sinep
ดอกจิก	klubid
hood	hood
schott	schott
eur	eurot
eur	eur
โปรไฟล์	profiil
โปรไฟล์	profiili
โปรไฟล์	profiilid
จาว	shao
clover	ristik
cheese	juustu
cheese	juust
จู๊ด	jude
wto	wto
moe	moe
เบลโล	bello
ing	ing
ctrl	ctrl
pac	pac
ชุล	chul
requiem	reekviem
รปภ	turvalisus
รปภ	julgeolek
รปภ	turva
รปภ	julgeoleku
elsevier	elsevier
emma	emma
หัวนม	tissid
heuristic	heuristika
mohd	mohd
plc	plc
raven	ronk
raven	raven
แล็ปท็อป	sülearvutid
แล็ปท็อป	sülearvuti
แล็ปท็อป	laptop
เบลก	blake
lucy	lucy
โป๊กเกอร์	pokker
nfl	nfl
lip	huule
moss	moss
ปลอกคอ	krae
ปลอกคอ	võru
ปลอกคอ	ääred
โฮล์มส์	holmes
ไมลส์	miles
ไมลส์	miili
civic	civic
iec	iec
naruto	naruto
tlc	tlc
carmen	carmen
ตื้นๆ	madal
ตื้นๆ	madalad
หนองใน	gonorröa
ลอต	lott
ลินซ์	lynch
คีท	keith
dubai	dubai
ทรัมเปต	trompet
กระวนกระวาย	ärevil
เหิร	liftid
gis	gis
สวยๆ	kaunist
สวยๆ	ilus
สวยๆ	kaunid
สวยๆ	ilusad
สวยๆ	kaunis
สวยๆ	päris
sdtv	sdtv
ภาพยนต์	filmi
ภาพยนต์	film
ภาพยนต์	filmid
spec	spec
asa	asa
rue	rue
ฉุบ	käärid
mou	memorandumi
นํ้า	vett
นํ้า	vesi
uprising	hunta
slim	slim
curry	karri
exp	exp
corticosteroids	kortikosteroidide
zanthoxylum	zanthoxylum
luca	luca
ตาชั่ง	kaalud
evergreen	evergreen
ใคร่ครวญ	kajastada
ใคร่ครวญ	peegelda
nic	nic
rubiaceae	rubiaceae
ขวนขวาย	teeni
rae	rae
tls	tls
ucla	ucla
แรนด์	rand
นมวัว	lehm
จรจัด	hulgus
จรจัด	kodutu
จรจัด	kodutud
pizza	pitsat
pizza	pitsa
pizza	pizza
rem	rem
เซรามิค	keraamilised
เซรามิค	keraamika
เซรามิค	keraamika
cis	cis
flop	flop
cotton	puuvill
ipod	ipod
ไซนัส	siinuse
ips	ips
ole	ole
chennai	chennai
peng	peng
solaris	solaris
สุขารมณ์	hedonism
comp	comp
บาร์บีคิว	grill
hcl	hcl
baba	baba
ems	ems
เทียนไข	küünal
hoc	hoc
โคไซน์	koosinus
เก๊าท์	podagra
บู้	boo
tidal	loodete
เพียซ	pierce
เพียซ	pearce
pdp	pdp
เมก	meg
sue	sue
terme	terme
als	als
cites	citesi
emerald	smaragd
bas	bas
percussion	löök
รีซ	reese
จอร์น	john
ตะคริว	kramp
จำนอง	hüpoteek
oecd	oecd
sig	sig
ตูด	tagumik
ตูด	perse
ตูด	tagumik
racer	racer
พลั่ว	labidas
วิสกี้	viski
วิสกี้	viski
ฟอร์แมต	vorming
ฟอร์แมต	vormindus
ฟอร์แมต	formaat
คิงสตัน	kingston
ไดร์ฟ	sõida
bacillus	bacillus
wifi	wifi
msv	msv
ipad	ipad
สำลัก	kägistada
เบรค	pidurid
เบรค	pidur
เบรค	pidurid
ดอท	täpp
ดอท	dot
ดอท	täppi
กลมๆ	ümar
กลมๆ	ümmargused
กลมๆ	ümmargune
กลมๆ	voor
mcdonald	mcdonald
vhs	vhs
kde	kde
ลูกมือ	abistamine
อีเมล์	email
อีเมล์	meili
ไนลอน	nailon
lopez	lopez
ลินช์	lynch
กิกิ	kiki
sato	sato
apa	apa
kloster	kloster
gpa	gpa
sauvage	sauvage
อินเตอร์เฟส	liides
อินเตอร์เฟส	liidese
stardust	tähetolm
sao	sao
ลอเรล	laurel
ยาสลบ	narkoosi
ก๊าด	petrooleumi
rss	rss
aec	aec
แบส	bass
ฝักบัว	dušš
ปาโล	palo
คลัสเตอร์	klaster
คลัสเตอร์	klastrite
nom	nom
แมป	kaardistatud
avec	avec
อีสุกอีใส	rõuged
nano	nano
bamboo	bambus
gmail	gmail
ipcc	ipcc
geoffroy	geoffroy
เนด	ned
เหยือก	kruus
เหยือก	kann
เหยือก	kannu
watt	watt
โปรโมชัน	promo
โปรโมชัน	edendamine
dodge	dodge
yves	yves
ซ้า	saab
ras	ras
อุ้งมือ	käpad
sprint	sprint
nyc	nyc
แพม	pam
จดจ่อ	keskendunud
vhf	vhf
evo	evo
ทรัมป์	trump
ich	ich
johan	johan
คีบ	tangid
bust	büst
อรรถประโยชน์	kasulikkuse
rsa	rsa
ฮิบ	hip
ฮิบ	puus
ฮิบ	puusa
cms	cms
arp	arp
biz	biz
dude	kutt
dude	dude
deutsch	deutsch
ฮโย	hyo
ต้อหิน	glaukoomi
หี	vitt
ไมก้า	micah
mont	mont
เซสชัน	seanss
เซสชัน	seansi
เซสชัน	istungid
capo	capo
บัดดี้	buddy
antagonists	antagonistide
clays	savid
panasonic	panasonic
พาธ	asukoht
พาธ	rada
cochrane	cochrane
คอมมูน	kommuun
société	société
dia	dia
adr	adr
kentucky	kentucky
ไฮไลต์	rõhutatud
ไฮไลต์	esile
ไฮไลต์	esiletõstmine
ไฮไลต์	rõhutab
ลูกวัว	vasika
ซีรี่ส์	seeria
ipc	ipc
aps	aps
แชต	vestlus
österreich	österreich
cfm	cfm
fcc	fcc
เสริฟ	teeni
เสริฟ	teenida
ataxia	ataksia
bash	bash
อืม	noh
อืม	no
อืม	hästi
mundo	mundo
staphylococcus	staphylococcus
tel	tel
ฟิค	joonis
coco	coco
japonica	japonica
kinase	kinaasi
อัลเฟร็ด	alfred
nbsp	nbsp
ส่วนลด	soodustus
ค่าสัมบูรณ์	absoluutne
ค่าสัมบูรณ์	absoluutse
tung	tung
xvi	xvi
hdl	hdl
csv	csv
gin	gin
gin	džinn
วัตถุนิยม	materialistlik
วัตถุนิยม	materialismi
parc	parc
eco	eco
liebe	liebe
เล้าโลม	eelmäng
amor	amor
fernández	fernández
bayern	bayern
ผิวปาก	vile
ใสๆ	doe
saab	saab
amorphous	amorfne
anhalt	anhalt
immunoglobulin	immunoglobuliini
ati	ati
gmbh	gmbh
psy	psy
tnt	tnt
ปฐมนิเทศ	orientatsiooni
amadeus	amadeus
โบกมือ	laine
อัลลอฮฺ	jumal
württemberg	württemberg
ไลค์	nagu
ไลค์	meeldib
domenico	domenico
ชอล์ก	kriit
เดนี	dani
ไฟแนนซ์	finantseerimine
ไฟแนนซ์	rahastamine
ไฟแนนซ์	rahastada
ไฟแนนซ์	rahandus
เฝือก	valatud
ppi	ppi
moulin	moulin
mayo	majonees
proc	proc
เกรียม	söestunud
dcc	dcc
nicholson	nicholson
jfk	jfk
primer	krunt
mee	mee
scr	scr
บล็อค	plokk
บล็อค	bloki
บล็อค	blokk
บล็อค	block
บล็อค	blokeeritud
proud	uhke
proud	uhked
tokamak	tokamak
ssri	ssri
บาดทะยัก	teetanuse
cfc	cfc
trend	trend
trend	suundumus
outlook	väljavaade
outlook	väljavaated
ลูปัส	luupus
inflow	sissevoolu
inflow	sissevool
lounge	lounge
บลูเบิร์ด	sinilind
beau	beau
มโนธรรม	südametunnistus
ร้อนๆ	kuum
ร้อนๆ	kuumad
ร้อนๆ	hot
ร้อนๆ	palav
เงินผ่อน	finantseerimine
เงินผ่อน	rahastamine
hpa	hpa
โรงนา	küüni
cena	cena
arius	arius
ขนลุก	jube
dev	dev
แล็ป	laboratoorsed
แล็ป	laboratooriumi
แล็ป	labor
แล็ป	laboratoorium
แล็ป	lab
แล็ป	labor
som	som
oxidase	oksüdaasi
lyn	lyn
gcc	gcc
ซักรีด	pesu
tyson	tyson
sharpe	sharpe
coo	coo
reductase	reduktaasi
hug	kallistus
hug	kalli
ราจ	raj
เย็นๆ	külm
เย็นๆ	külmad
dante	dante
jelly	jelly
cassini	cassini
och	och
ter	ter
คนสวน	aednik
kawasaki	kawasaki
สต๊อก	varu
สต๊อก	varude
aspergillus	aspergillus
voivodeship	vojevoodkond
uni	uni
dab	dab
lac	lac
นมผง	valem
sevilla	sevilla
philips	philips
พาโล	palo
mango	mango
kato	kato
theodor	theodor
rec	rec
taxa	taksonite
แรงๆ	lööja
ttv	ttv
puma	puma
โป๊ป	paavst
โป๊ป	pope
ลมกรด	keeristorm
emp	emp
kappa	kappa
voip	voip
rotterdam	rotterdami
mein	mein
mild	kerged
mild	kerge
fern	fern
คาร์ไมเคิล	carmichael
ไบเบิ้ล	piibel
เทอร์โมมิเตอร์	termomeeter
schleswig	schleswig
sis	sis
sis	sisi
hendrik	hendrik
carpi	carpi
rina	rina
faa	faa
fanny	fanny
electrophoresis	elektroforees
sartre	sartre
txt	txt
เลินเล่อ	hooletuse
tdi	tdi
อ่างอาบน้ำ	vann
อ่างอาบน้ำ	vanni
อ่างอาบน้ำ	vann
ssl	ssl
streptococcus	streptococcus
atr	atr
mpc	mpc
เกบ	gabe
ถลอก	kraapida
burger	burger
anaerobic	anaeroobne
แท็ป	kraan
คาร์ลอ	carl
molly	molly
ฮอง	hong
valentin	valentin
schloss	schloss
soa	soa
lindbergh	lindbergh
isis	isis
réunion	réunioni
jacq	jacq
umts	umts
ไฟแช็ก	kergem
getz	getz
แรนดัล	randall
moments	hetki
moments	hetked
แม็ท	matt
แม็ท	matti
hobby	hobi
maison	maison
sar	sar
jojo	jojo
mainz	mainz
csa	csa
thirteen	kolmteist
chapelle	chapelle
leisure	vabaaja
ผายลม	peer
münster	münsteri
île	île
alb	alb
ไลล์	lyle
ncc	ncc
beats	lööb
aura	aura
rosso	rosso
eduardo	eduardo
bing	bing
flex	flex
dagestan	dagestan
fta	vabakaubandusleping
nacl	nacl
olav	olav
sto	sto
ams	ams
centro	centro
wiesbaden	wiesbaden
ria	ria
vitis	vitis
บางเบา	suled
srt	srt
tottenham	tottenham
dora	dora
อ๊ะ	ups
mime	mime
peterson	peterson
cong	cong
หนักๆ	rasked
หนักๆ	raske
acta	acta
kerry	kerry
unhcr	unhcr
guerra	guerra
kanye	kanye
magnet	magnet
bild	bild
gbp	gbp
อุ๊ย	ups
bam	bam
ง่อย	sant
exodus	väljaränne
fet	fet
acipenser	acipenser
igf	igf
มัลแวร์	pahavara
ora	ora
goto	goto
อัพเดท	uuendatud
อัพเดท	ajakohastatud
pax	pax
ups	ups
บอกใบ้	vihjed
บอกใบ้	vihjeid
cod	tursa
cod	tursk
เคเบิ้ล	kaabel
เลขาฯ	sekretär
leben	leben
deutschland	deutschland
lisbon	lissaboni
lisbon	lissabonis
minna	minna
livre	livre
zita	zita
cdu	cdu
fernandez	fernandez
mir	mir
girard	girard
bismuth	vismut
droit	droit
korn	korn
michele	michele
ตอแหล	jama
pou	pou
ญาติๆ	sugulased
köln	köln
ชอปปิ้ง	poodi
กรีส	rasv
เบย	bae
ไมโล	milo
nucleotide	nukleotiidi
vim	vim
quantitative	kvantitatiivne
quantitative	kvantitatiivsed
เปียนโน	klaver
collagen	kollageeni
ดอยช์	deutsche
slalom	slaalom
macbook	macbook
sac	sac
pseudomonas	pseudomonas
unitary	ühtse
unitary	ühtne
ferreira	ferreira
ดินเนอร์	õhtusöök
mazda	mazda
ไกส์	skype
mimi	mimi
กิลเลส	gillespie
nenets	neenetsi
avatar	avatar
coe	coe
ย่อมเยา	taskukohane
เลอะเทอะ	segadus
taxon	taksoni
fai	fai
quint	quint
fia	fia
ซิการ์	sigari
ดรอป	tilk
henrik	henrik
ouest	ouest
การขนส่งมวลชน	läbisõit
การขนส่งมวลชน	transiidi
การขนส่งมวลชน	transiit
loc	loc
bonn	bonni
เมกะเฮิรตซ์	mhz
sixteen	kuusteist
บังตา	pimestatud
glutamate	glutamaadi
oakland	oaklandi
oro	oro
กระเด้ง	põrge
dns	dns
นรีแพทย์	günekoloog
แชท	vestlus
moo	moo
buryatia	burjaatia
เอเย่นต์	agent
ตูส	stu
outdoor	välitingimustes
outdoor	õues
influenzae	influenzae
เปเป	pepe
เปเป	peruu
bodyguard	ihukaitsja
samba	samba
raion	rajoon
minimal	minimaalne
csu	csu
barron	barron
subunit	alaühiku
pur	pur
ช๊อค	šokk
เตารีด	raud
เตารีด	raua
coturnix	coturnix
governorate	kubernerkond
göttingen	göttingen
atk	atk
หวานๆ	magusa
หวานๆ	magus
หวานๆ	magusad
urs	urs
micky	micky
tyrosine	türosiini
céline	céline
tuva	tõva
mms	mms
cgmp	cgmp
vin	vin
humboldt	humboldti
nike	nike
เนธาน	nathan
iter	iter
cava	cava
ops	ops
blackberry	blackberry
โชคลาง	ebausk
marius	marius
bsc	bsc
mps	mps
นิกิ	niki
ซื่อๆ	naiivne
rip	rip
smtp	smtp
sus	sus
pedersen	pedersen
สำส่อน	lits
dag	dag
nsdap	nsdap
fila	fila
torr	torr
pang	pang
đức	đức
nicky	nicky
palermo	palermo
meryl	meryl
เบลิซ	belize
vojvodina	vojvodina
dukes	dukes
prc	hiina
parque	parque
rondo	rondo
sachsen	sachsen
spielberg	spielberg
เหยาะ	yao
villosa	villosa
hannover	hannover
joanna	joanna
iglesias	iglesias
augsburg	augsburgi
อาร์ตี้	artie
องคชาติ	peenis
hussain	hussain
acs	acs
nail	küünte
nail	nael
kalmykia	kalmõkkia
andersson	andersson
albin	albin
เพลีย	väsinud
svensson	svensson
daw	daw
bubba	bubba
helgi	helgi
ether	eeter
kwh	kwh
กยู	kyu
asturias	astuuria
vaillant	vaillant
gadgets	vidinaid
bund	bund
palacio	palacio
rutaceae	rutaceae
eros	eros
lgbt	lgbt
rihanna	rihanna
blitz	blitz
nur	nur
nsaids	mspva
oxidative	oksüdatiivse
kendall	kendall
stripe	triip
sylvia	sylvia
หลานๆ	lapselapsed
mycobacterium	mycobacterium
xix	xix
dolce	dolce
oto	oto
barker	barker
vivo	vivo
buch	buch
opengl	opengl
บลูเบอร์รี	mustikad
mtb	mtb
sixty	kuuskümmend
pskov	pihkva
federalism	föderalismi
volvo	volvo
piedmont	piemonte
clostridium	clostridium
psk	psk
hpv	hpv
ทิงเจอร์	tinktuur
dylan	dylan
puy	puy
battista	battista
เปล่งปลั่ง	helendav
เปล่งปลั่ง	helendavad
analogues	analoogid
milo	milo
pollutant	saasteaine
เฮ้	hei
nikon	nikon
คอแห้ง	janu
ไพค์	pike
gucci	gucci
gerd	gerd
kari	kari
pharm	pharm
gourmet	gourmet
หนึบ	kleepuv
humilis	humilis
cvd	cvd
hbv	hbv
uptown	äärelinnas
uptown	äärelinna
ansi	ansi
เคอร์เซอร์	kursor
เคอร์เซอร์	kursori
mola	mola
prinz	prinz
derm	derm
imo	imo
richelieu	richelieu
tenth	kümnes
ymca	ymca
saku	saku
ssb	ssb
paix	paix
getty	getty
สมิทธ์	smithi
สมิทธ์	smith
ทำครัว	köök
rtl	rtl
vir	vir
tnf	tnf
เบ็ท	beth
rosetta	rosetta
suomen	suomen
trump	trump
bose	bose
usher	usher
hoa	hoa
ฟินช์	finch
earn	teeni
adolph	adolph
yama	yama
navi	navi
hilton	hilton
abdel	abdel
analgesics	valuvaigistite
wrc	wrc
eer	eer
protease	proteaasi
vos	vos
donau	donau
lago	iago
texture	tekstuuri
piezoelectric	piesoelektrilised
boomerang	bumerang
stephan	stephan
jeju	jeju
โฮลท์	holt
mls	mls
uma	uma
ดุค	vürst
ดุค	duke
ดุค	hertsog
dod	kaitseministeerium
spiegel	spiegel
cheers	terviseks
phosphatase	fosfataasi
fen	fen
sergio	sergio
เฮ็ค	heck
markus	markus
triomphe	triomphe
chanel	chanel
oliveira	oliveira
hermes	hermes
bernhard	bernhard
mus	mus
herrera	herrera
sven	sven
อาลิ	ali
kirov	kirov
ลอตเตอรี่	loterii
ipo	ipo
หือ	huh
บริกส์	briggs
ฟรอสท์	frost
lgpl	lgpl
koala	koaala
vlsi	vlsi
forte	forte
ทะนุถนอม	kalliks
grape	viinamarja
vaginal	tupe
blum	blum
photoshop	photoshop
gatsby	gatsby
โฮลต์	holt
antwerp	antwerpeni
ว่างๆ	tühi
ว่างๆ	tühjad
ontology	ontoloogia
mentor	mentor
ses	ses
boucher	boucher
tyrol	tyrol
pam	pam
khakassia	hakassia
merci	merci
cns	kns
psg	psg
แม็ต	matt
แม็ต	matti
catalunya	catalunya
chelyabinsk	tšeljabinski
rhineland	rheinland
noël	noël
coating	katmine
kcal	kcal
avi	avi
mallorca	mallorca
shima	shima
nhl	nhl
csf	csf
bourgogne	bourgogne
icc	icc
เฝอ	virgil
aix	aix
mezzo	mezzo
โบนส์	kondid
โบนส์	luud
โบนส์	luude
ยูนิฟอร์ม	ühtlane
ยูนิฟอร์ม	ühtsed
ยูนิฟอร์ม	munder
metabolite	metaboliit
selassie	selassie
recherche	recherche
wav	wav
megan	megan
tay	tay
agonists	agonistide
icu	intensiivravi
miley	miley
gmp	gmp
คลอโรฟอร์ม	kloroformi
palmas	palmas
moa	moa
eba	eba
einer	einer
diaz	diaz
amine	amiin
himalayan	himaalaja
xviii	xviii
แอ๊ปเปิ้ล	õunad
hieronymus	hieronymus
เทพพยากรณ์	oraakel
acp	akv
presto	presto
ode	ood
reds	punased
regensburg	regensburg
msk	msk
xxi	xxi
maris	maris
ทรัมพ์	trump
shy	häbelik
clade	klaad
arista	arista
polymerization	polümerisatsioon
cmyk	cmyk
gerry	gerry
thuringia	tüüringi
ฉาวโฉ่	kurikuulus
ฉาวโฉ่	kurikuulus
ฉาวโฉ่	skandaalne
fab	fab
xxii	xxii
deutscher	deutscher
oca	oca
zeit	zeit
alstom	alstom
malthus	malthus
nsa	nsa
spf	spf
ludovic	ludovic
ramón	ramón
rufa	rufa
polaris	polaris
qasim	qasim
esc	esc
smp	smp
hmg	hmg
athlon	athlon
ยกยอ	meelita
cee	cee
prada	prada
artiodactyla	artiodactyla
hidalgo	hidalgo
abba	abba
pneumoniae	pneumoniae
xxv	xxv
cpa	cpa
สะเพร่า	hooletu
persson	persson
เซสชั่น	seanss
เซสชั่น	seansi
เซสชั่น	istungid
epidemiological	epidemioloogiline
girolamo	girolamo
pripyat	prõpjat
général	général
ubisoft	ubisoft
igg	igg
gareth	gareth
cnc	cnc
msc	msc
หนาๆ	paksud
หนาๆ	paks
magyar	magyar
zia	zia
cindy	cindy
phenol	fenool
ดรูว	joonistas
ดรูว	drew
benedetto	benedetto
nusa	nusa
nmda	nmda
อัลม่า	alma
krupp	krupp
ลอว์เรน	lauren
nhc	nhc
sergey	sergei
perrin	perrin
คาร์เนชั่น	nelgi
californica	californica
โชโช	cho
higgins	higgins
oao	oao
maj	maj
rostov	rostovi
kiki	kiki
lactobacillus	lactobacillus
amt	amt
mbe	mbe
tandem	tandem
miao	miao
เมโย	majonees
ถูกๆ	odavad
ถูกๆ	odav
ถูกๆ	odavalt
hydrolysis	hüdrolüüsi
fino	fino
ฟอลส์	kukub
ฟอลส์	falls
ฟอลส์	langeb
udmurtia	udmurtia
pavo	pavo
แรนดอล	randall
osce	osce
saarland	saarimaa
tampere	tampere
แอพพลิเคชัน	taotlus
แอพพลิเคชัน	rakendus
แอพพลิเคชัน	kohaldamine
fifteen	viisteist
sourceforge	sourceforge
ปิกนิก	piknik
brigitte	brigitte
kamel	kamel
dinh	dinh
fuck	fuck
zeitung	zeitung
angie	angie
minima	miinimumid
ผ้าดิบ	riie
dunlop	dunlop
methionine	metioniin
ชอล์ค	kriit
bernoulli	bernoulli
sheldon	sheldon
bahnhof	bahnhof
borg	borg
cité	cité
nox	nox
เริงร่า	väljendusrikas
เริงร่า	rõõmsameelne
autre	autre
martius	marcius
medica	medica
ไฮท์	kõrgused
beatrix	beatrix
krajina	krajina
tiff	tiff
mtu	mtu
ไพธอน	pythoni
regis	regis
ดุ๊ค	vürst
ดุ๊ค	duke
ดุ๊ค	hertsog
esprit	esprit
tyumen	tjumen
audi	audi
niche	nišš
planar	tasapinnalised
mrp	mrp
mura	mura
spinosa	spinosa
álvarez	álvarez
wetland	märgala
ker	ker
cav	cav
bayan	bajan
hydroxy	hüdroksü
powerpoint	powerpoint
fink	fink
sharma	sharma
tethys	tethys
อิตาลี่	itaalia
smolensk	smolenski
giro	giro
yuzhno	južno
jeune	jeune
มอร์ฟ	morph
pygmaeus	pygmaeus
glock	glock
mui	mui
gladys	gladys
compagnie	compagnie
อุกอาจ	ennekuulmatu
rubra	rubra
อัพเดต	uuenda
อัพเดต	update
อัพเดต	uuendus
อัพเดต	ajakohastamine
อัพเดต	uuendamine
trujillo	trujillo
isla	menorca
เกษียน	pensionile
oma	oma
feo	feo
voronezh	voroneži
ทักซิโด	smoking
ทักซิโด	smoking
nmt	nmt
ige	ige
uwe	uwe
ilo	ilo
skype	skype
pura	pura
priori	priori
nylon	nailon
xxvii	xxvii
ira	ira
vibrio	vibrio
clément	clément
openstreetmap	openstreetmap
rosaceae	rosaceae
hla	hla
rowe	rowe
kris	kris
hof	hof
virgo	neitsi
amphibia	amphibia
azur	azuri
cerro	cerro
andrzej	andrzej
ato	ato
thc	thc
président	président
eriksen	eriksen
almanac	almanahh
rainer	rainer
penza	penza
aeruginosa	aeruginosa
pci	pci
ooo	ooo
turku	turu
fip	fip
ugo	ugo
imap	imap
hybridization	hübridisatsioon
shawshank	shawshanki
eec	emü
bola	bola
สเปรดชีต	tabeli
pistoia	pistoia
fiesta	fiesta
คาโล	carlo
หยง	yong
paracetamol	paratsetamooli
kurgan	kurgan
butyl	butüül
krause	krause
ceramic	keraamilised
ceramic	keraamika
svc	svc
phases	etapid
ผ้าเช็ดตัว	rätik
นอกชาน	terrassi
tcl	tcl
oem	oem
amylase	amülaasi
hev	ehs
karabakh	karabahhi
cfu	cfu
tambov	tambov
riverside	riverside
zac	zac
zno	zno
quintet	kvintett
pau	pau
diy	diy
msi	msi
mila	mila
ferrer	ferrer
spectrometry	spektromeetria
piacenza	piacenza
อ้วก	okse
vologda	vologda
constantin	constantin
nucleoside	nukleosiidi
ruf	ruf
unité	unité
pessoa	pessoa
valery	valeri
scala	scala
คลัตช์	sidur
nyu	nyu
outlaws	lindpriid
xxiv	xxiv
nacht	nacht
remi	remi
berlioz	berlioz
rtp	rtp
brassica	brassica
omnibus	omnibus
ปันผล	dividendid
emacs	emacs
milena	milena
heine	heine
quartier	quartier
mcmillan	mcmillan
naoko	naoko
aoc	aoc
แคชเชียร์	kassapidaja
nsaid	mspva
borgo	borgo
kyiv	kyiv
lyle	lyle
fdp	fdp
václav	václav
inactivated	inaktiveeritud
tirol	tirol
heinemann	heinemann
nkvd	nkvd
eurostat	eurostat
nmr	nmr
hansa	hansa
iberia	iberia
atlantique	atlantique
uvb	uvb
ssd	ssd
nutcracker	pähklipureja
อินเดียนาโปลิส	indianapolis
staples	klambrid
lublin	lublin
burgenland	burgenland
thessaloniki	thessaloníki
tft	tft
sebastián	sebastián
monika	monika
bmp	bmp
elton	elton
kostroma	kostroma
transformer	trafo
ผ้าปูที่นอน	lehed
ผ้าปูที่นอน	linad
clio	clio
omni	omni
bem	bem
grease	rasv
oryol	orjol
bmx	bmx
vorpommern	vorpommern
lol	lol
jimi	jimi
ard	ard
saratov	saraatovis
polysaccharides	polüsahhariidide
esquire	esquire
underrated	alahinnatud
nlp	nlp
angelique	angelique
เบเบ	bae
glycosides	glükosiidid
hessen	hesseni
ใจแตก	rikutud
souza	souza
ctc	ctc
oder	oder
rusa	rusa
คอมเมนท์	kommentaarid
คอมเมนท์	märkused
andrey	andrei
sorrento	sorrento
lymphocyte	lümfotsüütide
yangtze	jangtse
mémoires	mémoires
ibiza	ibiza
saccharomyces	saccharomyces
astra	astra
shropshire	shropshire
hala	hala
département	département
monomer	monomeeri
kimberley	kimberley
hdr	hdr
cie	cie
mentions	mainib
mentions	mainitakse
เพ็ค	peck
เพ็ค	jupp
rds	rds
phenylalanine	fenüülalaniini
ฟีบี	phoebe
garin	garin
xdr	xdr
โค้ท	mantel
จอส	joss
ranunculaceae	ranunculaceae
penicillins	penitsilliinid
puebla	puebla
susanne	susanne
quay	kai
hyogo	hyogo
bálint	bálint
camino	camino
agro	agro
kemerovo	kemerovo
atf	atf
conf	conf
boc	boc
gian	gian
schmitt	schmitt
เนบ	nava
จอยส์	joyce
biota	elustiku
dansk	dansk
gustaf	gustaf
nicki	nicki
oka	oka
soares	soares
rodrigues	rodrigues
tetracycline	tetratsükliini
natal	natali
condenser	kondensaatori
capsicum	capsicum
wep	wep
posix	posix
verdi	verdi
proteus	proteus
thyristor	türistor
osmium	osmium
adc	adc
kabila	kabila
เศร้าๆ	kurb
munch	munch
icp	icp
marinus	marinus
ako	ako
kant	kant
kant	kanti
prato	prato
pygmalion	pygmalion
srpska	srpska
wlan	wlan
เพค	peck
เพค	jupp
บร็อค	brock
cultivar	kultivar
inno	inno
frauen	frauen
moor	raba
moor	rabas
adidas	adidas
juni	juni
พิคโคโล่	piccolo
pdc	pdc
nowak	nowak
roe	roe
tokai	tokai
forma	forma
artemisia	artemisia
monographs	monograafiaid
monza	monza
beef	vida
tempera	tempera
งามๆ	võrratu
งามๆ	imeilus
บ๋อย	kelner
บ๋อย	ettekandja
wmv	wmv
udf	udf
verso	verso
slc	slc
norsk	norsk
susie	susie
ece	emk
fsb	fsb
alyssa	alyssa
wiedemann	wiedemann
respublika	respublika
microsystems	microsystems
freelance	vabakutseline
โซลูชัน	lahendused
โซลูชัน	lahused
hyman	hyman
kristian	kristjan
kristian	kristian
rostrata	rostrata
pharrell	pharrell
โค๊ช	treener
chiral	kiraalne
beaulieu	beaulieu
metabolites	metaboliidid
metabolites	metaboliitide
แม๊กซ์	max
แม๊กซ์	maks
hernández	hernández
dias	dias
tymoshenko	tõmošenko
lapd	lapd
reichstag	reichstagi
bundestag	bundestag
languedoc	languedoc
opioid	opioidide
iwate	iwate
soy	soja
cassius	cassius
collette	collette
freie	freie
silvia	silvia
rac	rac
hoch	hoch
fernand	fernand
akademie	akademie
salmo	salmo
peña	peña
xxviii	xxviii
tommaso	tommaso
brew	brew
carte	carte
ulm	ulm
gnp	rkt
โฮล์ท	holt
tull	tulli
siebold	siebold
sforza	sforza
holographic	holograafiline
ทริบูน	tribune
yacoub	yacoub
sistema	sistema
selenium	seleeni
fcf	fcf
grotto	grott
authentic	autentne
hem	hem
gheorghe	gheorghe
ulaanbaatar	ulaanbaatar
duvall	duvall
reuter	reuter
grenoble	grenoble
goldfinger	goldfinger
schreiber	schreiber
pps	ostujõu
medina	medina
xxiii	xxiii
ankara	ankara
iggy	iggy
zvezda	zvezda
fuego	fuego
แหยง	yang
ecm	ecm
hawks	hawks
sys	sys
gtp	gtp
unsaturated	küllastumata
plasmid	plasmiid
urea	karbamiidi
urea	uurea
gaspar	gaspar
พาราไดส์	paradiisi
พาราไดส์	paradiis
monoclonal	monoklonaalsed
amc	amc
bibliographical	bibliograafilisi
silesia	sileesia
glucocorticoids	glükokortikoidide
albino	albiino
zedong	zedong
oldenburg	oldenburg
sens	sens
inflorescence	õisik
fer	fer
balkan	balkani
balkan	balkanil
mikkel	mikkel
บิงโก	bingo
jacek	jacek
ฮิสทีเรีย	hüsteeria
messerschmitt	messerschmitt
mayr	mayr
partido	partido
slime	lima
joplin	joplin
aldosterone	aldosterooni
bevan	bevan
phenyl	fenüül
lenz	lenz
penicillium	penicillium
candida	candida
juli	juli
marian	marian
gabriele	gabriele
yttrium	ütrium
aspartate	aspartaadi
wadsworth	wadsworth
roussillon	roussillon
günter	günter
lustre	läige
cfb	cfb
dsb	dsb
cytokines	tsütokiinide
endogenous	endogeense
ชารลส์	charles
pore	poori
siri	siri
dtm	dtm
mip	mip
orkney	orkney
schwarzenegger	schwarzenegger
magnetization	magneetumine
dma	dma
algarve	algarve
hdd	hdd
etienne	etienne
bale	bale
jena	jena
abbeville	abbeville
ภาคทัณฑ์	tingimisi
caron	caron
checksum	kontrollsumma
iva	iva
wittenberg	wittenberg
coetzee	coetzee
metallurgy	metallurgia
armani	armani
wipo	wipo
stalingrad	stalingradi
maher	maher
popper	popper
heterocyclic	heterotsüklilised
สมยอม	üksmeelne
woodstock	woodstock
vanadium	vanaadiumi
fsi	fsi
xxix	xxix
woogie	woogie
pio	pio
cac	cac
handmade	käsitöö
heme	heemi
cours	cours
lax	lax
maurizio	maurizio
secretion	sekretsiooni
georgi	georgi
fyodor	fjodor
serine	seriin
kuhn	kuhn
shrewsbury	shrewsbury
cytokine	tsütokiini
alu	alu
dhcp	dhcp
valladolid	valladolidi
sverige	sverige
mcp	mcp
modulator	modulaator
constructor	konstruktor
อุ๊บ	ups
basingstoke	basingstoke
คยู	kyu
ibanez	ibanez
eno	eno
fsm	mikroneesia
domus	domus
lippe	lippe
avro	avro
piaf	piaf
supa	supa
nuovo	nuovo
wim	wim
pertussis	läkaköha
bitcoin	bitcoin
ดิ๊ค	munn
ดิ๊ค	dick
ferenc	ferenc
vasily	vassili
durch	durch
พีรามิด	püramiid
aosta	aosta
cavalier	cavalier
bnp	bnp
คาร์ไลส์	carlisle
sorbonne	sorbonne
aspire	püüdlevad
hypertrophy	hüpertroofia
benzo	benso
embraer	embraer
อัลเบิร์	albert
lom	lom
rts	rts
tabasco	tabasco
provincia	provincia
lca	olelusringi
groß	groß
légion	légion
