นกหวีด	吹口哨
นกหวีด	口哨
นกหวีด	吹哨
นกหวีด	口哨
termend	termend
bie	bie
ต้นคอ	脖子
ต้นคอ	頸
ต้นคอ	頸部
chrome	chrome
sim	sim
amp	放大器
blason	blason
แลป	實驗室
ขี้เหร่	醜八怪
ขี้เหร่	醜
ขี้เหร่	醜陋
พรีเมียม	premium
พรีเมียม	溢價
พรีเมียม	保費
พรีเมียม	保險費
เทด	ted
ชาร์ล็อตต์	charlotte
wikimania	wikimania
มีดโกน	刮刀
มีดโกน	剃刀
sophie	sophie
ลูกเห็บ	冰雹
อุ้งเท้า	爪
ploceus	ploceus
ลิปสติก	唇膏
ลิปสติก	口紅
casa	casa
reptilia	reptilia
sos	sos
อายัด	冷凍
อายัด	凍結
อายัด	冰凍
ซุซุ	宙斯
cts	cts
dallwitz	dallwitz
มุทะลุ	魯莽
สังเกตุ	通知
แก้วหู	耳膜
pgp	pgp
eddy	eddy
visa	visa
visa	簽證
ขนตา	睫毛
ขนตา	眼睫毛
ขนตา	睫毛
ขนตา	眼睫毛
ขนตา	睫毛
อาร์กิวเมนต์	論證
อาร์กิวเมนต์	參數
อาร์กิวเมนต์	爭論
อาร์กิวเมนต์	論點
uhf	超高頻
crush	暗戀
reg	reg
ซอฟแวร์	軟體
ocinsoutput	ocinsoutput
แฟนซี	看中
mda	mda
iwgp	iwgp
เงินปันผล	紅利
เงินปันผล	股息
อะเดล	adele
alignbars	alignbars
concepts	概念
concepts	理念
temminck	temminck
skill	技藝
skill	技巧
skill	技能
โฮมเพจ	首頁
โลชั่น	乳液
ลาเวนเดอร์	淡紫色
ฟีด	動態
ฟีด	飼料
sql	sql
meshname	meshname
vtec	vtec
bodystyle	bodystyle
aggregatescore	aggregatescore
ไปรษณียบัตร	明信片
ตรรก	理性
ตรรก	邏輯
ตรรก	邏輯
lte	lte
passive	被動
passive	消極
อาร์ตี	artie
dao	道
pascal	pascal
ขยะแขยง	惡心
อาบแดด	日光浴
วิป	鞭打
โลเวลล์	lowell
kitty	kitty
หลาบ	碼
มัสตาร์ด	芥菜
มัสตาร์ด	芥末
ดอกจิก	俱樂部
ดอกจิก	梅花
hood	hood
autoconfirmed	autoconfirmed
น้ำมูก	鼻涕
schott	schott
eur	歐元
eur	eur
alam	alam
กุญแจมือ	手銬
จาว	邵
linn	linn
aaaaaa	aaaaaa
cheese	乳酪
cheese	乾酪
riaj	riaj
perciformes	perciformes
บูกิต	bukit
เบลโล	bello
turismo	turismo
ing	ing
ctrl	ctrl
dota	dota
pac	pac
sortable	sortable
nums	nums
ufc	ufc
emma	艾瑪
emma	emma
หัวนม	乳頭
หัวนม	乳頭
หัวนม	山雀
plc	plc
raven	烏鴉
lorem	lorem
แล็ปท็อป	筆記本
lucy	露西
lucy	lucy
กานพลู	丁香
dinosauria	dinosauria
โป๊กเกอร์	撲克牌
โป๊กเกอร์	撲克
nfl	nfl
lip	嘴唇
lip	lip
lip	唇
moss	moss
ปลอกคอ	領
ปลอกคอ	項圈
โฮล์มส์	福爾摩斯
ไมลส์	萬里
ไมลส์	miles
ไมลส์	英里
passeriformes	passeriformes
civic	公民
iec	iec
naruto	鳴門
tlc	tlc
carmen	carmen
partai	partai
lgn	lgn
ตื้นๆ	淺
ตื้นๆ	膚淺
retval	retval
หนองใน	淋病
mustela	mustela
henle	henle
bce	bce
คีท	keith
topscorer	topscorer
กระวนกระวาย	焦急
กระวนกระวาย	焦慮
เหิร	升降機
tao	濤
tao	陶
opentheme	opentheme
สวยๆ	漂亮
สวยๆ	美
สวยๆ	美女
สวยๆ	美麗
สวยๆ	漂亮
sdtv	sdtv
ภาพยนต์	電影
ภาพยนต์	影片
ภาพยนต์	電影
cma	cma
mep	mep
spec	規格
asa	asa
rue	rue
ฉุบ	剪刀
พุพอง	水泡
นํ้า	飲水
นํ้า	水
คราง	呻吟
psr	psr
slim	苗條
slim	瘦
curry	咖哩
scaleminor	scaleminor
templatedata	templatedata
rft	rft
cdtv	cdtv
exp	exp
corticosteroids	corticosteroids
loaddata	loaddata
osprey	鶚
directx	directx
merriam	merriam
miocene	miocene
ตาชั่ง	天平
ตาชั่ง	尺度
ตาชั่ง	秤
familycolor	familycolor
evergreen	常綠
ใคร่ครวญ	反映
titleclass	titleclass
mmorpg	mmorpg
ผสมเทียม	人工授精
ขวนขวาย	掙
ขวนขวาย	賺取
ขวนขวาย	賺
คังนัม	江南
rae	rae
tls	tls
mtc	mtc
wmf	wmf
encyclopaedia	百科全書
bandai	萬代
bandai	bandai
เอทีเอ็ม	atm
เอทีเอ็ม	atm
wta	wta
แรนด์	rand
omniglot	omniglot
ยางลบ	橡皮擦
ยางลบ	橡皮
topicid	topicid
นมวัว	牛
นมวัว	奶牛
นมวัว	母牛
terma	terma
เมนเฟรม	主機
จรจัด	無家可歸
pizza	披薩
pizza	比薩
เซรามิค	陶瓷
เซรามิค	陶瓷
nrt	nrt
bhd	bhd
cotton	棉花
cotton	棉
cotton	棉質
cze	cze
ipod	ipod
ทำหมัน	絕育
ไซนัส	鼻竇
ไซนัส	鼻竇
ไซนัส	竇
setmetatable	setmetatable
domesticpartner	domesticpartner
peng	彭
peng	鵬
solaris	solaris
ดีซ่าน	黃疸
บาร์บีคิว	燒烤
บาร์บีคิว	烤肉
บาร์บีคิว	燒烤
บาร์บีคิว	燒烤
baba	巴巴
ems	ems
sohc	sohc
เทียนไข	燭
เทียนไข	蠟燭
rafinesque	rafinesque
โคไซน์	餘弦
โคไซน์	余弦
เก๊าท์	痛風
บู้	boo
subfamilia	subfamilia
eos	eos
tidal	潮汐
เพียซ	pierce
pdp	pdp
shtml	shtml
sue	sue
sue	蘇
als	als
noot	noot
จอร์น	john
ตะคริว	抽筋
plantae	plantae
จำนอง	抵押
lccn	lccn
subclassis	subclassis
disp	disp
sig	sig
ตูด	屁股
ตูด	屁股
พลั่ว	鏟子
พลั่ว	鏟
พลั่ว	鏟子
linecolor	linecolor
esrb	esrb
nameh	nameh
วิสกี้	威士忌
วิสกี้	威士忌
benth	benth
basestyle	basestyle
afp	法新社
ฟอร์แมต	格式
ฟอร์แมต	形式
ฟอร์แมต	格式化
จิ๋ม	陰戶
ไดร์ฟ	開車
ไดร์ฟ	駕駛
lpg	lpg
bacillus	桿菌
wifi	wifi
getcurrenttitle	getcurrenttitle
ambox	ambox
msv	msv
ipad	ipad
afanasieff	afanasieff
สำลัก	噎
สำลัก	嗆
สำลัก	窒息
สำลัก	嗆
cmos	cmos
เบรค	煞車
เบรค	制動
เบรค	煞車
เบรค	制動
ดอท	點
marksize	marksize
กลมๆ	圓
กลมๆ	輪
nist	nist
มัดจำ	保證金
มัดจำ	存
มัดจำ	存款
มัดจำ	押金
trigramme	trigramme
vhs	vhs
kde	kde
medlineplus	medlineplus
wikibooks	wikibooks
ลูกมือ	協助
bkk	bkk
alternativemap	alternativemap
อีเมล์	電子郵件
อีเมล์	email
ไนลอน	尼龍
ทะลึ่ง	厚臉皮
ทะลึ่ง	厚顏無恥
gre	gre
goldblatt	goldblatt
sato	佐藤
datastyle	datastyle
ต้อกระจก	白內障
ifpi	ifpi
gpa	gpa
lightsteelblue	lightsteelblue
sauvage	sauvage
อินเตอร์เฟส	介面
sao	嘯
aol	aol
ลอเรล	月桂
ลอเรล	laurel
perrow	perrow
ยาสลบ	麻醉
ยาสลบ	麻醉劑
ก๊าด	煤油
rss	rss
coliseo	coliseo
aec	aec
แบส	低音
แบส	bass
ฝักบัว	洗澡
ฝักบัว	淋浴
ฝักบัว	陣雨
ฝักบัว	淋浴
คลัสเตอร์	集群
คลัสเตอร์	集群
tee	tee
nom	nom
kmc	kmc
อีสุกอีใส	水痘
อีสุกอีใส	痘
nano	納米
casting	鑄造
bamboo	竹
bamboo	竹子
miq	miq
gmail	gmail
webometrics	webometrics
cyworld	cyworld
ผ้าเช็ดหน้า	手帕
ผ้าเช็ดหน้า	手絹
ผ้าเช็ดหน้า	手帕
nong	農
มอลต์	麥芽
byp	byp
เหยือก	投手
เหยือก	壺
monobook	monobook
gprs	gprs
playmore	playmore
fips	fips
watt	瓦特
โปรโมชัน	促銷
โปรโมชัน	推廣
โปรโมชัน	促銷
โปรโมชัน	晉升
psu	psu
editpage	editpage
eka	eka
citationclass	citationclass
อมยิ้ม	棒棒糖
yves	yves
actualuse	actualuse
originalairdate	originalairdate
amet	amet
ras	ras
หกล้ม	絆倒
sprint	衝刺
publicationdate	publicationdate
mma	mma
panoramio	panoramio
แพม	潘
แพม	pam
evo	evo
shinee	shinee
ทรัมป์	trump
timeshift	timeshift
muell	muell
johan	johan
bust	胸圍
อรรถประโยชน์	水電費
อรรถประโยชน์	實用
อรรถประโยชน์	效用
อรรถประโยชน์	實用性
rsa	rsa
ฮิบ	hip
ฮิบ	臀
ฮิบ	臀部
ฮิบ	髖
metacritic	metacritic
โบรกเกอร์	經紀人
โบรกเกอร์	經紀
โบรกเกอร์	中介
โบรกเกอร์	經紀
cms	cms
abcd	abcd
arp	arp
biz	商務
biz	biz
dude	花花公子
ฮโย	孝
ต้อหิน	青光眼
subpages	subpages
หี	陰戶
hotcat	hotcat
mont	蒙特
mont	蒙
svk	svk
ccccc	ccccc
capo	capo
pantene	pantene
tko	tko
panasonic	panasonic
guideline	準則
odbc	odbc
infraordo	infraordo
kaon	kaon
พาธ	路徑
คอมมูน	公社
nds	nds
gogo	gogo
dia	dia
adr	adr
util	util
globalsecurity	globalsecurity
imageright	imageright
ไฮไลต์	突顯
ไฮไลต์	凸顯
ไฮไลต์	突顯
ลูกวัว	小腿
ลูกวัว	牛犢
ลูกวัว	犢
ลูกวัว	小牛
ซีรี่ส์	系列
mah	mah
aps	aps
แชต	聊
แชต	聊天
quis	quis
cfm	cfm
contentcat	contentcat
cccc	cccc
fps	fps
กรน	打鼾
pardus	pardus
joker	小丑
cambodge	cambodge
fcc	fcc
เสริฟ	服務
เสริฟ	發球
demospace	demospace
cpe	cpe
bash	bash
hdmi	hdmi
titlebackground	titlebackground
ถาก	放牧
แท่	泰
ฟิค	無花果
gam	gam
coco	可可
palgrave	palgrave
titleforeground	titleforeground
nec	nec
cdt	cdt
duomo	duomo
halign	halign
nvidia	nvidia
isi	isi
pubmed	pubmed
ส่วนลด	折扣
ส่วนลด	優惠
ส่วนลด	折扣
ค่าสัมบูรณ์	絕對
ค่าสัมบูรณ์	絕對值
tung	董
xvi	十六
hdl	hdl
arxiv	arxiv
csv	csv
buttonlabel	buttonlabel
parc	parc
liebe	liebe
เล้าโลม	前奏
amor	amor
bayern	bayern
ผิวปาก	吹口哨
ผิวปาก	口哨
ผิวปาก	吹哨
mis	mis
ใสๆ	doe
aeu	aeu
shortsummary	shortsummary
ati	ati
gmbh	gmbh
psy	psy
intl	intl
tnt	tnt
eso	eso
ปฐมนิเทศ	方向
ปฐมนิเทศ	定向
tam	譚
tam	潭
amadeus	amadeus
ลงๆ	鞦韆
โบกมือ	揮手
โบกมือ	浪潮
โบกมือ	波
โบกมือ	浪
โบกมือ	波浪
อัลลอฮฺ	神
lepus	lepus
dcdcdc	dcdcdc
subsid	subsid
ไลค์	讚
ไลค์	就像
ไลค์	像
ไลค์	喜歡
domenico	domenico
ชอล์ก	粉筆
เดนี	dani
ไฟแนนซ์	財務
เฝือก	石膏
เฝือก	投
เฝือก	演員
ppi	ppi
berhad	berhad
colstyle	colstyle
pledis	pledis
moulin	moulin
mayo	蛋黃醬
mayo	mayo
เกรียม	燒焦
uht	uht
dcc	dcc
primer	底漆
mov	mov
const	const
fallax	fallax
mpv	mpv
vga	vga
scr	scr
fcl	fcl
บล็อค	區塊
บล็อค	block
proud	自豪
proud	驕傲
slr	slr
ssri	ssri
บาดทะยัก	破傷風
trend	趨勢
trend	趨向
outlook	展望
ลูปัส	狼瘡
inflow	流入
eis	eis
lounge	休息室
trna	trna
พิธีรีตอง	手續
checkuser	checkuser
govaerts	govaerts
meshnumber	meshnumber
มโนธรรม	良知
มโนธรรม	良心
cmu	cmu
ร้อนๆ	熱
ร้อนๆ	燙
erminea	erminea
โรงนา	穀倉
archiveurl	archiveurl
cena	cena
chrtitle	chrtitle
endtheme	endtheme
nadh	nadh
mgrtitle	mgrtitle
bcd	bcd
แปรงสีฟัน	牙刷
nobelprize	nobelprize
dev	dev
แล็ป	實驗室
แล็ป	化驗室
แล็ป	實驗室
saurischia	saurischia
กักตุน	囤積
stm	stm
gagnep	gagnep
msds	msds
whitesmoke	whitesmoke
pod	豆莢
insight	洞察力
insight	洞察
musashi	musashi
ohv	ohv
formatdate	formatdate
yugra	yugra
wwwf	wwwf
ซักรีด	洗衣
ซักรีด	洗衣服
ซักรีด	洗衣店
pcall	pcall
coo	咕
coo	coo
reductase	還原酶
hug	擁抱
hug	抱抱
hug	抱
ราจ	raj
เย็นๆ	冷冷
เย็นๆ	寒冷
เย็นๆ	冷
pst	pst
colhead	colhead
jelly	果凍
slip	滑
คนสวน	園丁
kawasaki	川崎
backgroundcolors	backgroundcolors
สต๊อก	股票
สต๊อก	存貨
สต๊อก	庫存
sfsr	sfsr
aspergillus	曲霉
pulp	紙漿
voivodeship	省
fitzinger	fitzinger
sortkey	sortkey
งุนงง	發呆
metallicity	metallicity
amg	amg
uni	uni
dab	dab
quicktime	quicktime
liverpoolfc	liverpoolfc
นมผง	公式
นมผง	方程式
นมผง	配方
subtemplate	subtemplate
nrc	nrc
wikibase	wikibase
isnotempty	isnotempty
philips	philips
philips	飛利浦
gba	gba
พุดดิ้ง	布丁
tentaculata	tentaculata
gainsboro	gainsboro
tsu	津
mango	芒果
kato	加藤
lowii	lowii
theodor	theodor
uncollapsed	uncollapsed
kbps	kbps
lightblue	lightblue
แรงๆ	面糊
ttv	ttv
hina	hina
ติวเตอร์	家教
ติวเตอร์	導師
nilai	nilai
fnn	fnn
syed	syed
giotto	giotto
hatnote	hatnote
โป๊ป	教皇
โป๊ป	教宗
interscope	interscope
ลมกรด	旋風
emp	emp
ddd	ddd
kappa	kappa
voip	voip
rotterdam	鹿特丹
pargs	pargs
teatro	teatro
mild	輕度
mild	溫和
aqm	aqm
grus	grus
ppt	ppt
fern	蕨類
fern	fern
ไบเบิ้ล	聖經
lite	lite
เทอร์โมมิเตอร์	溫度計
cervus	cervus
coord	coord
futbolme	futbolme
sis	姐
sis	姐姐
sis	姊姊
hubbs	hubbs
rina	rina
rta	rta
otc	otc
gts	gts
txt	txt
เลินเล่อ	過失
เลินเล่อ	疏忽
kabardino	kabardino
tdi	tdi
artistid	artistid
อ่างอาบน้ำ	浴缸
อ่างอาบน้ำ	浴
อ่างอาบน้ำ	洗澡
checktype	checktype
wwa	wwa
ssl	ssl
streptococcus	鏈球菌
atr	atr
wmc	wmc
mpc	mpc
เกบ	gabe
abusefilter	abusefilter
burger	漢堡
cacatua	cacatua
anaerobic	厭氧
arkive	arkive
ucl	ucl
archaeopteryx	archaeopteryx
molly	茉莉
molly	molly
ฮอง	虹
ฮอง	洪
gimp	gimp
valentin	valentin
smf	smf
soa	soa
isis	isis
sillago	sillago
mistyrose	mistyrose
ncsoft	ncsoft
sampa	sampa
bigbang	bigbang
hist	hist
bmi	bmi
umts	umts
contribs	contribs
ไฟแช็ก	打火機
ไฟแช็ก	輕
wikiquote	wikiquote
รังแค	屑
แรนดัล	randall
moments	moments
moments	瞬間
moments	時刻
poj	poj
cribb	cribb
edda	edda
ceeb	ceeb
expedia	expedia
hobby	嗜好
hobby	愛好
datavalue	datavalue
sar	特區
nbr	nbr
deutschen	deutschen
willd	willd
plainlinks	plainlinks
เคอร์ฟิว	宵禁
funimation	funimation
บารอมิเตอร์	晴雨表
vevent	vevent
leisure	休閒
leisure	閒暇
ผายลม	屁
ait	ait
ncc	ncc
bbs	bbs
geograph	geograph
beats	節拍
ronda	ronda
unforgiven	unforgiven
tvn	tvn
pda	pda
aura	光環
iptv	iptv
mun	mun
shm	shm
fef	fef
flex	flex
flex	彈性
ambystoma	ambystoma
atl	atl
ก้นกบ	尾骨
ก้นกบ	尾椎
bpm	bpm
sto	sto
skyblue	skyblue
argonauta	argonauta
lgv	lgv
ngv	ngv
latreille	latreille
angiosperm	angiosperm
deutsches	deutsches
fes	fes
ams	ams
radeon	radeon
ria	ria
vitis	葡萄
บางเบา	羽毛
srt	srt
nin	nin
spreng	spreng
daum	daum
pubchem	pubchem
tottenham	tottenham
tev	tev
อ๊ะ	哎呀
mime	mime
firewire	firewire
peterson	peterson
cong	琮
หนักๆ	重
หนักๆ	重型
หนักๆ	沈重
geneon	geneon
std	性病
std	性病
wolfram	wolfram
imax	imax
archivedate	archivedate
kerry	kerry
generalized	廣義
qld	qld
cups	杯子
pars	pars
msnbc	msnbc
pong	邦
blink	眨
blink	閃爍
blink	眨眼
kanye	kanye
magnet	磁鐵
toon	卡通
nrhp	nrhp
dct	dct
suru	suru
cooh	cooh
อุ๊ย	哎呀
dunk	灌籃
ง่อย	瘸子
ง่อย	殘廢
rvr	rvr
pocock	pocock
fet	fet
rwd	rwd
lettres	lettres
acipenser	acipenser
ora	ora
ucode	ucode
plosive	plosive
inst	inst
goto	goto
อัพเดท	更新
pax	pax
pax	大同
gta	gta
nas	nas
ups	ups
บอกใบ้	暗示
cod	鱈魚
เคเบิ้ล	有線
เคเบิ้ล	纜繩
เคเบิ้ล	電纜
เลขาฯ	秘書
craib	craib
leben	leben
lisbon	里斯本
lisbon	lisbon
tpe	tpe
haeckel	haeckel
topographic	地形
เมี้ยว	喵
zoids	zoids
hort	hort
jnn	jnn
gesellschaft	gesellschaft
kunth	kunth
transcluded	transcluded
bismuth	鉍
cronquist	cronquist
darjah	darjah
korn	korn
michele	michele
dickson	dickson
taxoboxes	taxoboxes
ญาติๆ	親屬
ญาติๆ	親戚
toolserver	toolserver
jalan	jalan
btob	btob
nnn	nnn
nabla	nabla
wikt	wikt
abovebelow	abovebelow
ชอปปิ้ง	買東西
ชอปปิ้ง	購物
superfamilia	superfamilia
bom	atlantico
dsrna	dsrna
กรีส	油脂
sirna	sirna
ksa	ksa
เบย	裴
berghahn	berghahn
crocodylus	crocodylus
งีบ	午睡
งีบ	小睡
vim	vim
quantitative	量化
quantitative	定量
dtv	dtv
lour	lour
เปียนโน	鋼琴
dlc	dlc
trachypithecus	trachypithecus
prolog	prolog
sina	sina
macbook	macbook
sac	sac
ดินเนอร์	晚飯
ดินเนอร์	晚餐
michi	michi
ไกส์	skype
garman	garman
mimi	咪咪
avatar	神通
avatar	化身
omim	omim
ssc	ssc
accademia	accademia
powerpc	powerpc
อุทาหรณ์	寓言
อุทาหรณ์	比喻
moderne	moderne
ย่อมเยา	負擔得起
เลอะเทอะ	亂
เลอะเทอะ	凌亂
เลอะเทอะ	亂
เลอะเทอะ	爛攤子
barincrement	barincrement
cta	cta
chapterurl	chapterurl
ทัณฑ์บน	假釋
fai	輝
romaji	romaji
broker	經紀人
broker	經紀
broker	中介
continuum	連續
ติดตลก	機智
ซิการ์	雪茄
ejective	ejective
ดรอป	滴
ดรอป	下降
rodentia	rodentia
pfeil	pfeil
กระดิก	擺動
กระดิก	搖擺
การขนส่งมวลชน	過境
loc	祿
rsmc	rsmc
angiosperms	angiosperms
bonn	波恩
เมกะเฮิรตซ์	兆赫
เมกะเฮิรตซ์	mhz
sixteen	十六
บังตา	蒙蔽
nadph	nadph
emedicine	emedicine
กระเด้ง	彈跳
กระเด้ง	反彈
ขาอ่อน	大腿
dns	dns
ttl	ttl
นรีแพทย์	婦科
นรีแพทย์	婦科醫生
acn	acn
adagio	adagio
แชท	聊
แชท	聊天
evenodd	evenodd
moo	茂
zap	zap
sma	sma
missingno	missingno
เอเย่นต์	代理商
เอเย่นต์	代理人
เอเย่นต์	特工
เอเย่นต์	代理
espada	espada
msu	msu
ตูส	stu
infraclassis	infraclassis
lemonchiffon	lemonchiffon
outdoor	室外
outdoor	戶外
polydor	polydor
antineutrino	antineutrino
treme	treme
เปเป	秘魯
bodyguard	保鏢
nfc	nfc
samba	samba
velit	velit
wikiversity	wikiversity
sop	sop
eaba	eaba
czw	czw
csu	csu
mcv	mcv
gaba	gaba
ช๊อค	休克
ช๊อค	驚
ช๊อค	震驚
ช๊อค	衝擊
yami	yami
เตารีด	鋼鐵
เตารีด	鐵
coturnix	coturnix
voc	voc
subphylum	subphylum
viroid	viroid
governorate	省
governorate	省省
atk	atk
หวานๆ	甜蜜
หวานๆ	甜
theropoda	theropoda
wikivoyage	wikivoyage
subcompact	subcompact
mms	mms
cgmp	cgmp
tcwc	tcwc
dmc	dmc
consequat	consequat
spica	spica
bara	bara
vin	vin
webos	webos
gpp	gpp
paleocene	paleocene
nisi	nisi
blackberry	黑莓
blackberry	blackberry
โชคลาง	迷信
tapirus	tapirus
oligocene	oligocene
cbn	cbn
บังกะโล	平房
hrsg	hrsg
ซื่อๆ	幼稚
ซื่อๆ	天真
rip	安息吧
rip	安息
smtp	smtp
utd	utd
dailynews	dailynews
animenewsnetwork	animenewsnetwork
phasianidae	phasianidae
pang	龐
ngn	ngn
nicky	nicky
motogp	motogp
hspa	hspa
rdf	rdf
parque	parque
rondo	回旋曲
amr	amr
moma	moma
sachsen	sachsen
เหยาะ	姚
เหยาะ	瑤
zaft	zaft
rambur	rambur
mobygames	mobygames
uncredited	uncredited
historiography	史學
manutd	manutd
gmatch	gmatch
wmflabs	wmflabs
prec	prec
sdb	sdb
zaw	zaw
อาร์ตี้	artie
องคชาติ	陰莖
danser	danser
nsw	nsw
hussain	hussain
tempor	tempor
neanderthalensis	neanderthalensis
acs	acs
cng	cng
nail	釘
nail	釘子
nail	指甲
hookeriana	hookeriana
wimax	wimax
aes	aes
afi	afi
csc	csc
cvn	cvn
salvator	salvator
เพลีย	累了
เพลีย	累
emporis	emporis
ffb	ffb
tpp	tpp
poptime	poptime
barnstar	barnstar
apex	頂點
เด็บ	deb
daw	daw
enwiki	enwiki
toho	toho
monospace	monospace
borderline	邊緣
pwr	pwr
ether	醚
tdma	tdma
bwr	bwr
parserfunctions	parserfunctions
adv	adv
กยู	圭
mde	mde
vaillant	vaillant
bund	上灘
pka	pka
eros	eros
spathulata	spathulata
lgbt	lgbt
hkg	hkg
icann	icann
schum	schum
taxobox	taxobox
rihanna	rihanna
blitz	閃擊
blitz	閃電戰
nur	nur
bouvier	bouvier
aniplex	aniplex
nsaids	nsaids
monodelphis	monodelphis
stripe	stripe
stripe	條紋
esse	esse
ptg	ptg
clustering	群集
clustering	集群
หลานๆ	孫子
photobucket	photobucket
agb	agb
openbsd	openbsd
scc	scc
dolce	dolce
rerun	重播
ffi	ffi
antiquark	antiquark
highestsinglesranking	highestsinglesranking
afs	afs
civ	civ
lydekker	lydekker
vivo	vivo
careerprizemoney	careerprizemoney
bibcode	bibcode
opengl	opengl
บลูเบอร์รี	藍莓
doublesrecord	doublesrecord
consolidation	鞏固
consolidation	整合
consolidation	合併
treron	treron
sixty	六十
volvo	富豪
disambig	disambig
piedmont	山麓
phineas	phineas
psk	psk
hpv	hpv
oldid	oldid
pgm	pgm
ddot	ddot
puy	puy
battista	battista
เปล่งปลั่ง	發光
pollutant	污染物
hylobates	hylobates
transcriptase	transcriptase
laidlaw	laidlaw
สะอึก	打嗝
laurenti	laurenti
เฮ้	嘿
prk	prk
sana	薩那
คอแห้ง	渴了
คอแห้ง	渴
คอแห้ง	口渴
atrium	atrium
nowiki	nowiki
nyasaland	nyasaland
freenode	freenode
gucci	gucci
gerd	gerd
qam	qam
singlesrecord	singlesrecord
เดบิต	借方
chembox	chembox
หนึบ	黏黏
หนึบ	粘
หนึบ	粘性
หนึบ	黏
snak	snak
swainson	swainson
pte	pte
nes	nes
hbv	hbv
plunkett	plunkett
ansi	ansi
soccerway	soccerway
tts	tts
เคอร์เซอร์	游標
prinz	prinz
derm	derm
tenth	第十
naa	naa
ssb	ssb
copyleft	copyleft
motilal	motilal
khamis	khamis
helloworld	helloworld
getty	getty
hsdpa	hsdpa
สมิทธ์	smith
สมิทธ์	史密斯
ทำครัว	廚房
bmj	bmj
jerkins	jerkins
rtl	rtl
tnf	tnf
roundel	roundel
nativename	nativename
เบ็ท	beth
utm	utm
trump	trump
othernames	othernames
columnwidth	columnwidth
quoy	quoy
แวบ	wham
bose	bose
takehiko	takehiko
aof	aof
tep	tep
plainlist	plainlist
cpn	cpn
eutheria	eutheria
bbb	bbb
highestdoublesranking	highestdoublesranking
tif	tif
earn	掙
earn	賺取
earn	賺
navi	navi
hilton	希爾頓
abdel	abdel
swa	swa
becc	becc
ไฟร์เบิร์ด	firebird
wrc	wrc
regency	regency
eer	eer
protease	蛋白酶
vos	vos
donau	多瑙
hct	hct
spyder	spyder
naing	naing
clubnumber	clubnumber
texture	紋理
kaval	kaval
suppressplaceholder	suppressplaceholder
sigurd	sigurd
prestel	prestel
scn	scn
travelocity	travelocity
lcc	lcc
ota	太田
ota	大田
boomerang	boomerang
stephan	stephan
networth	networth
tvk	tvk
wikilinks	wikilinks
grandprix	grandprix
thunb	thunb
lfp	lfp
ksc	ksc
haliaeetus	haliaeetus
clr	clr
eme	eme
epac	epac
mls	mls
uma	uma
trofeo	trofeo
tem	tem
ดุค	公爵
sfc	sfc
asm	asm
onsen	溫泉
tres	tres
prx	prx
หลวย	集會
ces	ces
soccernet	soccernet
origyear	origyear
spiegel	spiegel
preprocess	preprocess
cheers	歡呼聲
consectetur	consectetur
paradisaea	paradisaea
fen	芬
sergio	sergio
schl	schl
faf	faf
nwo	nwo
niosh	niosh
australianopenresult	australianopenresult
eazy	eazy
jassim	jassim
hermes	hermes
voluptate	voluptate
sven	斯文
listn	listn
marri	marri
อาลิ	阿里
อาลิ	ali
ใจแข็ง	無情
ลอตเตอรี่	彩票
jdbc	jdbc
ipo	ipo
bbd	bbd
tms	tms
testudo	testudo
ฟรอสท์	frost
ฟรอสท์	霜
ฟรอสท์	冰霜
lgpl	lgpl
เซจ	sage
vlsi	vlsi
cml	cml
naver	naver
anura	anura
ทะนุถนอม	珍惜
ทะนุถนอม	珍愛
grape	葡萄
dioguardi	dioguardi
wimbledonresult	wimbledonresult
docomo	docomo
usopenresult	usopenresult
vaginal	陰道
blum	blum
photoshop	photoshop
msx	msx
openoffice	openoffice
iis	iis
tui	tui
sws	sws
ว่างๆ	出缺
ว่างๆ	空缺
ว่างๆ	空白
ว่างๆ	空
symphonic	交響樂
ontology	本體
ontology	本體論
lse	lse
mentor	導師
ยกนิ้ว	拇指
ยกนิ้ว	大拇指
สเต็ก	牛排
nep	nep
ses	ses
chemspiderid	chemspiderid
lundin	lundin
boucher	boucher
pam	潘
pam	pam
deadurl	deadurl
sonate	sonate
npt	npt
swat	swat
swat	特種部隊
cns	cns
lantis	lantis
psg	psg
frenchopenresult	frenchopenresult
transrapid	transrapid
imagecaption	imagecaption
tmp	tmp
pes	pes
kcal	千卡
avi	avi
dap	dap
csf	csf
mariano	mariano
fsa	fsa
fujibayashi	fujibayashi
loxodonta	loxodonta
choy	蔡
autosomal	autosomal
holthuis	holthuis
icc	icc
rhombicuboctahedron	rhombicuboctahedron
lipase	lipase
เฝอ	崇德
masato	真人
github	github
tfl	tfl
dte	dte
mezzo	mezzo
โบนส์	bones
โบนส์	骨
โบนส์	骨骼
โบนส์	骨頭
ยูนิฟอร์ม	軍服
ยูนิฟอร์ม	均勻
ยูนิฟอร์ม	制服
ยูนิฟอร์ม	軍裝
zim	zim
wikispecies	wikispecies
fnc	fnc
skyscraperpage	skyscraperpage
crs	crs
microcebus	microcebus
kuntze	kuntze
wav	wav
bunko	文庫
megan	megan
tay	tay
miley	miley
gmp	gmp
ctx	ctx
ilds	ilds
atx	atx
คลอโรฟอร์ม	氯仿
mainsnak	mainsnak
hasbro	hasbro
westport	westport
labore	labore
petaurista	petaurista
moa	moa
prednisolone	prednisolone
pyotr	pyotr
eba	eba
diaz	diaz
amine	胺
แอ๊ปเปิ้ล	蘋果
gridcolor	gridcolor
vivace	vivace
sut	sut
เทพพยากรณ์	oracle
เทพพยากรณ์	先知
cephalopoda	cephalopoda
maler	maler
presto	presto
monash	monash
sinh	sinh
mrc	mrc
cnet	cnet
พิมพ์เขียว	藍圖
พิมพ์เขียว	藍圖
rebels	叛亂份子
rebels	叛亂分子
rebels	叛軍
ode	頌
bataille	bataille
comune	comune
boydell	boydell
uncia	uncia
scribner	scribner
ทรัมพ์	trump
ffk	ffk
rrna	rrna
pokemon	pokemon
shy	害羞
longmans	longmans
arista	arista
cmyk	cmyk
ฉาวโฉ่	聲名狼藉
ฉาวโฉ่	臭名昭著
ฉาวโฉ่	臭名昭著
ฉาวโฉ่	聲名狼藉
xxii	xxii
pty	pty
obe	obe
deutscher	deutscher
gpg	gpg
fairuse	fairuse
xxvi	xxvi
bhr	bhr
zeit	zeit
horner	horner
ultratop	ultratop
alstom	alstom
alsos	alsos
mtdna	mtdna
iffhs	iffhs
richman	richman
fns	fns
sonybmg	sonybmg
retroflex	捲舌
searchlight	探照燈
spf	spf
podiceps	podiceps
eget	eget
veniam	veniam
kha	kha
taiping	太平
reprehenderit	reprehenderit
fugiat	fugiat
pariatur	pariatur
arctan	arctan
methuen	methuen
wikimapia	wikimapia
theresia	theresia
polaris	北極星
qasim	qasim
notableworks	notableworks
tomica	tomica
zin	zin
esc	esc
smp	smp
hmg	hmg
pbk	pbk
inconnu	inconnu
banarsidass	banarsidass
oncorhynchus	oncorhynchus
presl	presl
sauropsida	sauropsida
hemsl	hemsl
ornithischia	ornithischia
allegretto	allegretto
footballdatabase	footballdatabase
mips	mips
goetia	goetia
tos	tos
crm	crm
nasser	nasser
nasser	納賽爾
loen	loen
prada	prada
artiodactyla	artiodactyla
moderato	moderato
hidalgo	hidalgo
abba	abba
xxv	xxv
dll	dll
cpa	cpa
สะเพร่า	魯莽
สะเพร่า	馬虎
acd	acd
messagebox	messagebox
cbe	cbe
lfc	lfc
ffebcd	ffebcd
ics	ic
annandale	annandale
igg	igg
tpl	tpl
afa	afa
xperia	xperia
gareth	gareth
cnc	cnc
korat	korat
msc	msc
หนาๆ	厚
หนาๆ	厚厚
cindy	cindy
bur	bur
ดรูว	drew
nusa	nusa
nmda	nmda
bgm	bgm
อัลม่า	alma
krupp	krupp
phylogenetics	phylogenetics
ลอว์เรน	lauren
cowboys	牛仔
nhc	nhc
chatto	chatto
คาร์เนชั่น	康乃馨
joshi	joshi
hype	炒作
โชโช	趙
vorbis	vorbis
remixed	remixed
เฟช	fae
verizon	verizon
oao	oao
cdm	cdm
rso	rso
vac	vac
sps	sps
intron	intron
dth	dth
fmt	fmt
dexamethasone	dexamethasone
amt	amt
pcv	pcv
แมช	mash
pdu	pdu
phyo	phyo
enwp	enwp
sbk	sbk
tandem	串聯
userboxes	userboxes
hfc	hfc
pycnonotus	pycnonotus
yousef	yousef
miao	苗族
miao	苗
jal	jal
bibron	bibron
เมโย	蛋黃醬
เมโย	mayo
ถูกๆ	廉價
ถูกๆ	便宜
iczn	iczn
hydrolysis	水解
pstn	pstn
ฟอลส์	瀑布
udmurtia	udmurtia
weidenfeld	weidenfeld
nus	nus
แรนดอล	randall
lwb	lwb
แอพพลิเคชัน	申請
แอพพลิเคชัน	申請書
fifteen	fifteen
fifteen	十五
nia	nia
postfix	postfix
gatas	gatas
fdm	fdm
tah	tah
clh	clh
burushaski	burushaski
scs	scs
yms	yms
typus	䱵
kazuhiro	kazuhiro
smr	smr
sourceforge	sourceforge
messe	messe
sassy	時髦
ปิกนิก	野餐
ปิกนิก	郊遊
kamel	kamel
dinh	dinh
fah	fah
ashgate	ashgate
uwf	uwf
ftv	ftv
parlophone	parlophone
bjt	bjt
acad	acad
diaeresis	diaeresis
ผ้าดิบ	布料
ผ้าดิบ	織物
pag	pag
jbl	jbl
ชอล์ค	粉筆
stroud	stroud
dope	塗料
awm	awm
kune	kune
ris	ris
sheldon	sheldon
ascap	ascap
kaiserin	kaiserin
nox	nox
ghc	ghc
phaidon	phaidon
yukihiro	yukihiro
hamata	hamata
physique	體格
physique	體質
bloodshy	bloodshy
medica	medica
ไฮท์	高地
subfamily	subfamily
minim	minim
mauris	mauris
tiff	tiff
mtu	mtu
dts	dts
ponsonby	ponsonby
อัยย์	ayub
snh	snh
polideportivo	polideportivo
qualcomm	qualcomm
trf	trf
ไพธอน	python
ไพธอน	巨蟒
ไพธอน	蟒
ไพธอน	蟒蛇
tsr	tsr
regis	regis
ดุ๊ค	公爵
esprit	esprit
altis	altis
gaimard	gaimard
bcc	密件
bcc	bcc
webcite	webcite
niche	專長
iupacname	iupacname
domesticus	domesticus
mrp	mrp
vertebrata	vertebrata
álvarez	álvarez
thunderpuss	thunderpuss
viaf	viaf
wetland	濕地
