กระพือ	solapa
เสือก	tiger
เสือก	tigre
bts	bts
miguel	miguel
สิงค์	embruixat
ไฮเวย์	autopista
จู๋	penis
จู๋	polla
lam	lam
ประภาคาร	far
เบาๆ	suaument
cleveland	cleveland
bjs	bjs
subheader	subheader
vip	vip
ดอกจัน	asterisc
kor	kor
andreas	andreas
sme	pime
char	jis
เหน็ดเหนื่อย	fatiga
ไมเกรน	migranya
โผ	dard
timeaxis	timeaxis
render	representació
แคชเมียร์	caixmir
โคลนนิ่ง	clon
โคลนนิ่ง	clonació
ทอร์เรส	torres
aves	aves
รีโมท	remot
รีโมท	remota
รีโมท	remots
ฮันท์	hunt
อิมเมจ	imatge
โคบอลต์	cobalt
infinity	infinit
infinity	infinitat
คู่ควร	dignes
อัลลอฮ์	déu
ซุกซน	trapella
มึนเมา	disbauxa
agar	agar
rnai	rnai
superordo	superordo
lil	lil
michelle	michelle
บุคลิกลักษณะ	personalitat
echo	eco
echo	ressó
echo	echo
pcr	pcr
โพลล์	enquestes
โพลล์	urnes
โพลล์	enquesta
โพลล์	poll
credit	credit
credit	crèdit
ffe	ffe
ไฮไลท์	destaca
ไฮไลท์	destacats
ไฮไลท์	ressaltats
ไฮไลท์	ressalta
ไฮไลท์	ressaltat
seo	seo
springer	springer
สอย	shiv
rels	rels
ovw	ovw
ฮิป	hip
ฮิป	maluc
เครื่องร่อน	abid
มันเทศ	yam
reuters	reuters
langs	langs
polyhedra	políedre
mansi	mansi
khanty	khanti
เอื้อย	zapping
confederations	confederacions
prov	prov
macau	macau
rey	rey
copper	coure
ไดอะแกรม	diagrames
mas	mas
navbar	navbar
faq	pmf
ลีห์	leigh
vaccinium	vaccinium
sekai	sekai
เฮโรอีน	heroïna
bezirk	bezirk
mrt	mrt
sting	punxar
zhao	zhao
tmd	tmd
kpa	kpa
airplay	airplay
rchb	rchb
tar	tar
กะพริบ	parpelleig
เอ็มม่า	emma
แบบสอบถาม	qüestionari
attitude	actitud
kami	kami
โรงรถ	garatge
len	len
nest	niu
layout	disposició
gadget	gadget
ภวังค์	inconsciència
hrs	hrs
ซิงค์	sincronitza
สร่าง	sobri
มอร์ฟีน	morfina
เฟร็ด	fred
พูห์	pooh
ying	ying
โฟลเดอร์	carpetes
โฟลเดอร์	carpeta
bwv	bwv
hai	hai
ffa	ffa
เมกะไบต์	mib
เมกะไบต์	megabytes
ไขควง	tornavís
ratp	ratp
exo	exo
ยุ่น	jap
sqmi	sqmi
premium	premium
exe	exe
alocasia	alocasia
tsunami	tsunami
eest	eest
เดลาแวร์	delaware
ล้วนๆ	purament
หนุ่มๆ	nois
หนุ่มๆ	boys
คาร์ไลล์	carlisle
arsenal	arsenal
xiv	xiv
triumph	triomf
hotmail	hotmail
crest	cresta
crest	rasant
ridl	ridl
ฟีเจอร์	característica
ฟอยล์	floret
ฟอยล์	làmina
mbps	mbps
เคอร์เนล	nucli
mbs	mbs
แอสไพริน	aspirina
adm	adm
cash	cash
cash	efectiu
คอนโทรล	control
หดหู่	depressió
aboveclass	aboveclass
boo	boo
hoya	hoya
hoya	foia
transformers	exposicions
gsd	gsd
สุขใจ	feliç
ตุ๋ย	pedòfil
boku	boku
ซูม	zoom
thesis	tesi
thesis	tesis
เทต	tate
utf	utf
jang	jang
โคเคน	coca
โคเคน	cocaïna
frozen	frozen
frozen	congelat
mammalia	mammalia
initiative	iniciativa
plotarea	plotarea
เบ็ดเตล็ด	varis
เบ็ดเตล็ด	divers
sysop	sysop
xyz	xyz
ดาการ์	dakar
safari	safari
รังสีวิทยา	radiologia
โนห์	noh
transfermarkt	transfermarkt
rai	rai
โอ๊ย	uf
dateformat	dateformat
dino	dino
ชอล	chul
tattoo	tattoo
tattoo	tatuatge
ละเมอ	somnambulisme
เคฟ	kev
mev	mev
กว้าน	cabestany
gpcm	gpcm
ท่องจำ	memoritzar
cichlidae	cichlidae
ping	ping
melbourne	melbourne
nbn	nbn
undef	undef
lindl	lindl
บังเกอร์	bunker
บังเกอร์	búnquer
อิสลามาบัด	islamabad
mia	mia
bride	núvia
ภูเขาน้ำแข็ง	iceberg
chuck	chuck
ไฝ	talp
ไฝ	mols
ไฝ	moles
noaa	noaa
สลิป	relliscada
cruz	cruz
maya	maya
dolby	dolby
เบลค	blake
jstor	jstor
เน็ด	ned
ล็อบบี้	vestíbul
aki	aki
palestine	palestina
kate	kate
fhm	fhm
กรี๊ด	crit
กรี๊ด	cridar
pmc	pmc
vita	vita
tdr	tdr
belowclass	belowclass
ซิบ	cremallera
โพส	publicació
โพส	suposen
โพส	plantejant
แฮ็ก	piratejar
majeur	majeur
nextseason	nextseason
ขายส่ง	engròs
sap	sap
dmy	dmy
einecs	einecs
บดขยี้	trituració
textcolor	textcolor
โปสการ์ด	postal
โปสการ์ด	postals
isp	isp
engl	engl
gpu	gpu
ทุบตี	cops
cvt	cvt
pframe	pframe
สปา	spa
สปา	zepa
tbl	tbl
ลค	blake
chill	chill
cyp	cyp
origargs	origargs
pid	pid
nbt	nbt
duty	deure
sphrases	sphrases
prevseason	prevseason
คอรัปชั่น	corrupte
คอรัปชั่น	corruptes
din	din
orbiter	orbiter
phylogeny	cladística
che	che
แพ็คเกจ	envàs
แพ็คเกจ	manada
แพ็คเกจ	pack
แพ็คเกจ	pla
แพ็คเกจ	paquet
บอยด์	boyd
วอลเล่ย์	voleibol
sans	sans
acm	acm
โซนาร์	sonar
ccff	ccff
ก้ำกึ่ง	borderline
gym	gimnàs
gym	gym
ช่ำชอง	hàbils
seventeen	disset
เซอร์ไพรส์	sorpresa
rune	rune
ars	ars
อาเมน	amén
อาเมน	amen
ฟลอเรส	flores
เท็ต	tate
ความเฉื่อย	inèrcia
ฮาร์ป	arpa
ดิ๊ก	dick
แคลอรี่	caloria
แคลอรี่	calories
โคมลอย	fanalets
univ	univ
bdfutbol	bdfutbol
efm	efm
พล็อต	trama
getparent	getparent
เป๊ะ	exactament
annie	annie
ucb	ucb
xtreme	xtreme
เมอร์ลิน	merlí
เมอร์ลิน	merlin
ตะเข็บ	cosint
แชด	txad
มูส	ant
resistivity	resistivity
imagestyle	imagestyle
chelsea	chelsea
coin	moneda
หอน	llança
ทรัม	trump
titan	titan
titan	tità
wet	humida
wet	mullat
หลงลืม	descuit
หลงลืม	desatenció
เตาผิง	xemeneia
บาร์บูดา	barbuda
อัลฟ่า	alpha
อัลฟ่า	alfa
ขนมอบ	rebosteria
ขนมอบ	pastisseria
สดๆ	fresc
สดๆ	fresques
สดๆ	fresca
สดๆ	frescos
เห็บ	puces
ukr	ukr
crh	crh
mpa	mpa
prof	prof
หวีด	xiulet
บรูก	bru
บาร์เลย์	ordi
mbf	mbf
ppp	ppp
aut	aut
pete	pete
อินเตอร์เน็ต	internet
อินเดียนา	indiana
แฮกเกอร์	hacker
nikki	nikki
benz	benz
scalemajor	scalemajor
piaget	piaget
adsl	adsl
hdtv	hdtv
burton	burton
lcd	roundup
lcd	lcd
gakuen	gakuen
steindachner	steindachner
hay	hay
แอป	app
แอป	aplicacions
cid	cid
นกหวีด	xiulet
นกหวีด	xiulets
bie	bie
ต้นคอ	coll
chrome	chrome
taoiseach	taoiseach
ก้าวก่าย	intrusiu
sim	sim
blason	blason
แลป	laboratori
ขี้เหร่	lleig
ขี้เหร่	lletja
พรีเมียม	premium
aru	aru
uri	uri
koei	koei
เทด	ted
ชาร์ล็อตต์	charlotte
ชาร์ล็อตต์	carlota
wikimania	wikimania
มีดโกน	razor
มีดโกน	navalla
sophie	sophie
ลูกเห็บ	calamarsa
iro	iro
อุ้งเท้า	urpes
ploceus	ploceus
ลิปสติก	pintallavis
ergaster	ergaster
reptilia	reptilia
sos	sos
ฮวา	hwa
อายัด	frozen
อายัด	congelat
ssp	ssp
ซุซุ	zeus
tabernaemontana	tabernaemontana
cts	cts
dallwitz	dallwitz
มุทะลุ	temerari
สังเกตุ	preavís
pgp	pgp
eddy	eddy
visa	visat
ขนตา	fuetades
ddr	ddr
อาร์กิวเมนต์	arguments
uhf	uhf
crush	crush
crush	esclafar
ซอฟแวร์	programari
ocinsoutput	ocinsoutput
lancer	lancer
mda	mda
เงินปันผล	dividends
mari	mari
อะเดล	adèle
อะเดล	adele
alignbars	alignbars
concepts	conceptes
smes	pime
smes	pimes
temminck	temminck
skill	destresa
skill	habilitat
โลชั่น	loció
ลาเวนเดอร์	lavanda
ฟีด	alimenta
บัซ	buzz
viva	viva
sql	sql
meshname	meshname
vtec	vtec
bodystyle	bodystyle
ไปรษณียบัตร	postal
ตรรก	racional
ตรรก	racionals
ตรรก	lògic
ตรรก	lògica
lte	lte
passive	passiu
dao	dao
pascal	pascal
burke	burke
transcript	transcripció
โลเวลล์	lowell
kitty	kitty
หลาบ	iardes
มัสตาร์ด	mostassa
ดอกจิก	clubs
ดอกจิก	trèvols
hood	hood
schott	schott
ร่ำไห้	ploren
eur	eur
alam	alam
กุญแจมือ	manilles
tona	tona
โปรไฟล์	perfil
โปรไฟล์	perfils
จาว	shao
livesey	livesey
ind	ind
linn	linn
clover	trèvol
cheese	formatge
wto	omc
บูกิต	bukit
พอกพูน	acreció
moe	moe
turismo	turismo
ing	ing
ctrl	ctrl
pfc	pfc
dota	dota
pac	pac
ชุล	chul
sortable	sortable
nums	nums
ufc	ufc
requiem	rèquiem
รปภ	seguretat
elsevier	elsevier
emma	emma
หัวนม	mugrons
หัวนม	mugró
heuristic	heurística
plc	plc
raven	corb
raven	raven
lorem	lorem
แล็ปท็อป	portàtils
แล็ปท็อป	portàtil
เบลก	blake
lucy	lucy
gnis	gnis
dinosauria	dinosauria
โป๊กเกอร์	poker
โป๊กเกอร์	pòquer
nfl	nfl
dengeki	dengeki
lip	llavi
moss	molsa
moss	moss
ปลอกคอ	collar
ปลอกคอ	collarets
โฮล์มส์	holmes
ไมลส์	milles
ไมลส์	kilòmetres
ไมลส์	quilòmetres
civic	cívic
civic	civic
leiden	leiden
iec	iec
naruto	naruto
tlc	tlc
carmen	carmen
extensor	extensor
ตื้นๆ	superficial
หนองใน	gonorrea
ลอต	lott
henle	henle
ลินซ์	lynch
คีท	keith
elephas	elephas
topscorer	topscorer
dubai	dubai
ทรัมเปต	trompeta
กระวนกระวาย	ansiosa
เหิร	ascensors
เหิร	aixeca
tao	tao
gis	gis
สวยๆ	guapa
sdtv	sdtv
cma	cma
mep	mep
asa	asa
rue	rue
ฉุบ	tisores
นํ้า	aigua
คราง	gemec
gorm	gorm
psr	psr
uprising	junta
slim	slim
curry	curri
curry	curry
scaleminor	scaleminor
templatedata	templatedata
zonal	zonal
rft	rft
exp	exp
orientalis	orientalis
loaddata	loaddata
directx	directx
รัดรูป	rudd
miocene	miocè
zanthoxylum	zanthoxylum
luca	luca
ตาชั่ง	barems
ตาชั่ง	escales
ตาชั่ง	escates
ตาชั่ง	bàscula
familycolor	familycolor
ใคร่ครวญ	reflecteixen
ใคร่ครวญ	reflecteix
ใคร่ครวญ	reflexionar
ใคร่ครวญ	reflectir
ใคร่ครวญ	contemplant
titleclass	titleclass
mmorpg	mmorpg
nic	nic
ผสมเทียม	inseminació
rubiaceae	rubiàcia
limnonectes	limnonectes
คังนัม	gangnam
rae	rae
tls	tls
mtc	mtc
wmf	wmf
pwg	pwg
idn	idn
bandai	bandai
ucla	ucla
เอทีเอ็ม	caixer
เอทีเอ็ม	atm
wta	wta
แรนด์	rand
omniglot	omniglot
ยางลบ	esborrany
นมวัว	vaca
ped	ped
sdn	sdn
pizza	pizza
rem	rem
เซรามิค	ceràmica
เซรามิค	ceràmica
cis	cei
dek	dek
phuket	phuket
nrt	nrt
thx	thx
bhd	bhd
cotton	cotó
cze	cze
ipod	ipod
ipod	ipods
emerg	emerg
ทำหมัน	esterilització
ทำหมัน	esterilitzat
setmetatable	setmetatable
ips	ips
ole	ole
chennai	chennai
peng	peng
solaris	solaris
สุขารมณ์	hedonisme
ดีซ่าน	icterícia
comp	comp
บาร์บีคิว	barbacoa
บาร์บีคิว	barbacoa
hcl	hcl
baba	baba
ems	sme
ems	ems
เทียนไข	vetlla
เทียนไข	vela
เทียนไข	espelma
hoc	hoc
rafinesque	rafinesque
โคไซน์	cosinus
บู้	boo
subfamilia	subfamilia
เพียซ	pierce
pdp	pdp
เมก	meg
shtml	shtml
sue	sue
terme	terme
herre	herre
birdlife	avifauna
emerald	maragda
bas	bas
percussion	percussió
รีซ	reese
จอร์น	john
จอร์น	joan
plantae	plantae
จำนอง	hipoteca
lccn	lccn
oecd	ocde
subclassis	subclassis
disp	desv
sig	sig
ตูด	cul
racer	racer
พลั่ว	palas
พลั่ว	pala
linecolor	linecolor
esrb	esrb
irn	irn
วิสกี้	whisky
benth	benth
basestyle	basestyle
ยอร์น	york,
afp	afp
ฟอร์แมต	format
lycodon	lycodon
จิ๋ม	pussy
lpg	glp
bacillus	bacillus
wifi	wifi
getcurrenttitle	getcurrenttitle
ambox	ambox
msv	msv
ipad	ipad
สำลัก	penjant
cmos	cmos
gmelin	gmelin
เบรค	fre
เบรค	frens
ดอท	dot
marksize	marksize
กลมๆ	ronda
mcdonald	mcdonald
nist	nist
มัดจำ	dipòsit
vhs	vhs
kde	kde
medlineplus	medlineplus
wikibooks	viquillibres
bkk	bbk
lothringen	lothringen
ไนลอน	niló
ปมด้อย	inferioritat
lopez	lópez
lopez	lopez
gre	gre
ลินช์	lynch
goldblatt	goldblatt
กิกิ	kiki
sato	sato
datastyle	datastyle
apa	apa
kloster	kloster
ต้อกระจก	cataracta
ifpi	ifpi
forsskål	forsskål
lightsteelblue	lightsteelblue
sauvage	sauvage
อินเตอร์เฟส	interfície
stardust	stardust
ministère	ministère
aol	aol
ลอเรล	laurel
factsheet	factsheet
ยาสลบ	anestèsia
ก๊าด	querosè
hon	hon
rss	rss
rheum	rheum
coliseo	coliseo
aec	aec
ฝักบัว	dutxa
ฝักบัว	ruixats
ฝักบัว	dutxes
ปาโล	palo
คลัสเตอร์	cúmul
คลัสเตอร์	clúster
คลัสเตอร์	clústers
tee	tee
wittgenstein	wittgenstein
avec	avec
geforce	geforce
อีสุกอีใส	pox
nano	nano
casting	fosa
casting	càsting
casting	casting
iss	iss
bamboo	bambú
nigra	nigra
miq	miq
gmail	gmail
ผ้าเช็ดหน้า	mocador
ipcc	ipcc
itf	itf
nong	nong
geoffroy	geoffroy
มอลต์	malt
เนด	ned
เหยือก	mug
เหยือก	llançador
เหยือก	gerro
monobook	monobook
gprs	gprs
watt	watt
veitchii	veitchii
โปรโมชัน	promo
โปรโมชัน	promoció
psu	psu
habilis	habilis
eka	eka
dodge	dodge
eia	eia
yves	yves
universität	universität
ซอด	zod
actualuse	actualuse
amet	amet
kin	kin
kyaw	kyaw
ras	ras
ลีท	leith
อุ้งมือ	urpes
sprint	sprint
sprint	esprint
nyc	nyc
barneby	barneby
publicationdate	publicationdate
mma	mma
panoramio	panoramio
แพม	pam
australopithecus	australopithecus
evo	evo
ทรัมป์	trump
muell	muell
ich	ich
johan	johan
คีบ	fòrceps
bust	busto
bust	bust
อรรถประโยชน์	utilitats
อรรถประโยชน์	utilitat
rsa	rsa
ฮิบ	hip
ฮิบ	maluc
metacritic	metacritic
โบรกเกอร์	broker
cms	cms
arp	arp
biz	biz
dude	tiu
deutsch	deutsch
ฮโย	hyo
ต้อหิน	glaucoma
hotcat	hotcat
pga	pga
ไมก้า	micah
mont	mont
svk	svk
ccccc	ccccc
เซสชัน	session
เซสชัน	sessió
เซสชัน	sessions
capo	capo
บัดดี้	buddy
เอะอะ	enrenou
itc	itc
clays	argiles
panasonic	panasonic
guideline	directriu
infraordo	infraordo
leguminosae	leguminosae
naka	naka
พาธ	camí
longus	llong
ดุลยพินิจ	discreció
cochrane	cochrane
คอมมูน	comuna
nds	nds
gogo	gogo
aac	aac
société	société
adr	adr
util	util
globalsecurity	globalsecurity
kentucky	kentucky
imageright	imageright
ไฮไลต์	ressalta
ไฮไลต์	ressaltat
ไฮไลต์	destaca
ไฮไลต์	destacats
ไฮไลต์	ressaltats
ซีรี่ส์	sèries
ซีรี่ส์	sèrie
longman	longman
ipc	ipc
mah	mah
aps	aps
แชต	xat
capensis	capensis
österreich	österreich
quis	quis
cfm	cfm
fps	fps
kew	kew
cwa	cwa
joker	jòquer
cambodge	cambodge
fcc	fcc
ataxia	atàxia
stadion	stadion
demospace	demospace
cpe	cpe
hdmi	hdmi
mundo	mundo
เธน	gentilhome
ถาก	pasturar
staphylococcus	staphylococcus
แท่	tae
tel	tel
ฟิค	figa
delle	delle
gam	gam
coco	coco
palgrave	palgrave
kinki	kinki
japonica	japonica
kinase	ciclina
อัลเฟร็ด	alfred
nec	nec
cdt	cdt
nbsp	nbsp
duomo	duomo
nvidia	nvidia
isi	isi
pubmed	pubmed
ส่วนลด	descompte
ส่วนลด	rebaixa
ส่วนลด	descomptes
ส่วนลด	rebaixes
ค่าสัมบูรณ์	absoluts
ค่าสัมบูรณ์	absolut
ค่าสัมบูรณ์	absoluta
ค่าสัมบูรณ์	absolutes
tung	tung
tero	tero
xvi	xvi
hdl	hdl
arxiv	arxiv
csv	csv
gin	gin
kokoro	kokoro
nida	nida
liebe	liebe
muay	muay
เล้าโลม	preliminars
tis	tis
fernández	fernández
bayern	bayern
ผิวปาก	xiulet
ผิวปาก	xiular
mis	mis
vtr	vtr
anhalt	anhalt
immunoglobulin	immunoglobulina
shortsummary	shortsummary
ati	ati
gmbh	gmbh
แฮ่	hae
psy	psy
tnt	tnt
natalie	natali
ปฐมนิเทศ	orientació
tam	tam
duméril	duméril
โบกมือ	onejant
โบกมือ	ona
อัลลอฮฺ	déu
württemberg	württemberg
มอซ	moz
utama	utama
harpercollins	harpercollins
ไลค์	com
ไลค์	like
domenico	domenico
เดนี	dani
ไฟแนนซ์	finançament
ไฟแนนซ์	finances
เฝือก	elenc
เฝือก	repartiment
ppi	ppi
colstyle	colstyle
moulin	moulin
mayo	mayo
proc	proc
dbt	dbt
rhizopus	rhizopus
dcc	dcc
nicholson	nicholson
jfk	jfk
bashkortostan	baixkíria
mov	mov
rsu	rsu
const	const
fallax	fallax
mpv	mpv
mee	mee
vga	vga
scr	scr
บล็อค	bloqueja
บล็อค	bloc
บล็อค	bloquejats
บล็อค	bloquejat
proud	orgullosa
proud	orgullós
proud	orgullosos
tokamak	tokamak
slr	rèflex
ppv	ppv
บาดทะยัก	tètanus
cfc	cfc
trend	tendència
outlook	outlook
lacépède	lacépède
ลูปัส	lupus
ชีก	sheik
squamata	squamata
eis	eis
lounge	saló
trna	trna
พิธีรีตอง	tràmits
gaon	gaon
checkuser	checkuser
meshnumber	meshnumber
beau	beau
มโนธรรม	consciència
cmu	cmu
palatinate	palatinat
brookesia	brookesia
เหน็บแนม	burla
ร้อนๆ	hot
ร้อนๆ	calent
เงินผ่อน	finançament
erminea	erminea
hpa	hpa
inset	inset
cena	cena
nadh	nadh
arius	arri
arius	arius
ecu	ecus
ขนลุก	esgarrifós
bcd	bcd
แปรงสีฟัน	raspalls
dev	dev
แล็ป	laboratori
แล็ป	laboratori
som	soms
som	som
suzumiya	suzumiya
oxidase	oxidasa
stm	stm
gagnep	gagnep
msds	msds
irq	irq
insight	perspicàcia
lyn	lyn
musashi	musashi
ohv	ohv
formatdate	formatdate
ซักรีด	bugaderia
pcall	pcall
tyson	tyson
sharpe	sharpe
แฮก	piratejar
coo	coo
คูปอง	cupons
reductase	reductasa
hug	abraçada
ราจ	raj
เย็นๆ	fred
pst	pst
dante	dante
eigenmann	eigenmann
cassini	cassini
république	république
slip	relliscada
och	och
ter	ter
คนสวน	jardiner
backgroundcolors	backgroundcolors
สต๊อก	estoc
สต๊อก	stock
sfsr	sfsr
aspergillus	aspergillus
pulp	polpa
doubleday	doubleday
voivodeship	voivodat
fitzinger	fitzinger
sortkey	sortkey
metallicity	metallicity
amg	amg
ducal	ducal
uni	uni
dab	dab
quicktime	quicktime
otoko	otoko
agassiz	agassiz
lac	lac
นมผง	fórmula
srb	srb
nulla	nulla
sevilla	sevilla
subtemplate	subtemplate
nrc	nrc
seds	seds
wikibase	wikibase
isnotempty	isnotempty
swu	swu
andante	andante
philips	philips
gba	gba
พุดดิ้ง	flam
พุดดิ้ง	púding
พุดดิ้ง	pudding
utrecht	utrecht
พาโล	palo
ute	ute
mango	mango
milne	milne
theodor	theodor
uncollapsed	uncollapsed
rec	rec
kbps	kbps
lightblue	lightblue
scopus	scopus
แรงๆ	arrebossat
ttv	ttv
hina	hina
megaman	megaman
ordovician	ordovicià
ติวเตอร์	tutor
ติวเตอร์	preceptor
puma	puma
fnn	fnn
syed	syed
giotto	giotto
caretta	caretta
โป๊ป	papa
interscope	interscope
ลมกรด	baldufa
ddd	ddd
kappa	kappa
voip	voip
rotterdam	rotterdam
pargs	pargs
mein	mein
sono	sono
teatro	teatro
coauthors	coauthors
mild	lleus
mild	lleu
ลีต	leith
filmfare	filmfare
grus	grus
sco	sco
fern	falguera
ไบเบิ้ล	bíblia
annales	annales
spam	brossa
lite	lite
เทอร์โมมิเตอร์	termòmetre
cervus	cervus
honneur	honneur
schleswig	schleswig
coord	coord
futbolme	futbolme
hangman	penjat
sis	germaneta
hendrik	hendrik
carpi	carpi
rina	rina
mdi	mdi
rta	rta
otc	otc
gts	gts
faa	faa
fanny	fanny
electrophoresis	electroforesi
sartre	sartre
เลินเล่อ	negligència
kabardino	kabardino
tdi	tdi
อ่างอาบน้ำ	banyera
phylogenetic	filogenètic
checktype	checktype
ssl	ssl
streptococcus	streptococcus
atr	atr
mpc	mpc
เกบ	gabe
dst	dst
tachi	tachi
tenshi	tenshi
aql	aql
abusefilter	abusefilter
burger	burger
burger	hamburguesa
anaerobic	anaeròbia
arkive	arkive
ucl	ucl
แท็ป	aixeta
แท็ป	toca
แท็ป	tap
คาร์ลอ	carl
archaeopteryx	arqueòpterix
molly	molly
gimp	gimp
valentin	valentin
valentin	valentín
schloss	schloss
soa	soa
lindbergh	lindbergh
isis	isis
sampa	sampa
hist	hist
jacq	jacq
umts	umts
ไฟแช็ก	encenedor
wikiquote	viquidites
รังแค	caspa
getz	getz
bruxelles	bruxelles
แรนดัล	randall
miniseries	minisèrie
moments	moments
poj	poj
jabs	punxades
cribb	cribb
stenophylla	stenophylla
expedia	expedia
แม็ท	matt
hobby	hobby
hobby	passatemps
datavalue	datavalue
gaiden	gaiden
maison	maison
sar	sar
borneensis	borneensis
deutschen	deutschen
ucs	ucs
willd	willd
jojo	jojo
mainz	magúncia
csa	aca
funimation	funimation
เทท	tate
thirteen	tretze
mecha	mecha
surrealism	surrealisme
บารอมิเตอร์	baròmetre
chapelle	chapelle
leisure	lleure
ait	ait
münster	münster
île	île
alb	alb
ไลล์	lyle
ชุย	chui
bbs	bbs
geograph	geograph
beats	batecs
beats	batega
ronda	ronda
tvn	tvn
pda	pdas
pda	pda
aura	aura
pliocene	pliocè
neue	neue
rosso	rosso
eduardo	eduardo
bing	bing
iptv	iptv
mun	mun
msm	msm
chō	chō
shm	shm
ragnarök	ragnarök
fef	fef
flex	flex
atl	atl
ก้นกบ	còccix
dagestan	daguestan
pectinata	pectinata
olav	olav
hystrix	hystrix
sto	sto
skyblue	skyblue
shoujo	shoujo
lgv	lgv
ngv	ngv
latreille	latreille
angiosperm	angiosperm
ryū	ryū
ams	ams
nco	nco
centro	centro
radeon	radeon
wiesbaden	wiesbaden
ria	ria
vitis	vitis
imd	imd
บางเบา	plomes
srt	srt
nin	nin
spreng	spreng
daum	daum
pubchem	pubchem
innsbruck	innsbruck
tottenham	tottenham
tev	tev
dora	dora
mime	mime
microlepis	microlepis
peterson	peterson
cong	cong
หนักๆ	heavy
หนักๆ	pesats
หนักๆ	pesada
หนักๆ	pesant
หนักๆ	pesades
birdman	birdman
kao	kao
std	std
wolfram	wolfram
acta	acta
muller	muller
escherichia	escherichia
imax	imax
kerry	kerry
unhcr	acnur
generalized	generalitzat
qld	qld
cups	cups
cups	tasses
dnp	dnp
pars	pars
illu	illu
benn	benn
msnbc	msnbc
pong	pong
tve	tve
blink	parpelleig
kanye	kanye
sixteenth	setzena
liner	liner
iarc	iarc
magnet	imant
valeton	valeton
nrhp	nrhp
bild	bild
courbet	courbet
gbp	gbp
dct	dct
suru	suru
cooh	cooh
exodus	èxode
arthropoda	arthropoda
rvr	rvr
pocock	pocock
msj	msj
rwd	rwd
shounen	shounen
lettres	lettres
acipenser	acipenser
igf	igf
nct	nct
tabi	tabi
ora	ora
goto	goto
อัพเดท	actualitzat
pax	pax
gta	gta
ups	altes
cod	bacallà
เคเบิ้ล	cable
เลขาฯ	secretària
เลขาฯ	secretari
deutschland	deutschland
lisbon	lisboa
haeckel	haeckel
topographic	topogràfic
tbm	tbm
minna	minna
เมี้ยว	miau
gamepad	gamepad
dyk	dyk
livre	livre
zita	zita
ไซปัน	saipan
jnn	jnn
gesellschaft	gesellschaft
cdu	cdu
fernandez	fernandez
fernandez	fernández
kunth	kunth
transcluded	transcluded
mir	mir
girard	girard
medien	medien
bismuth	bismut
cronquist	cronquist
droit	droit
korn	korn
mainichi	mainichi
econ	econ
michele	michele
dickson	dickson
taxoboxes	taxoboxes
nok	nok
apec	apec
pou	pou
ญาติๆ	familiars
ญาติๆ	parents
salvelinus	salvelinus
toolserver	toolserver
köln	köln
nnn	nnn
hotspur	hotspur
nabla	nabla
zimmermann	zimmermann
église	église
ชอปปิ้ง	compres
ชอปปิ้ง	shopping
citrate	citrat
superfamilia	superfamilia
miramax	miramax
bom	atlantico
bom	bom
dsrna	dsrna
กรีส	grease
dbd	dbd
ยอร์ด	york,
sirna	sirna
uru	uru
kuniyoshi	kuniyoshi
ksa	ksa
ocellatus	ocellatus
siècle	siècle
เบย	bae
berghahn	berghahn
cfa	cfa
crocodylus	crocodylus
ไมโล	milo
ichigo	ichigo
ano	ano
musique	musique
vim	vim
quantitative	quantitatiu
quantitative	quantitatius
dtv	dtv
kirchner	kirchner
lour	lour
เปียนโน	piano
dlc	dlc
utagawa	utagawa
ดอยช์	deutsche
slalom	eslàlom
slalom	slalom
sina	sina
macbook	macbook
sac	sac
pseudomonas	pseudomonas
unitary	unitari
ferreira	ferreira
ดินเนอร์	sopar
michi	michi
mazda	mazda
ไกส์	skype
garman	garman
mimi	mimi
singha	singha
nenets	nenets
avatar	avatar
yaroslavl	iaroslavl
bokura	bokura
omim	omim
ssc	ssc
fcb	fcb
accademia	accademia
powerpc	powerpc
coe	coe
pennsylvanian	pennsylvanian
อุทาหรณ์	paràbola
wikinews	viquinotícies
ย่อมเยา	assequibles
ย่อมเยา	assequible
yuán	yuán
chitra	chitra
dvořák	dvořák
shinsengumi	shinsengumi
เลอะเทอะ	barrejat
barincrement	barincrement
botanic	botanic
taxon	tàxon
cta	cta
fai	fai
petite	petite
broker	broker
continuum	continu
fia	fia
ซิการ์	cigar
adb	adb
valencian	valencià
ดรอป	llença
ดรอป	gota
rodentia	rodentia
electronegativity	electronegativitat
pfeil	pfeil
henrik	henrik
hoang	hoang
การขนส่งมวลชน	transit
loc	loc
angiosperms	basals
bonn	bonn
เมกะเฮิรตซ์	mhz
sixteen	setze
บังตา	encegat
khabarovsk	khabàrovsk
nadph	nadph
tensor	tensor
emedicine	emedicine
นู่	nuh
heidelbergensis	heidelbergensis
กระเด้ง	rebota
ขาอ่อน	cuixes
dns	dns
ttl	ttl
นรีแพทย์	ginecòleg
cristatus	cristatus
acn	acn
adagio	adagio
แชท	xat
mcfarland	mcfarland
africanus	africà
vishwanath	vishwanath
moo	moo
zap	zapping
sma	sma
buryatia	buriàtia
เอเย่นต์	agent
seurat	seurat
oed	oed
mississippian	mississippian
msu	msu
ตูส	stu
shockley	shockley
germplasm	germplasm
infraclassis	infraclassis
lemonchiffon	lemonchiffon
rechts	rechts
outdoor	outdoor
outdoor	alella
polydor	polydor
intermedia	intermedia
influenzae	influenzae
barbus	barb
barbus	barbus
sardinella	sardinella
treme	treme
imc	imc
เปเป	pepe
เปเป	perú
เปเป	peru
hodder	hodder
bodyguard	guardaespatlles
nfc	nfc
samba	samba
dreamworks	dreamworks
wikiversity	wikiversity
raion	raion
niloticus	niloticus
minimal	mínima
minimal	mínims
ntsc	ntsc
sop	sop
csd	csd
eaba	eaba
viz	viz
torii	torii
csu	uec
mcv	mcv
casio	casio
barron	barron
bopp	bopp
özil	özil
subunit	subunitat
gaba	gaba
ช๊อค	xoc
yami	yami
เตารีด	planxa
เตารีด	ferro
coturnix	coturnix
prefectural	prefectural
subphylum	subfílum
reine	reine
governorate	governació
göttingen	göttingen
atk	atk
hohenzollern	hohenzollern
saya	saya
หวานๆ	dolç
หวานๆ	dolços
หวานๆ	dolça
urs	urs
upn	upn
micky	micky
tyrosine	tirosina
céline	céline
theropoda	teròpode
tuva	tuvà
dunam	dunam
cgmp	cgmp
lexikon	lexikon
dmc	dmc
montréal	montréal
vue	fue
spica	spica
bara	bara
vin	vin
gpp	gpp
pedophilia	pedofília
humboldt	humboldt
nike	nike
เนธาน	nathan
abdulrahman	abdulrahman
iter	iter
cava	cava
paleocene	paleocè
ops	ops
nisi	nisi
enim	enim
blackberry	blackberry
blackberry	móra
โชคลาง	supersticiós
marius	marius
tapirus	tapirus
oligocene	oligocè
bsc	bsc
cbn	cbn
regio	regio
บังกะโล	bungalows
บังกะโล	bungalow
mps	mps
hrsg	hrsg
นิกิ	niki
ซื่อๆ	ingenu
rip	rip
smtp	smtp
brachii	braquial
sus	sus
pedersen	pedersen
utd	utd
dag	dag
torr	torr
pang	pang
ngn	ngn
đức	đức
motogp	motogp
palermo	palerm
meryl	meryl
เบลิซ	belize
vojvodina	voivodina
buchholz	buchholz
abbaye	abbaye
dukes	ducs
parque	parque
rondo	rondo
amr	amr
truss	truss
moma	moma
sachsen	sachsen
เหยาะ	yao
villosa	villosa
rambur	rambur
joanna	joanna
iglesias	iglesias
toroid	toroide
mobygames	mobygames
uncredited	uncredited
augsburg	augsburg
historiography	historiografia
kyi	kyi
wmflabs	wmflabs
sdb	sdb
primetime	primetime
outre	outre
zaw	zaw
องคชาติ	penis
danser	danser
nsw	nsw
hussain	hussain
tempor	tempor
neanderthalensis	neanderthalensis
acs	acs
cng	cng
nail	deté
wimax	wimax
