serena	सेरेना
malus	malus
cessna	cessna
across	आरपार
quest	क्वेस्ट
kangaroo	कंगारू
chrome	क्रोम
chrome	chrome
ismail	इस्माईल
saratoga	साराटोगा
irkutsk	इरकुत्स्क
liếm	लिक
isla	इस्ला
lancashire	लंकाशायर
albedo	ऐल्बीडो
infinite	अनगिनत
infinite	अनंत
infinite	असीमित
infinite	अनन्त
myspace	माईस्पेस
buri	buri
saab	saab
saab	साब
gloucester	gloucester
hamburger	हैमबर्गर
sarajevo	साराजेवो
res	res
marvin	मारविन
lift	लिफ़्ट
lift	वृद्धि
lift	लिफ्ट
inn	सराय
inn	inn
inn	इन
sonny	सन्नी
esp	ईएसपी
encyclopædia	ब्रिटैनिका
gore	गोर
donna	डोना
yai	yai
yai	यै
halle	हैल
checkuser	checkuser
alston	एल्स्टन
gap	अंतर
gap	गैप
tirana	तिराना
karelia	कारेलिया
hàu	सीप
erie	erie
ogg	ogg
adriatic	एड्रियाटिक
viva	चिरायु
cafe	कॉफ़ी
cafe	कॉफी
cafe	कैफ़े
assassin	हत्यारे
farm	खेत
farm	फ़ार्म
farm	फार्म
kwang	क्वांग
vanilla	गरज
vanilla	थंडर
vanilla	वैनिला
société	société
extreme	चरम
bun	बुल्गारियाई
bun	बूलियन
bun	बुलियन
bun	बन
auschwitz	auschwitz
multi	मल्टी
newark	न्यूर्क
woody	वुडी
fat	वसा
fat	मोटी
fat	स्थूल
fat	मोटा
fat	मोटे
corleone	कोरलियॉन
mẹo	युक्तियाँ
mẹo	सुझाव
mẹo	टिप्स
mẹo	नुस्ख़े
mẹo	युक्ति
mẹo	टिप
metropolitana	metropolitana
haw	haw
wilde	वाइल्ड
glycine	glycine
plato	प्लेटो
olympus	ओलम्पस
tashkent	ताशकंद
hcl	hci
lex	लेक्स
fukushima	फुकुशिमा
episodes	धारावाहिक
episodes	एपिसोड
episodes	एपीसोड
herb	औषधि
herb	हर्ब
nicola	निकोला
burgundy	बरगंडी
bleach	ब्लीच
stub	स्टब
avengers	avengers
weiss	वेइस
rousseau	रूसो
mecca	मक्का
switch	स्विच
herald	हेराल्ड
melanie	मेलानी
holloway	होलोवे
tama	तम
muse	चिंतन
chamberlain	चेम्बरलेन
gala	गाला
kazakh	कज़ाख़
bye	बाय
bye	bye
bye	अलविदा
cằm	चिन
cằm	ठोड़ी
cằm	chin
pioneer	अग्रगामी
pioneer	पायोनियर
paula	पाउला
imdb	आईएमडीबी
romano	romano
wizard	विज़ार्ड
wizard	विजार्ड
wizard	जादूगर
yom	योम
damian	डेमियन
bedford	bedford
haifa	हाइफ़ा
armavir	अर्मावीर
bor	bor
cash	नकद
cash	cash
cash	नकदी
runner	रनर
runner	धावक
twilight	गोधूलि
hispaniola	हिस्पानिओला
dorsalis	dorsalis
entropy	एन्ट्रॉपी
voltaire	वोल्टेयर
mask	मास्क
mask	नकाब
mask	मुखौटा
merton	merton
coa	किए
asparagus	शतावर
salmon	सामन
dahl	dahl
nhả	release
nhả	रिलीज़
nhả	रिलीज
charlemagne	शारलेमेन
thùa	agave
heathrow	हीथ्रो
jenkins	जेनकींस
minneapolis	मिनियापोलिस
pack	पैक
shorea	shorea
tbd	tbd
machado	machado
lions	शेर
buckingham	बकिंघम
kitty	किटी
kitty	किट्टी
samara	समारा
petersen	petersen
mona	मोना
mona	mona
elsa	एल्स
baba	baba
baba	बाबा
ost	ost
backstreet	बैकस्ट्रीट
spielberg	स्पिलबर्ग
kana	काना
coventry	coventry
lathyrus	lathyrus
pbs	pbs
lhasa	ल्हासा
ito	ito
calvert	calvert
polymer	पॉलिमर
nolan	नोलन
fitzgerald	fitzgerald
mama	मामा
romeo	रोमियो
meet	मिलें
alexis	एलेक्सिस
radiata	radiata
espiritu	espiritu
kin	kin
greenwich	ग्रीनविच
usaf	यूएसएएफ
revue	revue
titus	टाइटस
hayek	हायेक
messenger	messenger
messenger	मैसेंजर
messenger	मेसेंजर
por	पोर
lagos	लागोस
stream	धारा
stream	स्ट्रीम
petra	पीट्रा
sikorsky	sikorsky
ngẫm	चबा
ensign	ensign
sio	sio
ericsson	ericsson
phalanx	व्यूह
gerard	जेरार्ड
yerevan	येरेवन
cast	कास्ट
cast	डाल
boca	boca
nếm	taste
nếm	स्वाद
nếm	चखना
nếm	चख
ski	स्की
dhaka	ढाका
framework	फ्रेमवर्क
seem	सेम
amour	amour
amor	amor
zara	ज़रा
zara	ज़ारा
richelieu	रिचलू
michele	मिशेल
swansea	स्वान्ज़ी
guadalupe	guadalupe
españa	españa
mendoza	मेंडोज़ा
judo	जूडो
sira	सिरा
myung	म्युंग
tunis	ट्यूनिस
nigel	निगेल
sue	सू
sue	मुकदमा
garfield	गारफ़ील्ड
texte	texte
aff	aff
alicia	एलिसिया
registry	रजिस्ट्री
eindhoven	आइंटहॉवन
archipelago	द्वीपसमूह
jedi	जेडी
iglesias	इग्लेसियस
nirvana	निर्वाण
harley	हार्ले
wanted	चाही
survivor	उत्तरजीवी
gauge	गेज
reno	रेनो
suu	suu
nháp	प्रारूप
nháp	ड्राफ़्ट
nháp	मसौदा
nháp	ड्राफ्ट
chát	harsh
chát	हर्ष
chát	चैट
chát	गपशप
lahore	लाहौर
melody	राग
sterling	स्टर्लिंग
chambers	कक्षों
mari	मारी
mari	मरी
mari	mari
sikh	सिख
sikh	सिखों
sikh	पगड़ी
ivy	आइवी
northampton	नॉर्थम्प्टन
penaltyscore	penaltyscore
judith	जूडिथ
constantius	constantius
shirley	शर्ली
nairobi	नैरोबी
cate	केट
cate	कैटलिन
xui	अशुभ
lou	लू
advance	एडवांस
advance	अग्रिम
pulitzer	पुलित्जर
pocket	जेब
akbar	अकबर
akbar	akbar
sandra	सैंड्रा
krasnoyarsk	क्रस्नोयार्स्क
buch	buch
interwiki	interwiki
acad	acad
angry	गुस्सा
angry	क्रोधित
angry	एंग्री
lisboa	लिस्बन
cotton	सूत
cotton	कपास
stamford	stamford
klm	klm
kansai	कन्साई
oval	ओवल
marca	मार्का
lineatus	lineatus
mannheim	mannheim
everest	एवरेस्ट
nationale	nationale
mpeg	एमपीईजी
atm	atm
atm	एटीएम
deutsch	deutsch
cantor	cantor
lamb	मेमना
lamb	मेमने
bray	ब्रे
giỏ	जेब
giỏ	टोकरी
giỏ	बास्केट
sap	अर्क
sap	sap
lauren	लॉरेन
marta	marta
tạt	सरसों
ars	ars
iana	iana
hana	हाना
tristan	ट्रिस्टन
howe	होवे
saunders	सांडर्स
wyatt	व्याट
katherine	कैथरीन
manitoba	मनिटोबा
cật	गुर्दे
eliot	एलियट
tea	चाय
teddy	टेडी
breaking	तोड़ने
breaking	ब्रेकिंग
breaking	तोड़कर
othername	othername
alien	एलियन
raja	raja
raja	राजा
lydia	लीडिया
fun	मज़ा
fun	मनोरंजक
fun	मज़ेदार
fun	मस्ती
fun	मजा
jungle	जंगल
lorenz	एकम
hillary	हिलेरी
wolfram	टंगस्टन
clermont	clermont
dalton	डाल्टन
gottfried	गॉटफ्राइड
stephens	स्टीफंस
genie	जिनी
mangan	मैंगनीज
bluetooth	ब्लूटूथ
compton	कॉम्पटन
mgm	mgm
brock	ब्रॉक
conway	कॉनवे
msn	एमएसएन
schuster	शूस्टर
fleming	फ्लेमिंग
rodrigues	रोड्रिग्स
snyder	स्नाइडर
glucose	ग्लूकोज
credit	श्रेय
credit	क्रेडिट
carrie	कैरी
classics	क्लासिको
classics	क्लासिक
axel	एक्सेल
daimyo	दाईम्यो
rầy	डांट
punic	प्यूनिक
novosibirsk	नोवोसिबिर्स्क
galápagos	गैलापागोस
frost	तुषार
utrecht	utrecht
herschel	हर्शेल
wiltshire	विल्टशायर
jacqueline	जैकलिन
café	कैफ़े
freiburg	freiburg
sui	सुई
sui	sui
nikita	निकिता
dudley	dudley
pleasant	सुहाना
pleasant	सुहावना
pleasant	सुखद
davy	डेवी
điếc	बहरे
điếc	बहरा
lupus	lupus
concept	अवधारणा
neu	neu
casino	कैसीनो
casino	कसीनो
sami	सामी
marilyn	मर्लिन
morebits	morebits
hyde	हाइड
cabin	केबिन
simone	सिमोन
rệp	खटमल
rệp	बग्स
rệp	बग
sina	सिना
wallis	वालिस
jericho	जेरिको
thatcher	थैचर
vandal	vandal
khz	khz
ying	यिंग
zip	जिप
zip	ज़िप
zip	zip
arthropoda	arthropoda
nal	nal
fermat	फर्मा
colt	टट्टू
clarence	क्लेरेंस
watt	वॉट
watt	वाट
yoko	योको
bomb	बम
bomb	बमों
bomb	बमबारी
jerzy	जर्ज़ी
koi	कोई
pole	ध्रुव
judy	जुडी
neue	neue
astronomy	खगोलशास्त्र
mầu	रंग
poker	पोकर
shaun	शॉन
higgins	हिगिंस
tal	tal
aya	आया
aya	अया
nevis	नेविस
inermis	inermis
internazionale	internazionale
vẫy	हिलाता
meade	meade
dorothy	डोरोथी
mcmahon	मैकमोहन
hartley	हार्टले
epstein	epstein
jobs	जॉब
jobs	नौकरियां
jobs	नौकरियाँ
jobs	कार्य
safari	सफारी
safari	safari
atr	एटीआर
som	सोम
pictus	pictus
gutenberg	गुटेनबर्ग
guild	श्रेणियों
guild	श्रेणियाँ
guild	गिल्ड
novo	नोवो
vita	वीटा
nantes	nantes
stay	रहें
stay	रहो
panthera	पेंथेरा
worms	कीड़े
worms	कीड़ों
tripura	त्रिपुरा
enrico	एनरिको
mei	mei
nháy	फ़्लैश
nháy	फ्लैश
nháy	बैटिंग
nháy	बल्लेबाजी
alfredo	अल्फ्रेडो
dayton	डेटन
hispida	hispida
superman	सुपरमैन
corbett	कॉर्बेट
champ	चैम्पियन
champ	champ
bowditch	bowditch
saints	संतों
saints	संत
saints	संतो
kochi	कोचीन
kochi	कोच्चि
aves	aves
jerome	जेरोम
rapunzel	रॅपन्ज़ेल
gupta	गुप्ता
gupta	गुप्त
nomen	nomen
trọc	गंजे
trọc	गंजा
als	als
meiji	मेइजी
sạc	चार्जर
sạc	प्रभार
sạc	चार्ज
sạc	चार्जिंग
imax	imax
fossil	खनिज
fossil	जीवाश्म
fossil	चट्टान
bart	बार्ट
rightarm	rightarm
karachi	कराची
karachi	करानी
suvarnabhumi	suvarnabhumi
commonwealth	राष्ट्रमंडल
cactus	कैक्टस
bourne	बोर्न
dakshina	दक्षिणा
esther	एस्थर
leroy	लेरॉय
callas	कैलस
lester	लेस्टर
biswas	बिस्वास
carson	कार्सन
ichi	इची
doug	डग
amanita	amanita
alpine	अल्पाइन
sicily	सिसिली
cream	क्रीम
cream	मलाई
antony	एंटोनी
reeves	रीव्स
finn	फिन
cassette	कैसेट
laplace	लाप्लास
argentea	argentea
ufo	ufo
sioux	सू
mendes	मेंडिस
cristiano	क्रिस्टियानो
aberdeen	एबरडीन
sprague	स्प्रेग
platinum	प्लैटिनम
platinum	प्लेटिनम
wikitable	wikitable
gfdl	gfdl
savoy	savoy
nervosa	नर्वोज़ा
trip	यात्रा
trip	ट्रिप
morocco	मोरक्को
vít	पेंचकस
garde	कसी
trois	trois
tara	tara
shia	शिया
kwazulu	kwazulu
guthrie	गथरी
eclipse	ग्रहण
tap	प्रतियोगी
penalty	पेनल्टी
penalty	दंड
sts	एसटीएस
pinyin	पिनयिन
brandon	ब्रैंडन
hoover	हूवर
foo	फू
sida	aids
sida	एड्स
sutton	सटन
zoom	ज़ूम
zoom	जूम
flynn	flynn
lover	प्रेमी
honshu	होन्शू
superba	superba
tor	tor
tor	तूर
tor	तोर
tor	थोर
capo	capo
dallwitz	dallwitz
rụi	कुचल
blyth	blyth
orient	प्राची
romanov	romanov
eaton	eaton
lakes	झीलें
lakes	झीलों
suharto	सुहार्तो
aspera	aspera
natalia	नतालिया
salazar	salazar
gmbh	gmbh
abrams	abrams
giles	जाइल्स
whole	पूरी
whole	पूरा
whole	पूरे
aid	सहायता
râm	छाया
râm	शेड
milwaukee	मिल्वौकी
edith	एडिथ
indianapolis	इंडियानापोलिस
noah	नूह
caucasus	काकेशस
gillespie	गिलेस्पी
lynx	लिंक्स
ayuntamiento	ayuntamiento
app	ऐप
app	एप्लिकेशन
app	app
presley	प्रेस्ली
brook	ब्रुक
vhs	vhs
troll	ट्रोल
osiris	ओसिरिस
cassius	कैसियस
sora	sora
ethernet	ईथरनेट
peso	पेसोस
peso	पेसो
shock	सदमे
shock	झटका
shock	शॉक
tutu	टूटू
serviceyears	serviceyears
nhử	प्रलोभन
nhử	लुभाने
bend	बेंड
artiodactyla	artiodactyla
caldwell	काल्डवेल
fusion	संलयन
xoang	साइनस
coffee	कॉफ़ी
coffee	कॉफी
task	कार्य
bak	बाक
sulfat	सल्फेट
pla	pla
iroquois	इरक्वॉइ
rivers	नहरें
rivers	नदियाँ
flemish	फ्लेमिश
sorex	shrew
edición	edición
legion	लीजन
ala	अला
ala	आला
ala	ala
cctld	cctld
itf	आईटीएफ
dash	डैश
isis	आईएसआईएस
isis	isis
trek	ट्रेक
pizza	पिज्जा
pizza	पिज़्ज़ा
shikoku	शिकोकू
cobra	कोबरा
unicef	यूनिसेफ
dee	dee
rsa	आरएसए
hockey	हॉकी
xỉn	शराबी
xỉn	नशे
bow	धनुष
sars	सार्स
cristatus	cristatus
vic	विक
nico	निको
fed	खिलाया
nizhny	nizhny
trevor	ट्रेवर
sherlock	शर्लक
avatar	अवतार
sinatra	सिनात्रा
ivanov	इवानोव
chhattisgarh	छत्तीसगढ़
julio	जूलियो
ricky	रिकी
reader	पाठक
reader	रीडर
fortune	भाग्य
fortune	सौभाग्य
doo	डू
faraday	फैराडे
tate	टेट
rand	रैंड
rand	गोल
baird	बेयर्ड
rubin	रुबिन
cana	काना
lesnar	lesnar
rowling	रोलिंग
rapid	द्रुत
rapid	रैपिड
potosí	पोतोसी
clyde	क्लाइड
kiribati	किरिबाती
beverly	बेवर्ली
goodman	गुडमैन
cowboy	चरवाहे
cowboy	काउंटी
samantha	सामन्था
analog	एनालॉग
kei	केई
kerry	केरी
muller	मुलर
ramón	रामोन
ramón	रेमन
merry	मैरी
chirac	शिराक
pagan	काफिर
ria	रिया
olivia	ओलिविया
mem	mem
mem	मेम
dodge	मोड
dodge	चकमा
spike	स्पाइक
augustine	अगस्टाइन
gangnam	गंगनम
horizonte	होरिज़ोंटे
cdma	cdma
aruba	अरूबा
hawkins	हॉकिन्स
burt	बर्ट
communis	communis
sala	sala
olive	जैतून
olive	ज़ैतून
tuva	तूवा
kitts	किट्स
magellan	मॅजलॅनिक
equus	equus
dốt	अज्ञानी
calgary	कैलगरी
calgary	कैला
jena	जेना
gol	gol
murad	मुराद
malik	मलिक
malik	malik
escape	एस्केप
salon	सैलून
salon	सैलून
durban	डरबन
lama	लामा
oswald	ओसवाल्ड
mara	mara
mara	मारा
bikini	बिकनी
bikini	बिकिनी
mika	मिका
ocimum	ocimum
maggie	मैगी
jürgen	य़ुएर्गेन
siết	हग
siết	निचोड़
visa	वीजा
visa	वीसा
visa	वीज़ा
button	बटन
duc	duc
alger	शैवाल
gong	गोंग
subtemplates	subtemplates
gerd	गर्ड
qantas	क्वांटास
pet	पालतू
pet	पालतु
pet	बुद्धि
pet	इंटेलिजेंस
pet	खुफिया
pet	बुद्धिमत्ता
pet	प्रज्ञा
drum	ड्रम
drum	ढोल
daewoo	देवू
merino	मेरिनो
martini	मार्टिनी
clarkson	क्लार्कसन
varna	varna
amman	अम्मान
nazi	फासिस्ट
nazi	नाजी
tul	तुल
tởm	घृणास्पद
tởm	घृणित
brazilian	ब्राज़ीलियाई
khabarovsk	ख़ाबारोव्स्क
creed	पंथ
atra	अत्र
trail	ट्रेल
bosco	बोस्को
lipid	लिपिड
billie	बिली
chaos	अव्यवस्था
chaos	अराजकता
umbrella	छाता
umbrella	छतरी
umbrella	छतरियाँ
candida	candida
karaoke	कराओके
oskar	oskar
ebert	ebert
textcolor	textcolor
aziz	अज़ीज़
aziz	अजीज
ping	पिंग
marin	मारिन
nazareth	नासरत
abs	abs
abs	एबीएस
keller	केलर
boyle	बॉयल
nod	आज्ञा
nod	सम्मति
nod	हुक्म
nod	तकलीफ
spot	स्पॉट
cctv	cctv
cctv	सीसीटीवी
dar	dar
dar	दार
garrulax	laughingthrush
matter	मैट्स
herodotus	हिरोडोटस
vidal	विडाल
jaya	जय
jaya	जया
jaya	jaya
melissa	मेलिसा
tar	tar
tar	तारकोल
riemann	रीमान
tribune	ट्रिब्यून
aden	अदन
erectus	इरेक्टस
uppsala	उप्साला
juliet	जूलियट
elias	एलियास
angus	एंगस
horus	होरस
cas	कैस
hamas	हमास
idf	idf
systematics	systematics
guillermo	गुलिरमो
mchenry	मैकहेनरी
palmyra	palmyra
rutherford	रदरफोर्ड
loc	loc
jansen	जानसन
ishikawa	इशिकावा
poincaré	पांकरे
wadi	wadi
cunningham	कनिंघम
dyer	डायर
vogue	प्रचलन
embraer	एमब्रेयर
xíu	नन्हा
xíu	छोटा
atlantis	अटलांटिस
dewey	डिवी
capra	capra
barbuda	बारबूडा
zenit	जेनिट
margarita	मार्गरिटा
soto	सोटो
dreamworks	ड्रीमवर्क्स
charter	चार्टर
geoff	ज्यॉफ
autobiography	आत्मकथा
bark	छाल
mêtan	मिथेन
guru	गुरु
guru	गुरू
sanders	सैंडर्स
aztec	एज़टेक
spy	उल्टी
nikolay	निकोलय
bengalensis	bengalensis
stereo	स्टीरियो
fermi	फर्मी
lance	lance
lance	लांस
lance	तलवार
benoy	बिनय
jatropha	जत्रोफा
dal	दाल
vladivostok	व्लादिवोस्तोक
vida	विदा
nora	नोरा
geum	गयूम
blogger	ब्लॉगर
blogger	ब्लॉग
stephanie	स्टेफ़नी
bing	bing
kgb	केजीबी
kaga	कागा
chapel	चैपल
marais	मराइस
confederations	confederations
spice	स्पाइस
spice	मसाला
pires	पायर्स
octopus	ऑक्टोपस
octopus	अष्टभुज
acb	acb
khít	पैडिंग
khít	पैकिंग
sink	जिंक
sink	जस्ता
nubia	नुबिया
cinnyris	सनबर्ड
bohol	बोहोल
harmony	सद्भाव
harmony	समरसता
harmony	सदभावना
harmony	सामंजस्य
diaz	डियाज़
vầng	सुनहरा
vầng	गोल्डन
vầng	सुनहरी
tostring	tostring
gui	जीयूआई
odyssey	भ्रमण
odyssey	ओडिसी
ngo	ngo
kuiper	kuiper
progressive	प्रगतिशील
davidson	डेविडसन
hammond	हैमंड
hastings	हास्टिंग्स
gaya	gaya
fairfield	फेयरफील्ड
fairchild	fairchild
consolidated	संचित
boyer	बोएर
găm	ख़ंजर
ava	आवा
riyadh	रियाद
booth	बूथ
cristina	क्रिस्टीना
plc	पीएलसी
negro	नीग्रो
rum	रम
rum	rum
argus	argus
leibniz	लैबनिट्ज़
paralympic	पैरालम्पिक
authorlink	authorlink
mahmoud	महमूद
gorky	गोर्की
steam	भाप
phoenicia	फ़ोनीशिया
spa	spa
spa	स्पा
spa	स्पा
addis	अदीस
huntington	हटिंगटन
belowstyle	belowstyle
vijaya	विजया
styles	शैलियाँ
pool	pol
boyd	boyd
tornado	आंधी
tornado	बवंडर
vin	विन
dmt	डीएमटी
keane	कीन
chorus	कोरस
maluku	मालुकू
lone	लोन
paso	पासो
dolly	डॉली
kramer	क्रेमर
wushu	वुशु
rae	rae
genesis	उत्पत्ति
corinth	कोरिंथ
nissan	निसान
mir	मीर
dagestan	दाग़िस्तान
fernandez	फर्नांडीज
gustaf	गुस्टाफ
peterson	पीटरसन
hường	फ्यूशिया
reuters	रॉयटर्स
rình	शिकारी
officinalis	officinalis
nach	नच
aix	aix
gpl	जीपीएल
hodgson	hodgson
josep	josep
clifford	क्लिफर्ड
worlds	संसार
providence	विधाता
psp	psp
generic	जेनरिक
generic	जेनेरिक
emberiza	bunting
ploceus	बया
carlton	कार्लटन
sampson	sampson
daniels	डैनियल्स
papa	पापा
sha	शा
brady	ब्रैडी
identity	पहचान
launch	लांच
launch	लॉन्च
telescope	दूरदर्शी
destroyer	ध्वनिक
destroyer	विनाशक
collapsible	collapsible
rodgers	रोजर्स
dolphin	डॉल्फ़िन
swing	स्विंग
swing	झूले
aegean	ईजियन
kern	कर्न
martins	मार्टिंस
gdi	gdi
buena	buena
aleksey	एलेक्सी
squad	दस्ता
squad	दस्ते
squad	स्क्वाड
coleman	कोलमैन
baikal	बैकाल
oro	oro
oro	ओरो
khartoum	खार्तूम
steiner	स्टेनर
steroid	स्टेरॉयड
scene	यूएमएल
dakar	डकार
ipod	ipod
atkinson	एटकिन्सन
abd	अब्द
packard	पैकर्ड
arlington	आर्लिंगटन
exeter	एक्सेटर
fax	फैक्स
brotherhood	भाईचारा
brotherhood	भाईचारे
tampa	tampa
stevie	स्टीवी
siegfried	siegfried
banda	बाँदा
banda	banda
banda	बांदा
vat	वट
vat	vat
vat	भीग
vat	गीली
vat	वेट
vat	गीला
madame	मेडम
quito	क्विटो
hades	हेडीस
dominic	डोमिनिक
sook	सोक
chelyabinsk	चेल्याबिंस्क
hague	हेग
astoria	एस्टोरिया
pskov	pskov
satan	शैतान
satan	शैतानी
arch	चाप
arch	मेहराब
groupstyle	groupstyle
liam	लियाम
sylvester	सिलवेस्टर
tiffany	टिफ़नी
braga	ब्रागा
horace	होरेस
plutarch	प्लूटार्क
mathias	मैथियास
hilary	हिलेरी
hilary	हिलेरी
mel	mel
nest	घोसला
nest	घोंसला
dress	सूट
aureus	aureus
guevara	ग्वेरा
uranium	यूरेनियम
pinto	पिंटो
claus	क्लॉस
avec	avec
daisy	डेज़ी
katie	केटी
anthus	pipit
léopold	लियोपोल्ड
arabica	arabica
seljuk	सलजूक़
rubik	घन
osborne	ओसबोर्न
entre	entre
proxima	प्रॉक्सिमा
reese	रीज़
natasha	नताशा
ribbon	फीता
ribbon	रिबन
pali	पाली
boer	बोअर
nhọ	अशुभ
nhọ	कालिख
belgorod	बेल्गोरोद
owl	उल्लू
molly	मोल
bieber	बीबर
soprano	सोप्रानो
cdc	सीडीसी
sanskrit	संस्कृत
yao	याओ
crash	क्रेश
crash	क्रैश
ulus	ulus
aki	अकी
pycnonotus	बुलबुल
fragrans	fragrans
hardcover	सजिल्द
challenger	चैलेंजर
ribosome	राइबोसोम
balboa	बाल्बोआ
helmuth	helmuth
cska	सीएसकेए
stirling	स्टर्लिंग
duffy	डफी
terrier	टेरियर
krupp	क्रुप
sulfuric	sulfuric
seasons	मौसम
seasons	सीज़न
osman	उस्मान
hasan	हसन
karabakh	काराबाख़
lte	lte
vẩn	बकवास
meshid	meshid
ppm	ppm
patel	patel
patel	पटेल
clan	गोत्र
prado	प्राडो
markov	markov
oecd	oecd
freud	फ्रायड
emilio	एमिलियो
asiatica	asiatica
taiga	ताइगा
loop	पाश
loop	लूप
cordifolia	cordifolia
mayo	मेयो
rfa	nrc
tatarstan	तातारस्तान
vip	vip
vip	वीआईपी
locke	locke
naga	नागा
garland	माला
lycée	लीसे
maple	मेपल
tau	ताऊ
miocene	miocene
booker	बुकर
lure	प्रलोभन
lure	लुभाने
raphael	राफेल
ipairs	ipairs
designations	designations
gurion	गुरियन
ami	अमी
colonial	औपनिवेशिक
zulu	ज़ुलू
pub	पब
platon	प्लेटो
khon	खोन
mccarthy	मैकार्थी
sal	सल
sal	sal
fin	जोडे
ulmus	elm
daimler	डेमलर
mora	mora
pyrenees	pyrenees
pyrenees	pyrénées
kremlin	क्रैमलिन
griffith	ग्रिफ़िथ
suisse	सुइस
everett	everett
khalid	खालिद
mercy	मेहरबानी
mercy	दया
mercy	रहमत
grenadines	grenadines
scarlet	स्कारलेट
jaguar	जैगुआर
mathieu	mathieu
gastropoda	उदरपाद
firefly	जुगनू
mcpherson	मैकफर्सन
em}}	i}}
rận	जूँ
rận	जूं
rolf	rolf
dartmouth	डार्टमाउथ
luiz	लुइज़
himachal	हिमाचल
himachal	himachal
mamluk	ममलूक
miura	miura
gar	gar
gar	गर
sverdlovsk	sverdlovsk
calcutta	कलकत्ता
hystrix	साही
northumberland	नॉर्थम्बरलैंड
hollow	खोखला
ipad	आईपैड
ipad	ipad
fifth	पंचम
fifth	पाँचवा
fifth	पांचवा
fifth	पांचवां
pauli	पौली
schlegel	schlegel
isa	isa
gpu	gpu
trent	ट्रेंट
alamos	alamos
lodge	लॉज
lodge	आवास
willie	विली
anita	अनीता
nietzsche	नीत्शे
blitzkrieg	ब्लिट्जक्रेग
vđv	एथलीट
stafford	स्टेफोर्ड
cocktail	कॉकटेल
hiro	hiro
pamela	पामेला
badami	बादामी
minerva	मिनर्वा
diffusa	diffusa
audrey	ऑड्रे
luanda	लुआंडा
odorata	odorata
kumar	kumar
kumar	कुमार
loki	लोकी
perm	पर्म
wta	पहियों
wichita	wichita
thin	पतली
thin	पतला
sql	एसक्यूएल
brooke	ब्रुक
tanh	साटन
elk	नीलगाय
rubens	rubens
anguilla	एंगुइला
toby	टोबी
nitric	नाइट्रिक
chennai	चेन्नई
chennai	चेन्नै
jfk	jfk
byzantium	byzantium
surat	सुरत
surat	सूरत
geisha	गीशा
gale	झोंका
eddy	भँवर
eddy	eddy
magdeburg	मागदेबुर्ग
dinar	दीनार
dinar	दिनार
wittelsbach	wittelsbach
damon	डैमन
crusader	जेहादी
expo	एक्सपो
tráp	फंदा
banksia	बैंकसिया
vince	विंस
barber	नाई
bos	bos
danish	डेनिश
danish	दानिश
danish	डैनिश
omaha	ओमाहा
cologne	कोलोन
meson	मेसॉन
stdinchi	stdinchi
mönchengladbach	मौनचेंगलाडबाख
kimura	किमुरा
ferox	ferox
sqm	वर्गमीटर
samson	सैमसन
tulip	ट्यूलिप
mergedtoprow	mergedtoprow
luxemburg	लुक्सेम्बुर्ग
gmail	श्रेय
gmail	क्रेडिट
gmail	जीमेल
xyanua	साइनाइड
gradient	ढाल
gradient	अनुपात
cosmos	ब्रह्मांड
cellspacing	cellspacing
britannia	britannia
adda	अड्डा
plains	मैदान
nusa	नुसा
kamchatka	कमचातका
civic	नागरिक
basil	तुलसी
basil	बेसिल
marxist	मार्क्सवादी
oleg	oleg
willy	विली
shiro	शिरो
maori	माओरी
fips	fips
pygmy	सानो
furious	क्रोधित
maki	माकी
shuttle	शटल
serge	सर्ज
stdinchikey	stdinchikey
xịt	हैट
xịt	था
duff	डफ़
roc	आरओसी
bunker	बंकर
strabo	स्ट्रैबो
selen	सेलेनियम
còng	कफ
tome	टोम
brutus	ब्रूटस
nicobar	निकोबार
cliff	चट्टान
bernstein	बर्नस्टीन
eagles	ईगल्स
morse	मोर्स
lympho	lymphoma
dfb	dfb
hedge	बचाव
emerald	पन्ना
frey	फ्रे
duỗi	खिंचाव
duỗi	खींचें
petr	पेत्रो
cory	कोरी
beer	बीयर
beer	बियर
federico	federico
internacional	internacional
boss	बॉस
boss	boss
casno	casno
sasaki	ससाकी
indi	इण्डियम
groove	नाली
freddie	फ्रेडी
crocus	crocus
avant	अवंत
brenda	ब्रेंडा
xắt	कटा
navajo	navajo
philips	फिलिप्स
bronx	bronx
bir	बीर
asiatic	एशियाटिक
timbaland	टिम्बालैंड
lodi	लोधी
lodi	लोदी
gateway	गेटवे
lutheran	लूथरन
novak	नोवाक
anastasia	अनास्तासिया
đỉa	जोंक
avon	एवन
siam	सियाम
udon	उदोन
vincenzo	vincenzo
tomb	मज़ार
tomb	मकबरा
andromeda	एंड्रोमेडा
caltech	caltech
allah	अल्लाह
allah	allah
sousa	सूज़ा
condor	कोंडोर
shine	चमक
macro	मैक्रो
donovan	डोनोवन
petite	petite
steele	स्टील
clive	क्लाइव
hbo	एचबीओ
caterpillar	इल्ली
copernicus	कोपरनिकस
svalbard	स्वालबार्ड
grayson	ग्रेसन
hin	hin
crc	crc
romain	रोमेन
alphonse	अल्फोंस
jeddah	जेद्दाह
jeddah	जेद्दा
crop	फसल
crop	फ़सल
crop	काटें
crop	क्रॉप
nme	nme
doris	डोरिस
myth	मिथक
vittorio	vittorio
moody	moody
moody	मूडी
simmons	सीमन्स
observer	सर्वर
observer	निरीक्षक
isu	isu
cauchy	कौशी
atv	atv
dolls	डॉल
augustin	augustin
mitch	मिच
directx	डाइरेक्टएक्स
shetland	शेटलैंड
levine	लेविन
claudio	क्लाउडियो
tenor	टेनर
naomi	नाओमी
carinatus	carinatus
galilei	गैलिली
bashkortostan	बश्कोरतोस्तान
shakhtar	शख्तर्
pei	pei
astrakhan	आस्त्राख़ान
siena	सियेना
lago	lago
marty	मार्टी
arturo	arturo
ich	ich
moines	moines
amino	अमीनो
omsk	ओम्स्क
evelyn	एवलिन
edmonton	एडमॉन्टन
tuvalu	तुवालू
sởi	measles
emery	एमरी
torch	मशाल
panda	panda
panda	पांडा
trachea	श्वासनली
almaty	almaty
tribal	आदिवासी
tribal	जनजातीय
parque	parque
shire	शायर
brighton	ब्राइटन
frederic	फ़्रेडरिक
khalifa	खलीफा
asteroids	क्षुद्रग्रह
coco	कोको
sếp	sir
sếp	श्रीमान
sếp	साहब
sếp	महोदय
sếp	सर
sếp	प्रधान
sếp	प्रमुख
sếp	मुखिया
sếp	मुख्य
sếp	बॉस
sếp	boss
zacatecas	zacatecas
giầy	जूते
moe	मो
channing	चेनिंग
palo	पालो
junction	जंक्शन
mifflin	mifflin
kuma	कुम
mimi	मिमी
valois	valois
mor	मोर
plastic	प्लास्टिक
magnitude	परिमाण
messiah	मसीहा
lies	झूठ
sango	सांगो
ababa	अबाबा
blackberry	ब्लैकबेरी
gallus	gallus
travis	ट्रैविस
mahmud	महमूद
baikonur	बायकोनूर
halogen	हैलोजन
glacier	हिमनद
glacier	ग्लेशियर
glacier	हिमानी
gomes	गोम्स
ecw	ecw
imam	इमाम
dio	dio
nightwish	नाइटविश
wise	बुद्धिमानी
wise	हिकमत
cathay	कैथे
kathy	कैथी
doom	अज़ाब
doom	यातना
ella	एला
hathaway	हैथवे
burger	बर्गर
lise	लिसे
chôm	चोरी
chôm	चुराया
gondwana	गोंडवाना
dustin	डस्टिन
deck	डेक
pius	पायस
schistura	schistura
serial	धारावाहिक
serial	सीरियल
beth	बेथ
integrifolia	integrifolia
dms	dms
mos	mos
nia	निया
falling	गिरने
falling	गिरना
unity	एकता
rodrigo	रोड्रिगो
odin	ओडिन
artemis	आर्टेमिस
nhòm	दूरबीन
abbott	एबॉट
bra	ब्राजील
bra	ब्राज़ील
ibiza	ibiza
rupee	रुपए
rupee	रुपए
rupee	रुपिया
rupee	रूपया
rupee	रुपया
nộm	डमी
enzo	एंज़ो
bora	बोरा
armand	आर्मंड
entomology	कीटविज्ञान
taurus	वृषभ
taurus	वृष
middleton	मिडलटन
stokes	स्टोक्स
pci	पीसीआई
atlantica	atlantica
frankie	फ्रेंकी
zimmer	ज़िमर
enter	एंटर
enter	डालें
bride	दुल्हन
bride	बहू
nikki	निक्की
survival	अस्तित्व
reptilia	reptilia
sept	सितम्बर
harmonica	हार्मोनिका
sandwich	सैंडविच
emb	emb
fabio	फैबियो
peck	पेक
universität	universität
sensei	सेंसेई
trend	रुझान
trend	प्रवृत्ति
trend	चर्चित
trend	ट्रेंड
sos	sos
ole	ओले
dane	डेन
gpcm	gpcm
views	नजारे
views	दृश्य
shepherd	शेफर्ड
shepherd	गड़रिये
jacobi	jacobi
rosenberg	rosenberg
cocos	कोकोस
moo	मू
archibald	आर्चिबाल्ड
mica	अभ्रक
sale	बिक्री
sale	काठी
vue	vue
storia	storia
khay	ट्रे
lantan	लैन्थनम
kristen	क्रिस्टन
aachen	आखन
oracle	दैवीय
oracle	ओरेकल
oracle	दैवी
brendan	ब्रेंडन
buzz	अफ़वाह
buzz	बज़
sabina	सबीना
scan	स्कैन
penelope	पेनेलोप
#efefef	#efefef
muỗng	चम्मच
muỗng	चमचा
anand	आनंद
skull	खोपड़ी
skull	कपाल
lawson	लॉसन
clk	clk
rhea	रिया
rhett	रहेट
bernadotte	बर्नाडोट
titans	टाइटन्स
comments	टिप्पणियां
comments	टिप्पणियाँ
comments	टिप्पणी
rupert	रुपर्ट
torah	तोरा
ferreira	फरेरा
alec	एलेक
bowie	बोवी
karim	करीम
mueller	मुलर
nepenthes	nepenthes
motorola	मोटोरोला
primera	primera
schiller	शिलर
dieter	dieter
gotham	गोथम
alam	आलम
beetles	भृंग
vote	वोट
vote	vote
boot	बूट
stadt	stadt
felis	फेलिस
pueblo	pueblo
naoh	naoh
hex	हेक्स
dìm	विघ्न
moor	मूर
valentinianus	valentinian
nghẹt	जमघट
uri	यूआरआई
uri	उड़ी
uri	uri
uri	यूआरआइ
marmara	मरमरा
afghan	अफगान
pls	प्लीज
pls	pls
oka	ओका
jill	जिल
jill	jill
rambo	rambo
murmansk	मूरमान्स्क
persie	पेर्सिए
feyenoord	फेनूर्ड
trụy	बलात्कारी
courtney	कोर्टनी
maynard	मेनार्ड
laurie	लॉरी
stavropol	स्ताव्रोपोल
deborah	डेबोरा
lauraceae	जयपत्र
bering	बेरिंग
dominican	डोमिनिकन
graves	क़ब्रों
loang	घिर
comet	धूमकेतुओं
comet	धूमकेतु
loud	जोर
loud	लाउड
hangal	हंगल
sage	ऋषि
cicero	सिसरो
anpơ	ऐल्प्स
wcw	wcw
mải	सनातन
mải	अनन्त
emerson	एमर्सन
closer	करीब
wilkes	wilkes
mick	मिक
walton	वाल्टन
hói	गंजे
hói	गंजा
addison	एडीसन
harding	हार्डिंग
apec	apec
cellpadding	cellpadding
heron	बगुला
université	université
rữa	दुर्गन्ध
passeriformes	passeriformes
globalsecurity	globalsecurity
ramon	रामोन
ramon	रेमन
hulk	हल्क
monterey	monterey
nhóc	किड
nhóc	बच्चा
sunny	sunny
sunny	सनी
enix	एनिक्स
schrödinger	श्रोडिंगर
vái	दुआ
enigma	पहेली
vase	गुलदान
bismil	बिस्मिल
stanisław	स्तानिस्लाव
holden	होल्डन
merkel	मार्केल
corvus	कौआ
corvus	कौवा
lit	जलाकर
lit	lit
lit	गिनती
hormon	हार्मोन
hormon	हार्मोन
pectoralis	pectoralis
celsius	सेल्सियस
patterns	पैटर्न
rough	रफ
rough	रूखी
rough	अशिष्ट
mah	mah
anas	अनस
sus	सस
boo	बू
stamp	स्टैम्प
malo	malo
internationale	internationale
cindy	सिंडी
barrier	अवरोध
poison	poisson
poison	विष
poison	जहर
poison	ज़हर
scorpion	वृश्चिक
scorpion	बिच्छू
hazard	जोखिम
gambit	जुवा
dioxide	डाइऑक्साइड
pong	पोंग
wolverhampton	wolverhampton
panel	पावेल
gustavo	गुस्तावो
bagdad	बगदाद
subgenus	subgenus
accra	अक्रा
horizon	क्षैतिज
horizon	क्षितिज
cassia	cassia
kao	काव
veron	वेरोन
blast	ब्लास्ट
blast	धमाका
vigo	vigo
phết	अल्पविराम
phết	विराम
hamlet	हैमलेट
kolbe	kolbe
eur	eur
darkness	उजाला
darkness	कालिमा
darkness	अन्धकार
darkness	अंधेरा
mclaren	मैकलारेन
sprint	स्प्रिंट
methyl	मिथाइल
verne	वर्न
ludwigslust	मेक्लेनबर्ग
headerstyle	headerstyle
aol	एओएल
kpa	kpa
domino	domino
kathmandu	काठमांडू
terminator	टर्मिनेटर
bitcoin	बिटकॉइन
produce	उपज
sucre	sucre
cdo	सीडीओ
brent	ब्रेंट
rms	rms
afrika	afrika
poe	पो
mccoy	मैककॉय
gunn	gunn
alvin	एल्विन
gregorio	gregorio
kotayk	कोटायक
lbs	lbs
lbs	पाउंड
aquarium	एक्वेरियम
wifi	wifi
wifi	वाईफ़ाई
gregor	ग्रेगर
vanda	vantaa
judas	यहूदा
bhutto	भुट्टो
pony	टट्टू
yusuf	यूसुफ
hagrid	हैग्रिड
quad	क्वाड
