smile	naerata
smile	naeratus
attila	attila
leverkusen	leverkusen
tbilisi	thbilisi
plutoni	plutooniumi
rochester	rochester
rugby	ragbi
kira	kira
marguerite	marguerite
laden	koormatud
benito	benito
aka	aka
ramesses	ramses
ngứa	sügelus
ngứa	sügelemine
ngứa	küüned
ngứa	küünised
rebecca	rebecca
stones	kivid
stones	kive
panorama	panorama
schultz	schultz
trumpet	trompet
pot	pada
pot	potti
pot	pott
patterson	patterson
obi	obi
alma	alma
bốt	saapad
gsm	gsm
hwan	hwan
homer	homer
weasley	weasley
myers	myers
fourier	fourier
hub	hub
tivi	televiisor
tivi	televisiooni
tivi	televisioon
prinz	prinz
argentine	argentina
argentine	argentiina
benin	benini
sar	sar
intercontinental	intercontinental
tina	tina
saddam	saddam
mystery	müstika
mystery	müsteerium
mystery	mõistatus
ruth	ruth
carolyn	carolyn
monde	monde
beetle	mardikas
picasso	picasso
bien	nähtavad
bien	nähtav
bien	bien
bien	taevas
hoffmann	hoffmann
heather	heather
geo	geo
sussex	sussexi
joey	joey
nuremberg	nürnbergi
silicon	räni
isabel	isabel
damascus	damaskuse
batista	batista
highland	highland
avenue	avenue
avenue	avenüü
alegre	alegre
toyotomi	toyotomi
anemia	aneemia
schwarzenegger	schwarzenegger
una	una
fountain	purskkaev
imp	paharet
holmberg	holmberg
vaucluse	vaucluse
sinai	siinai
huelva	huelva
beckham	beckham
reyes	reyes
gin	gin
gin	džinn
camille	camille
wendy	wendy
medicago	medicago
blackwell	blackwell
oxit	oksiid
echo	kaja
gneisenau	gneisenau
holiday	puhkus
holiday	pühal
chocolate	šokolaad
chocolate	šokolaadi
transistor	transistor
timur	timur
hemingway	hemingway
táp	amps
táp	hammustus
táp	hammusta
spl	spl
hybrid	hübriid
gibbs	gibbs
canis	canis
battlefield	lahinguväljal
neutrino	neutriino
elton	elton
fiat	fiat
circus	tsirkus
subspecies	alamliik
montpellier	montpellier
dawson	dawson
ivoire	ivoire
stress	stress
stress	stressist
stress	stressi
tak	tak
pattern	muster
pattern	mustri
greece	kreeka
oliva	oliva
brain	ajud
levant	levant
vila	vila
sapporo	sapporo
buchanan	buchanan
alive	elusana
alive	elus
alive	elusalt
rodriguez	rodriguez
cent	sent
lẻn	hiilida
sandy	sandy
fra	fra
cuốc	suvaline
cuốc	juhuslik
cuốc	kõblas
ftp	ftp
desmond	desmond
terra	terra
pal	pal
champs	champs
charmed	võlus
charmed	võlutud
menu	menüü
kelvin	kelvin
klug	klug
sergio	sergio
hawking	hawking
pitt	pitt
sistema	sistema
medium	keskmise
medium	keskmine
medium	keskmised
medium	andmekandja
jakob	jakob
somali	somaalia
somali	somaalia
shane	shane
cal	cal
cool	lahe
cool	cool
hardcore	hardcore
waltz	valss
moreno	moreno
telegraph	telegraafi
hcv	hcv
milk	piima
milk	piim
daphne	daphne
jackie	jackie
livingston	livingston
thierry	thierry
serena	serena
graz	grazi
malus	malus
flo	flo
cessna	cessna
quest	otsingul
kangaroo	känguru
chrome	kroomi
chrome	kroom
ismail	ismail
saratoga	saratoga
alejandro	alejandro
friuli	friuli
infinite	lõpmatu
infinite	lõputu
myspace	myspace
buri	buri
saab	saab
zhao	zao
draco	draco
hale	hale
gloucester	gloucester
hamburger	hamburger
sarajevo	sarajevo
breda	breda
res	res
marvin	marvin
lift	tõsta
lift	lift
lift	tõste
inn	inn
sonny	sonny
neill	neill
esp	esp
aguilar	aguilar
gore	gore
donna	donna
kauai	kauai
halle	halle
ulrich	ulrich
gap	lõhe
tirana	tirana
karelia	karjala
beaumont	beaumont
ogg	ogg
ulsan	ulsan
frances	frances
viva	viva
cafe	kohvi
cafe	kohv
cafe	cafe
cafe	kohvikus
cafe	kohvik
assassin	palgamõrvar
farm	talu
farm	farm
kwang	kwang
vanilla	äike
société	société
extreme	äärmuslik
bilbao	bilbao
bun	bulgaaria
bun	tõeväärtus
auschwitz	auschwitzi
multi	mitme
wiedemann	wiedemann
newark	newarki
armour	turvis
woody	woody
fat	rasv
fat	rasva
fat	paksud
fat	paks
andrey	andrei
corleone	corleone
mẹo	nõuanded
mẹo	vihjed
mẹo	jootraha
mẹo	vihje
mẹo	tip
pegasus	pegasus
seymour	seymour
haw	haw
wilde	wilde
glycine	glütsiin
plato	platon
olympus	olümpos
tashkent	taškent
lex	lex
fukushima	fukushima
episodes	episoodid
muñoz	muñoz
herb	herb
ringo	ringo
nicola	nicola
burgundy	burgundia
renault	renault
stub	stub
weiss	weiss
rousseau	rousseau
mecca	meka
kamakura	kamakura
augsburg	augsburgi
switch	vaheta
switch	lüliti
fide	fide
dickinson	dickinson
melanie	melanie
holloway	holloway
hume	hume
kar	kar
ngơ	eiramine
ngơ	ignoreerides
ngơ	eirates
muse	muusa
chamberlain	chamberlain
bruch	bruch
gala	gala
cằm	lõug
cằm	chin
pioneer	pioneer
paula	paula
romano	romano
wizard	nõustaja
wizard	võlur
zander	zander
yom	yom
damian	damian
bedford	bedford
haifa	haifa
cash	sularaha
cash	cash
sorbonne	sorbonne
lugo	lugo
runner	jooksja
teo	teo
twilight	videvik
kenji	kenji
hispaniola	hispaniola
entropy	entroopia
sardegna	sardegna
nur	nur
voltaire	voltaire
mask	mask
coa	coa
cluj	cluj
sinclair	sinclair
asparagus	spargel
rojas	rojas
salmon	lõhe
dahl	dahl
nhả	vabastamine
nhả	vabasta
nhả	vabastada
heathrow	heathrow
jenkins	jenkins
minneapolis	minneapolise
pack	pakend
pack	pakendis
pack	paki
pack	pakk
tbd	tbd
machado	machado
modena	modena
buckingham	buckinghami
kitty	kiisu
omer	omer
samara	samara
petersen	petersen
mona	mona
elsa	elsa
madeleine	madeleine
baba	baba
backstreet	backstreet
nagano	nagano
spielberg	spielberg
coventry	coventry
pbs	pbs
pau	pau
taub	taub
lhasa	lhasa
ito	ito
calvert	calvert
polymer	polümeerid
polymer	polümeeri
nolan	nolan
fitzgerald	fitzgerald
treviso	treviso
linum	linum
mama	mamma
mama	ema
mama	mama
romeo	romeo
didier	didier
liguria	liguuria
joyce	joyce
wai	wai
meet	tutvu
meet	kohtuda
alexis	alexis
avenger	tasuja
caserta	caserta
messenger	sõnumitooja
por	por
lagos	lagos
stream	oja
petra	petra
palmas	palmas
oldenburg	oldenburg
jacobs	jacobs
ngẫm	närida
reims	reims
ensign	lipnik
achilles	achilleus
achilles	achille
phalanx	faalanks
gerard	gérard
gerard	gerrard
gerard	gerard
yerevan	jerevan
bergman	bergman
cast	valatud
oran	oran
ortiz	ortiz
bogotá	bogotá
constance	constance
guiana	guajaana
boca	boca
nếm	maitsed
nếm	maitse
ski	suusa
dhaka	dhaka
framework	raamistik
seem	sem
amour	amour
amor	amor
zara	zara
richelieu	richelieu
snape	snape
michele	michele
guadalupe	guadalupe
españa	españa
mendoza	mendoza
judo	judo
tunis	tunis
nigel	nigel
sue	sue
garfield	garfield
tula	tula
hermes	hermes
alicia	alicia
registry	register
registry	kantselei
eindhoven	eindhoven
archipelago	saarestik
gogh	gogh
jedi	jedi
iglesias	iglesias
nirvana	nirvana
harley	harley
wanted	tahtis
wanted	tagaotsitav
wanted	tahtsin
survivor	ellujääja
survivor	ellujäänu
reno	reno
nháp	eelnõu
nháp	kavand
roque	roque
chát	karm
chát	vestlus
lahore	lahore
melody	meloodia
melody	melody
beretta	beretta
sterling	sterling
chambers	chambers
mari	mari
sikh	turban
ivy	ivy
judith	judith
shirley	shirley
michelangelo	michelangelo
nairobi	nairobi
cate	caitlin
lou	lou
advance	ette
boulogne	boulogne
pulitzer	pulitzeri
pocket	tasku
akbar	akbar
sandra	sandra
buch	buch
carinata	carinata
elite	eliit
angry	vihane
lisboa	lissaboni
lisboa	lissabonis
cotton	puuvill
stamford	stamford
faust	faust
klm	klm
oval	ovaalne
marca	macra
mannheim	mannheimi
everest	everest
nationale	nationale
mpeg	mpeg
ida	ida
deutsch	deutsch
cantor	cantor
dorset	dorset
dover	dover
avia	avia
suleiman	suleiman
bohr	bohr
lamb	lamb
lamb	lammas
lamb	lambaliha
noir	noir
brezhnev	brežnev
bray	bray
giỏ	tasku
giỏ	korv
giỏ	korvi
sap	sap
lauren	lauren
marta	marta
tạt	sinep
iana	lana
hana	hana
scipio	scipio
tristan	tristan
cascade	cascade
howe	howe
saunders	saunders
wyatt	wyatt
katherine	katherine
manitoba	manitoba
cật	neerud
almeida	almeida
eliot	eliot
tea	teed
tea	tee
stern	stern
teddy	teddy
marek	marek
alien	tulnukas
schindler	schindler
raja	raja
lydia	lydia
fun	lõbu
fun	lõbus
fun	fun
kumamoto	kumamoto
jungle	džungel
lorenz	lorenz
hillary	hillary
wolfram	volfram
gottfried	gottfried
stephens	stephens
genie	džinn
mangan	mangaani
byrne	byrne
lesser	väiksem
suceava	suceava
bluetooth	bluetooth
compton	compton
mgm	mgm
brock	brock
conway	conway
msn	msn
schuster	schuster
fleming	fleming
rodrigues	rodrigues
topo	topo
snyder	snyder
glucose	glükoos
credit	krediidi
credit	krediit
credit	krediiti
carrie	carrie
classics	klassika
axel	axel
corp	corp
molotov	molotovi
novosibirsk	novosibirski
galápagos	galápagose
frost	frost
bratislava	bratislava
herschel	herschel
munro	munro
endangered	ohustatud
lausanne	lausanne
jacqueline	jacqueline
café	cafe
café	kohvikus
café	kohvik
café	cafe
café	kohvik
norris	norris
freiburg	freiburgi
sui	sui
amadeus	amadeus
nikita	nikita
giacomo	giacomo
dudley	dudley
pleasant	meeldiv
pleasant	meeldivaks
davy	davy
magdalena	magdaleena
magdalena	magdalena
arras	arras
tot	tot
điếc	kurt
điếc	kurdid
lupus	luupus
xxi	xxi
concept	mõiste
concept	kontseptsioon
archimedes	archimedes
neu	neu
wedding	umbrohu
casino	kasiino
sami	sami
sami	saami
marilyn	marilyn
vincennes	vincennes
hyde	hyde
cabin	salongi
cabin	majake
cabin	kabiin
simone	simone
ulysses	ulysses
rệp	lutikad
rệp	putukad
tanganyika	tanganjika
sacramento	sacramento
wallis	wallis
hoét	rästas
jericho	jericho
thatcher	thatcher
byron	byron
faber	faber
ying	ying
zip	zip
toni	toni
moravia	morava
raoul	raoul
colt	colt
danzig	danzig
clarence	clarence
pitbull	pitbull
watt	watt
yoko	yoko
caracas	caracas
ned	ned
bomb	pomm
sarkozy	sarkozy
jerzy	jerzy
koi	koi
judy	judy
astronomy	astronoomia
crassus	crassus
mầu	värv
mầu	värvi
poker	pokker
shaun	shaun
higgins	higgins
aya	aya
nevis	nevis
dorothy	dorothy
mcmahon	mcmahon
hartley	hartley
epstein	epstein
jobs	töökohad
safari	safari
atr	atr
bonnie	bonnie
zamboanga	zamboanga
som	som
campobasso	campobasso
gnome	gnome
terre	terre
guild	gildi
rumble	möll
novo	novo
vita	vita
nantes	nantes
stay	püsi
psyche	psüühika
worms	ussid
stefano	stefano
tripura	tripura
enrico	enrico
nháy	flash
nháy	välk
calhoun	calhoun
alfredo	alfredo
castilla	castilla
dayton	daytoni
takeo	takeo
thun	thun
vulcan	vulcani
superman	superman
corbett	corbett
champ	tšempion
saints	pühakud
saints	pühakute
perez	perez
jerome	jerome
rapunzel	rapuntsel
clemens	clemens
gupta	gupta
trọc	skinhead
als	als
sạc	laadija
sạc	süüdistus
sạc	laeng
sạc	laadimine
bart	bart
karachi	karachi
commonwealth	ühendus
cactus	kaktus
bourne	bourne
esther	esther
leroy	leroy
laurence	laurence
lester	lester
carson	carson
doug	doug
amanita	kärbseseen
arroyo	arroyo
oss	oss
alpine	alpi
henrik	henrik
geoffroy	geoffroy
sicily	sitsiilia
sicily	sitsiilia
cream	koor
cream	kreem
cream	koort
grimm	grimm
antony	antonius
zack	zack
finn	finn
hoth	hoth
cassette	kassett
ufo	ufo
sioux	siuu
cristiano	cristiano
aberdeen	aberdeen
platinum	plaatina
savoy	savoy
bio	bio
bio	bios
kuban	kuban
fig	joonis
electra	electra
trip	trip
trip	reis
trip	tripp
morocco	maroko
vít	kruvikeeraja
garde	garde
camden	camdeni
tara	tara
shia	shia
kwazulu	kwazulu
guthrie	guthrie
eclipse	varjutus
tap	võistleja
penalty	karistus
brandon	brandon
hoover	hoover
borgo	borgo
rodney	rodney
foo	foo
sida	aids
sida	aidsi
sutton	sutton
zoom	zoom
flynn	flynn
lover	armuke
lover	armastaja
thera	thera
kirov	kirov
tor	tor
tor	thor
capo	capo
rụi	purustatud
orient	orient
romanov	romanov
eaton	eaton
lakes	järved
natalia	natalja
salazar	salazar
gmbh	gmbh
abrams	abrams
magister	magister
warwick	warwicki
whole	terve
whole	terved
whole	tervik
whole	tervelt
aid	abi
râm	varju
milwaukee	milwaukee
edith	edith
edith	édith
indianapolis	indianapolis
noah	noa
noah	noah
caucasus	kaukaasia
gillespie	gillespie
lynx	ilves
app	app
app	rakendus
presley	presley
brook	oja
vhs	vhs
troll	troll
troll	trollid
cassius	cassius
prahova	prahova
sora	sora
ethernet	ethernet
peso	peesot
peso	peeso
fontainebleau	fontainebleau
perugia	perugia
keng	keng
carvalho	carvalho
muon	tahaks
muon	tahad
shock	šokk
tutu	tutu
bend	painutada
artiodactyla	artiodactyla
tchaikovsky	tšaikovski
caldwell	caldwell
xoang	siinuse
fyodor	fjodor
kat	kati
kat	kat
königsberg	königsberg
coffee	kohvi
coffee	kohv
task	ülesanne
ger	ger
bak	bak
sulfat	sulfaat
tobias	tobias
rivers	jõed
flemish	flaami
legion	leegion
ala	ala
dash	dash
dash	kriips
isis	isis
trek	treki
lowe	lowe
pizza	pitsat
pizza	pitsa
pizza	pizza
cobra	kobra
unicef	unicef
kissinger	kissinger
dee	dee
rsa	rsa
hockey	hoki
xỉn	purjus
xỉn	joodik
bow	vibu
bow	kummardus
sars	sars
vic	vic
nico	nico
fed	toidetud
antoinette	antoinette
pzl	pzl
ramsay	ramsay
nizhny	nižni
trevor	trevor
limburg	limburgi
sherlock	sherlock
dolby	dolby
avatar	avatar
sinatra	sinatra
ivanov	ivanov
briggs	briggs
julio	julio
emile	emile
ricky	ricky
reader	lugeja
harald	harald
fortune	varandus
domodedovo	domodedovo
doo	doo
faraday	faraday
rand	rand
baird	baird
rubin	rubin
rowling	rowling
potosí	potosí
clyde	clyde
campestris	campestris
kiribati	kiribati
karlsruhe	karlsruhe
beverly	beverly
goodman	goodman
cowboy	kauboi
samantha	samantha
analog	analoog
ourense	ourense
kerry	kerry
muller	müller
ramón	ramón
ramón	ramon
horst	horst
merry	häid
chirac	chirac
pagan	paganlik
pagan	uskmatu
mendelssohn	mendelssohn
perseus	perseus
ria	ria
olivia	olivia
mem	mem
dodge	dodge
spike	spike
augustine	augustine
houghton	houghton
aruba	aruba
hawkins	hawkins
burt	burt
avignon	avignon
monarch	monarh
olive	olive
soares	soares
tuva	tõva
bacău	bacău
bowman	bowman
kitts	komplektid
kitts	kitts
magellan	magellan
equus	equus
agnes	agnes
dốt	harimatu
jena	jena
thessaloniki	thessaloníki
gol	gol
tetra	tetra
juno	juno
sumner	sumner
bock	bock
haydn	haydn
malik	malik
escape	põgenemine
salon	salong
salon	salongis
lama	laama
oswald	oswald
mara	mara
mika	mika
lia	lia
hegel	hegel
maggie	maggie
jürgen	jürgen
siết	kallistus
siết	kalli
visa	viisa
francois	francois
francois	françois
button	nööp
button	nupp
button	button
duc	duc
köhler	köhler
alger	vetikad
gong	gong
rostrata	rostrata
pompey	pompeius
gerd	gerd
pet	pet
pet	lemmikloom
pet	luure
drum	trumm
drum	trummi
daewoo	daewoo
pygmaeus	pygmaeus
martini	martini
clarkson	clarkson
manfred	manfred
varna	varna
nazi	fašistlik
spartan	sparta
mohr	mohr
tởm	vastik
jiménez	jiménez
brazilian	brasiilia
creed	creed
technologies	tehnoloogiad
technologies	tehnoloogiate
technologies	tehnoloogiaid
malfoy	malfoy
trail	jälg
trail	rada
bosco	bosco
shore	kalda
shore	kaldal
shore	shore
lipid	lipiidide
yamagata	yamagata
hyo	hyo
billie	billie
chaos	kaos
umbrella	vihmavari
candida	candida
karaoke	karaoke
oskar	oskar
zidane	zidane
aziz	aziz
cramer	cramer
vargas	vargas
ping	pingi
ping	ping
rostock	rostock
marin	marin
montbéliard	montbéliard
abs	abs
keller	keller
boyle	boyle
spot	spot
dar	dar
divaricata	divaricata
matter	matid
matter	mats
rocca	rocca
martial	martial
herodotus	herodotos
schumann	schumann
kyu	kyu
jaya	jaya
melissa	melissa
tar	tõrva
mureș	mureși
roux	roux
tribune	tribune
aden	adeni
erectus	erectus
uppsala	uppsala
juliet	juliet
elias	elias
angus	angus
cas	cas
cas	cass
hamas	hamasi
reinhard	reinhard
koblenz	koblenz
idf	idf
chevalier	rüütel
guillermo	guillermo
rutherford	rutherford
loc	loc
jansen	jansen
schubert	schubert
ensemble	ansambel
ishikawa	ishikawa
frozen	külmutatud
frozen	külmunud
huron	huron
cunningham	cunningham
dyer	dyer
shawn	shawn
juniperus	juniperus
vogue	vogue
josephine	josephine
embraer	embraer
xíu	pisike
xíu	tilluke
aubin	aubin
atlantis	atlantis
dewey	dewey
sulu	sulu
capra	capra
barbuda	barbuda
akita	akita
margarita	margarita
stavka	stavka
soto	soto
charter	harta
oliveira	oliveira
geoff	geoff
pamplona	pamplona
kyiv	kyiv
autobiography	autobiograafia
bark	koore
mêtan	metaani
mack	mack
guru	guru
sanders	sanders
aztec	asteekide
potomac	potomaci
cor	regioonide
spy	okse
nikolay	nikolai
bmp	bmp
garten	garten
stereo	stereo
murcia	murcia
georgetown	georgetowni
fermi	fermi
mcgraw	mcgraw
falco	falco
pedersen	pedersen
lance	lance
mohd	mohd
gettysburg	gettysburgi
perspective	perspektiive
amd	amd
pulcher	pulcher
vladivostok	vladivostoki
vida	vida
giulia	giulia
nora	nora
blogger	blogija
blogger	blogid
stephanie	stephanie
bing	bing
shotgun	püss
kgb	kgb
chapel	kabel
maison	maison
betta	betta
spice	vürtsi
radiohead	radiohead
octopus	kaheksajalg
severin	severin
zanthoxylum	zanthoxylum
khít	pakkimine
sink	tsink
abbeville	abbeville
saskatchewan	saskatchewan
kaliningrad	kaliningradi
bullock	bullock
bert	bert
makarov	makarov
harmony	harmoonia
diaz	diaz
vầng	golden
vầng	kuldsed
vầng	kuldne
gui	gui
odyssey	odyssey
ngo	mtü
tethys	tethys
progressive	progresseeruva
davidson	davidson
chernobyl	tšernobõli
hammond	hammond
hastings	hastings
larson	larson
olsen	olsen
fairchild	fairchild
biella	biella
consolidated	konsolideeritud
găm	pistoda
booth	kabiin
booth	booth
cristina	cristina
demosthenes	demosthenes
plc	plc
gerrard	gerrard
negro	neeger
negro	negro
rum	rumm
rum	rummi
argus	argus
vasco	vasco
leibniz	leibniz
bitburg	bitburg
mandalay	mandalay
mahmoud	mahmoud
tyra	tyra
pia	pia
gorky	gorki
steam	auru
steam	aur
spa	spa
huntington	huntington
styles	stiilid
pool	pol
boyd	boyd
tornado	tornaado
vin	vin
dmt	dmt
montagne	montagne
keane	keane
chorus	koori
chorus	refrään
brahms	brahmsi
aphrodite	aphrodite
paso	paso
dolly	dolly
paxton	paxton
prüm	prümi
char	char
kramer	kramer
wushu	wushu
rae	rae
genesis	genesis
frosinone	frosinone
nissan	nissan
mir	mir
gabrielle	gabrielle
dagestan	dagestan
fernandez	fernandez
władysław	władysław
gustaf	gustaf
peterson	peterson
garrett	garrett
vent	vent
reuters	reuters
nilsson	nilsson
rình	jälitamine
rình	jälitaja
novorossiysk	novorossiisk
officinalis	officinalis
aix	aix
gpl	gpl
hodgson	hodgson
piccolo	piccolo
pitchfork	hang
abruzzo	abruzzo
clifford	clifford
providence	providence
clare	clare
generic	üldine
emberiza	tsiitsitaja
ploceus	weaver
carlton	carlton
malmö	malmö
sampson	sampson
daniels	daniels
papa	papa
vitis	vitis
sha	sha
brady	brady
identity	identiteedi
identity	identiteet
launch	start
launch	käivitamine
telescope	teleskoobi
destroyer	hävitaja
rodgers	rodgers
dolphin	delfiin
swing	hoos
kern	kern
syracuse	syracuse
martins	martins
moritz	moritz
silica	ränidioksiid
hypericum	naistepuna
hypericum	hypericum
frederik	frederik
buena	buena
aleksey	aleksei
coleman	coleman
baikal	baikali
liszt	liszt
oro	oro
steiner	steiner
mackenzie	mackenzie
steroid	steroidide
steroid	steroide
scene	uml
dakar	dakar
ipod	ipod
atkinson	atkinson
packard	packard
arlington	arlingtoni
exeter	exeter
sedgwick	sedgwick
fax	faksi
brotherhood	vennaskond
flavius	flavius
tampa	tampa
stevie	stevie
siegfried	siegfried
banda	banda
vat	käibemaks
vat	käibemaksu
vat	märg
vat	märjad
vat	märjaks
poseidon	poseidon
liberec	liberec
mateo	matteo
mateo	mateo
vigna	vigna
madame	proua
madame	madame
turdus	rästas
hades	hades
dominic	dominic
chelyabinsk	tšeljabinski
hague	haagi
astoria	astoria
pskov	pihkva
richie	richie
satan	saatan
arch	kaare
arch	arch
arch	kaar
lübeck	lübeck
piceno	piceno
liam	liam
sylvester	sylvester
tiffany	tiffany
braga	braga
horace	horace
mathias	mathias
mathias	mattias
hilary	hillary
hilary	hilary
mel	mel
nest	pesa
dress	ülikond
aureus	aureus
guevara	guevara
savannah	savannah
uranium	uraan
pinto	pinto
conquest	vallutus
claus	claus
avec	avec
beatrice	beatrice
daisy	daisy
katie	katie
navarra	navarra
léopold	leopold
nucleotide	nukleotiidi
rubik	cube
rubik	kuubik
rubik	kuubiku
rubik	rubik
osborne	osborne
entre	entre
rhus	rhus
proxima	proxima
matthias	matthias
ker	ker
reese	reese
sergipe	sergipe
freshwater	magevee
natasha	natasha
ribbon	pael
ribbon	paela
nhọ	tahma
chul	chul
owl	öökull
molly	moll
molly	molly
picea	picea
picea	kuusk
bieber	bieber
wen	wen
sassari	sardiinia
sassari	sardiinias
soprano	soprano
goliath	koljat
cdc	cdc
vát	pead
vát	päid
sanskrit	sanskriti
yao	yao
crash	avarii
gaz	gaz
adsl	adsl
gaia	gaia
aki	aki
hanna	hanna
amelia	amelia
challenger	väljakutsuja
zheng	zheng
kanye	kanye
balboa	balboa
rieti	rieti
stirling	stirling
duffy	duffy
ula	ula
terrier	terjer
iloilo	iloilo
esa	esa
krupp	krupp
seasons	hooaega
proctor	proctor
osman	osman
hasan	hasan
karabakh	karabahhi
vẩn	jama
ppm	ppm
patel	patel
clan	klanni
clan	klann
prado	prado
neymar	neymar
markov	markov
oecd	oecd
fruticosa	fruticosa
freud	freud
emilio	emilio
distrito	distrito
demi	demi
loop	silmus
loop	loop
mayo	majonees
jive	jive
vip	vip
locke	locke
garland	garland
tau	tau
bmg	bmg
booker	booker
raphael	raphael
louisville	louisville
payne	payne
ami	ami
morley	morley
szolnok	szolnok
zulu	zulu
surabaya	surabaya
pub	pubi
platon	platon
mccarthy	mccarthy
sal	sal
fin	fin
ulmus	jalakate
daimler	daimler
mora	mora
malpensa	malpensa
pyrenees	püreneedes
pyrenees	pyrénées
cyril	cyril
kremlin	kremli
westphalia	westfalenis
griffith	griffith
pensacola	pensacola
everett	everett
khalid	khalid
naturelle	naturelle
shu	shu
mercy	halastus
mercy	halastust
somebody	keegi
scarlet	scarlet
villar	villar
jaguar	jaguar
mathieu	mathieu
firefly	firefly
mcpherson	mcpherson
lyndon	lyndon
rận	täid
rận	täide
rận	täi
rolf	rolf
moulin	moulin
dartmouth	dartmouth
luiz	luiz
burnett	burnett
iași	iași
miura	miura
blanche	blanche
gar	gar
calcutta	calcutta
spence	spence
hystrix	okassiga
northumberland	northumberland
hollow	õõnsad
tierra	tierra
laeta	laeta
ozawa	ozawa
ipad	ipad
fifth	viies
fifth	viiendaks
schlegel	schlegel
belluno	belluno
gpu	gpu
trent	trent
celle	celle
willie	willie
bac	bac
anita	anita
nietzsche	nietzsche
vđv	sportlased
evan	evan
stafford	stafford
cocktail	kokteil
cocktail	kokteili
usher	usher
pamela	pamela
georgy	georgi
minerva	minerva
audrey	audrey
luanda	luanda
kumar	kumar
loki	loki
wichita	wichita
thin	õhuke
thin	peenike
thin	õhukesed
sql	sql
brooke	brooke
kaufman	kaufman
elk	põder
rubens	rubens
anguilla	anguilla
toby	toby
chennai	chennai
fribourg	fribourg
jfk	jfk
geisha	geiša
eddy	eddy
magdeburg	magdeburg
dinar	dinaar
damon	damon
isabelle	isabelle
subtilis	subtilis
pentium	pentium
expo	expo
tráp	lõksu
tráp	lõks
flowering	õitsemist
vince	vince
barber	juuksur
bos	boss
danish	taani
omaha	omaha
corinthians	korintlastele
cologne	kölni
stevenson	stevenson
hutchinson	hutchinson
samson	samson
gmail	krediidi
gmail	krediit
gmail	krediiti
gmail	gmail
xyanua	tsüaniidi
pieter	pieter
gradient	kalle
gradient	üleminek
schwerin	schwerin
cosmos	kosmos
britannia	britannia
plains	tasandikud
enceladus	enceladus
catanzaro	catanzaro
nusa	nusa
lotte	lotte
alicante	alicante
kamchatka	kamtšatka
civic	civic
chesapeake	chesapeake
basil	basil
kirill	kirill
inger	inger
alves	alves
faa	faa
marxist	marksist
oleg	oleg
willy	willy
shiro	shiro
maori	maoori
maori	raba
maori	rabas
pygmy	kääbus
kami	kami
furious	raevus
maki	maki
shuttle	süstik
serge	serge
xịt	müts
xịt	mütsi
xịt	kaabu
xịt	kübar
xịt	oli
duff	duff
roc	roc
bunker	punker
strabo	strabo
selen	seleeni
còng	rauad
brutus	brutus
cliff	kalju
cliff	cliff
bernstein	bernstein
morse	morse
cullen	cullen
lympho	lümfoomi
hedge	heki
emerald	smaragd
frey	frey
duỗi	venitada
duỗi	venib
petr	petr
cory	cory
beer	õlut
beer	õlle
beer	õlu
federico	federico
boss	ülemus
boss	boss
tamara	tamara
einer	einer
indi	indium
groove	soon
frisia	friisi
freddie	freddie
avant	avant
tráo	paigaldamine
brenda	brenda
xắt	tükeldatud
xắt	hakitud
frodo	frodo
dreyfus	dreyfus
guido	guido
navajo	navajo
philips	philips
philips	phillips
avg	avg
savo	savo
cranmer	cranmer
barlow	barlow
bangs	tukk
bronx	bronxi
bir	bir
lodi	lodi
gateway	värav
lutheran	luterlane
maastricht	maastrichti
novak	novak
groß	groß
anastasia	anastasia
đỉa	kaanid
đỉa	kaan
rudolph	rudolph
anatomy	anatoomia
avon	avoni
linz	linz
siam	siiami
willard	willard
vincenzo	vincenzo
tomb	haud
tomb	haua
andromeda	andromeeda
neuville	neuville
caltech	caltech
batavia	batavia
allah	allah
sousa	sousa
condor	kondor
shine	sära
macro	makro
gel	geeli
gel	geel
donovan	donovan
steele	steele
clive	clive
hbo	hbo
copernicus	kopernik
montmartre	montmartre
svalbard	svalbard
dietrich	dietrich
zola	zola
grayson	grayson
crc	crc
romain	romain
alphonse	alphonse
mira	mira
flensburg	flensburgi
crop	kärpimine
pirates	piraadid
doris	doris
myth	müüdi
myth	müüt
elder	vanem
vittorio	vittorio
vaslui	vaslui
moody	moody
sands	liivad
simmons	simmons
observer	jälgija
observer	vaatleja
isu	isu
volta	volta
caligula	caligula
dolls	nukud
augustin	augustin
tarawa	tarawa
mitch	mitch
avellino	avellino
shetland	shetlandi
marks	märgid
marks	marks
kennel	kennel
levine	levine
langley	langley
claudio	claudio
tenor	tenor
naomi	naomi
sibiu	sibiu
pei	pei
volgograd	volgograd
siena	siena
uniflora	uniflora
franck	franck
lago	iago
piero	piero
marty	marty
triton	triton
anatoly	anatoli
nichols	nichols
sondrio	sondrio
arturo	arturo
ich	ich
moines	moines
void	tühjus
amino	amino
omsk	omski
albicans	albicans
durango	durango
evelyn	evelyn
edmonton	edmonton
tuvalu	tuvalu
sởi	leetrite
emery	emery
chou	chou
