click	clic
malay	malai
burke	burke
habana	habana
baldwin	balduí
glauca	glauca
gomez	gomez
gomez	gómez
diva	diva
mills	mills
vogel	vogel
katsuura	katsuura
exo	exo
aquila	aquila
riley	riley
prain	prain
aubl	aubl
apache	apache
apache	apatxe
swaziland	swazilàndia
kirk	kirk
villers	villers
dem	dem
bissau	bissau
cfg	cfg
humboldt	humboldt
angels	àngels
angels	angels
cincinnati	cincinnati
stein	stein
jalisco	jalisco
linden	linden
ada	adda
ada	ada
albion	albió
wade	wade
strong	forts
strong	forta
strong	fort
wto	omc
gould	gould
morales	morales
pixar	pixar
kohl	kohl
gardens	jardins
quincy	quincy
ornata	ornata
dante	dante
gérard	gérard
fury	fúria
savage	salvatge
maculatus	maculatus
hogwarts	hogwarts
oahu	oahu
moy	moy
gil	gil
cabo	cabo
jolie	jolie
rolls	rotllos
lviv	lviv
summerh	summerh
rehder	rehder
kota	kota
bauhinia	bauhinia
alessandro	alessandro
ekman	ekman
log	bitàcola
parms	parms
springer	springer
barnard	barnard
sabre	sabre
thebes	tebes
claudius	claudi
tricolor	tricolor
schulz	schulz
bari	bari
guillaumin	guillaumin
plasma	plasma
versicolor	versicolor
sturm	sturm
nathan	nathan
avro	avro
taekwondo	taekwondo
shinsengumi	shinsengumi
patricia	patricia
minutus	minutus
eduard	eduard
bufonidae	bufonidae
yangon	yangon
enrique	enrique
strike	vaga
asperula	asperula
yard	pati
bucharest	dosrius
bucharest	bucarest
konstantinos	constantí
int	int
shelby	shelby
lufthansa	lufthansa
taken	pres
rufus	ruf
connor	connor
dynamo	dinamo
harrier	arpella
caudata	caudata
hon	hon
hon	benvolguts
ôliu	olives
nola	nola
liechtenstein	liechtenstein
shakira	shakira
sứa	medusa
sứa	meduses
benoit	benoit
rabaul	rabaul
richland	richland
cromwell	cromwell
queens	reines
queens	queens
plain	plain
cello	violoncel
robertson	robertson
rán	fregida
rán	fry
quầy	chef
quầy	xef
fungorum	fungorum
hae	hae
dracula	dracula
endl	endl
metropolitan	metropolitan
capparis	capparis
vendée	vendée
tonga	tonga
pass	rellotge
pass	passen
pass	passi
pass	pass
baja	baja
dam	presa
yeltsin	ieltsin
lori	lori
malacca	malaca
lineata	lineata
walther	walther
christie	christie
oeste	oeste
eremophila	eremophila
dominique	dominique
garnier	garnier
dieu	dieu
crimean	crimea
quentin	quentin
marlborough	marlborough
fleet	flota
tours	tours
reeder	reeder
macquart	macquart
girona	girona
hokkaido	hokkaido
tales	tales
tales	contes
maldives	maldives
rennes	rennes
castellón	castellón
castellón	castelló
javier	javier
brod	brod
sharon	sharon
rosario	rosario
rosea	rosea
suite	suite
erigone	erígone
clair	clair
woodson	woodson
antwerp	anvers
sevastopol	sebastòpol
aurea	aurea
pseudopoda	pseudopoda
jeju	jeju
mirror	mirall
diếp	enciams
diếp	enciam
macrophylla	macrophylla
potentilla	potentilla
lesotho	lesotho
aristotle	aristòtil
maslin	maslin
ultra	ultra
xxx	xxx
arcade	arcade
ústí	ústí
wasp	vespa
boong	cobertes
boong	baralla
boong	coberta
furnariidae	furnariidae
pratt	pratt
andalusia	andalusia
lindau	lindau
bactria	bactriana
amanda	amanda
malcolm	malcolm
joker	jòquer
yves	yves
mrkos	mrkos
goethe	goethe
winchester	winchester
cnn	cnn
guillaume	guillaume
sericea	sericea
cúi	doblegar
juss	juss
thây	zombies
kant	kant
japonicus	japonicus
chum	chum
tanikawa	tanikawa
nhấp	clic
fallax	fallax
chronicle	crònica
pumila	pumila
birdlife	avifauna
turku	turku
bradford	bradford
antilles	antilles
seki	seki
ekaterina	iekaterina
populus	populus
shark	tauró
flagstaff	flagstaff
ein	ein
messina	messina
infraclassis	infraclassis
sếu	grues
sếu	grua
mandela	mandela
metallica	metallica
kanagawa	kanagawa
burret	burret
scorea	scorea
asm	asm
xiếc	circ
dom	dom
gigas	gigas
dae	dae
altlink	altlink
erwin	erwin
belfast	belfast
linn	linn
picta	picta
joy	alegria
haplochromis	haplochromis
verdun	verdum
macau	macau
sint	sint
tyrannidae	tyrannidae
bryansk	briansk
hare	hare
hare	llebre
jasper	jasper
nba	nba
tristis	tristis
trafford	trafford
emirates	emirats
emirates	emirates
terme	terme
sum	sumatori
sum	suma
swiss	suís
chin	barbeta
chin	chin
clemson	clemson
himmler	himmler
ahn	ivanov
ahn	ivànov
ahn	ahn
dĩa	placa
valenciennes	valenciennes
rna	rna
rna	arn
khoe	espectacles
düsseldorf	düsseldorf
düsseldorf	dusseldorf
maha	maha
usda	usda
lives	vides
tyson	tyson
sonic	sonic
johor	johor
agm	agm
dượng	vernon
dượng	padrastre
cecil	cecil
larvae	larves
besançon	besançon
javascript	javascript
rzhev	rjev
takeda	takeda
mercedes	mercedes
sigma	sigma
adventures	aventures
ryū	ryū
ubuntu	ubuntu
kagoshima	kagoshima
tallinn	tallinn
vito	vito
peruviana	peruviana
varese	varese
sparrow	pardal
origins	orígens
banh	pilota
yucatán	yucatan
yucatán	yucatán
heli	heli
wii	wii
orléans	orleans
lutea	lutea
almería	almería
almería	almeria
ponte	ponte
martínez	martínez
kmh	kmh
thames	thames
guadeloupe	guadalupe
jma	jma
cumberland	cumberland
lamarck	lamarck
craugastor	craugastor
btr	btr
serv	serv
leslie	leslie
kirby	kirby
mustafa	mustafa
mustafa	mustafà
romero	romero
messerschmitt	messerschmitt
cardamine	cardamine
pittsburgh	pittsburgh
saladin	saladí
asturias	astúries
asturias	asturias
weimar	weimar
synonym	sinònim
yoshida	yoshida
vaughan	vaughan
gauss	gaussià
gauss	gauss
sakhalin	sakhalín
esp}}	esp}}
banner	camins
banner	estendard
pallas	pallas
seth	seth
regia	regia
wikidata	wikidata
pao	lbs
mega	mega
mindanao	mindanao
nigricans	nigricans
claire	claire
maru	maru
trias	trias
mallinella	mallinella
meridionalis	meridionalis
africanus	africà
hindi	hindi
tango	tango
quýnh	jiong
montréal	montreal
desmodium	desmodium
makoto	makoto
dubia	dubia
empires	imperis
jesse	jesse
hey	ei
adrian	adrian
indicus	indicus
kagome	kagome
prescott	prescott
ark	ark
albrecht	albrecht
marsh	pantà
suwon	suwon
gómez	gomez
gómez	gómez
gómez	gómez
coldplay	coldplay
české	české
olga	olga
carnegie	carnegie
kwon	kwon
dyar	dyar
yamaguchi	yamaguchi
brit	brit
rod	rod
bờm	mane
crepis	crepis
hermione	hermione
phẩy	coma
zeno	zenó
mussolini	mussolini
amazing	increïble
nhờn	oliós
joshua	joshua
earl	earl
demetrios	demetri
amber	amber
amber	ambre
nhk	nhk
montevideo	montevideo
combretum	combretum
neon	neó
hoon	hoon
kenny	kenny
pallidus	pallidus
hanoi	hanoi
richter	richter
shiki	shiki
kurd	hamas
mercer	mercer
bethlehem	betlem
invincible	invencibles
invincible	invencible
mainz	magúncia
pygmaea	pygmaea
tracy	tracy
imf	fmi
lactuca	lactuca
blanchard	blanchard
mickey	mickey
natalensis	natalensis
grenada	grenada
uesac	uesac
xml	xml
antigua	antigua
claudia	claudia
shogun	shōgun
aung	aung
toei	toei
disa	disa
stella	stella
stoke	stoke
baku	baku
car	cotxe
eduardo	eduardo
yen	iens
sedis	sedis
werder	werder
seal	foca
seal	segell
elliot	elliot
pasteur	pasteur
albany	albany
decipiens	decipiens
bloch	bloch
yoga	yoga
yoga	ioga
albacete	albacete
blade	blade
gundam	gundam
mat	menjar
mat	alimentació
nuevo	nuevo
nol	nol
disco	discoteca
disco	disco
rufa	rufa
heinkel	heinkel
gsub	gsub
asp	asp
penny	penny
penny	cèntim
shadab	shadab
blackwall	blackwall
quýt	mandarina
sunni	sunnita
eve	eve
minamoto	minamoto
node	node
hacker	hacker
hacker	piratejar
sendai	sendai
tiberius	tiberi
christophe	christophe
ming	ming
engels	engels
znojmo	znojmo
lynn	lynn
olomouc	borrassà
durham	durham
chong	chong
hót	cant
hót	cantant
hót	canta
coloma	coloma
thor	thor
padova	pàdua
ovata	ovata
incertae	incertae
ruby	rubí
ruby	ruby
dwight	dwight
comoros	comores
fulton	fulton
palustris	palustris
xavier	xavier
blücher	blücher
candy	llaminadures
candy	candy
candy	caramel
superordo	superordo
sheridan	sheridan
pauly	pauly
xòe	tutu
griffin	griffin
fao	fao
iğdır	iğdır
vtc	vtc
menzies	menzies
khuấy	remenar
konstantin	konstantín
boa	boa
cube	cube
cube	cub
r}}	r}}
emil	emil
rahman	rahman
glen	glen
klaus	klaus
gorbachev	gorbatxov
resort	resort
corinna	corinna
benz	benz
hampton	hampton
chandler	chandler
williamson	williamson
pers	pers
papilionidae	papilionidae
göring	göring
nordrhein	nordrhein
samar	samar
quinn	quinn
taira	taira
castel	castel
bmw	bmw
sumer	sumeri
irene	irene
penang	penang
gớm	inflamació
zeller	zeller
scheer	scheer
kahn	kahn
toro	toro
gaon	gaon
sủa	escorça
sủa	barks
carr	carr
betty	betty
wilkinson	wilkinson
cholesterol	colesterol
constantinople	constantinoble
allmusic	allmusic
chihuahua	chihuahua
ancona	ancona
descartes	descartes
tran	tran
madeira	madeira
micro	micro
micro	micròfon
thìa	culleres
thìa	cullera
cristata	cristata
medici	mèdici
gien	gene
gien	gen
cornwall	cornualla
uae	uea
scharnhorst	scharnhorst
bains	bains
luzula	luzula
androsace	androsace
marche	marche
bremer	bremer
hormone	hormona
hormone	hormones
udine	udine
michx	michx
kan	kan
gập	plegat
lens	lens
lens	lent
lens	filtració
lens	fuita
beirut	beirut
hahn	hahn
yamada	yamada
linearis	linearis
dot	dot
andersson	andersson
lafayette	lafayette
willem	willem
tatar	tàtar
boom	bang
boom	boom
luigi	luigi
boone	boone
dumbledore	dumbledore
reo	dubte
reo	sonant
garrison	guarnició
fiction	ficció
sidney	sidney
zelotes	zelotes
musashi	musashi
bosmans	bosmans
pluto	plutó
pluto	pluto
adobe	adobe
lexikon	lexikon
shizuka	shizuka
lindsey	lindsey
hyundai	hyundai
direct	directe
direct	directa
direct	direct
direct	directes
primula	prímula
hochst	hochst
vermont	vermont
craven	craven
nomura	nomura
diane	diane
thrace	tràcia
rivière	rivière
anders	anders
sugar	sucre
hypercompe	hypercompe
bouchet	bouchet
evarcha	evarcha
doc	doc
budějovice	budějovice
khalip	califa
antiochos	antíoc
schalke	schalke
kyushu	kyushu
phidippus	phidippus
cremona	cremona
handel	handel
turing	turing
talbot	talbot
piston	pistons
piston	piston
admiralty	almirallat
cattleya	cattleya
kyle	kyle
emerton	emerton
dale	dale
gloria	glòria
gloria	gloria
oder	oder
lange	lange
shannon	shannon
liti	liti
mehmed	mehmet
cayman	calgary
summit	tossal
summit	cimera
martinique	martinica
villiers	villiers
gotha	gotha
martino	martino
obscurus	obscurus
saxophone	saxòfon
friedman	friedman
canescens	canescens
vanessa	vanessa
baghdad	bagdad
haas	haas
ryukyu	ryukyu
kanon	kanon
schwartz	schwartz
hohenzollern	hohenzollern
para	para
howell	howell
tolstoy	tolstoi
palawan	palawan
neptune	neptú
jupiter	júpiter
velvet	vellut
velvet	velvet
violacea	fustera
mia	mia
alfonso	alfons
alfonso	alfonso
lara	lara
bromley	bromley
proxy	intermediari
djibouti	djibouti
hattori	hattori
training	entrenament
training	formació
musa	mussa
musa	musa
bromus	bromus
acta	acta
akb	akb
californica	californica
marcello	marcello
kırıkkale	kırıkkale
gilles	gilles
shogakukan	shogakukan
norodom	norodom
funk	funk
robustus	robustus
jharkhand	jharkhand
shepard	shepard
microphylla	microphylla
zanzibar	zanzíbar
lil	lil
dmitry	dmitri
boisduval	boisduval
sporobolus	sporobolus
apiaceae	apiàcia
randolph	randolph
toscana	toscana
ambrose	ambrose
aurelius	aureli
sheikh	sheikh
sheikh	xeic
kottelat	kottelat
gear	tempo
gear	engranatge
gear	velocitats
andorra	podgorica
olympique	olympique
benedict	benedict
palmer	palmer
irving	irving
trau	cansada
trau	cansats
trau	cansat
bison	bison
medeiros	medeiros
lat	lat
lat	mandrós
ferula	ferula
coruña	coruña
wigan	wigan
crane	grua
ôtô	cars
ôtô	cotxes
ôtô	automòbils
clement	clement
fulva	fulva
nobilis	nobilis
darren	darren
duméril	duméril
beaver	beaver
beaver	castor
paulus	paulus
chopin	chopin
canterbury	canterbury
gerhard	gerhard
ariel	ariel
fujiwara	fujiwara
fasciatus	fasciatus
maxima	maxima
indie	indie
konrad	konrad
castillo	castillo
kung	kung
championships	campionats
animax	animax
beograd	belgrad
martha	martha
bloom	bloom
marius	marius
espírito	espírito
helmut	helmut
avril	avril
mbar	mbar
khuya	tard
suffolk	suffolk
kilis	kilis
niken	níquel
kimi	kimi
beaufort	beaufort
maui	maui
tone	to
tone	matís
rue	rue
michoacán	michoacán
ferrari	ferrari
sond	sond
stan	stan
rebel	rebel
loi	loi
regina	regina
laporte	laporte
cerastium	cerastium
cherry	cirera
cherry	cherry
cherry	cireres
scout	scout
scout	explorador
coburg	coburg
lozère	losera
pereira	pereira
borneensis	borneensis
interscope	interscope
agapetus	agapit
bruxelles	bruxelles
bruxelles	brussels
gaston	gaston
citation	citació
sakai	sakai
plethodontidae	plethodontidae
fairey	fairey
curie	curie
chuck	chuck
dora	dora
aerospace	aeroespacials
benn	benn
donau	danubi
donau	donau
punctatus	punctatus
dengeki	dengeki
romagna	romanya
bergen	bergen
schinz	schinz
laevis	laevis
sagar	sagar
gajbe	gajbe
turkish	turc
trinity	trinity
trinity	trinitat
antigonos	antígon
shop	botiga
shop	botigues
shop	comerços
alur	alur
roche	roche
lamiaceae	lamiàcia
parva	parva
gallo	gallo
kafka	kafka
sonora	sonora
leiden	leiden
truncata	truncata
hubert	hubert
thwaites	thwaites
gagea	gagea
schumacher	schumacher
bertrand	bertrand
turin	torí
tibialis	tibialis
wikitext	wikitext
valentin	valentin
valentin	valentín
thriller	thriller
holly	holly
sensu	sensu
fidel	fidel
ivanovich	ivànovitx
ash	cendra
brittany	bretanya
benoist	benoist
gentry	gentry
pohl	pohl
wickes	wickes
giặt	bugaderia
wrestlemania	wrestlemania
middlesbrough	middlesbrough
barker	barker
gurevich	gurévitx
philipp	philipp
andre	andre
andre	andré
hibiscus	hibiscus
barton	barton
pierce	pierce
rfc	rfc
dactylorhiza	dactylorhiza
catania	catania
scandens	scandens
falcata	falcata
canary	canàries
canary	canari
karst	carst
cynanchum	cynanchum
santana	santana
logroño	logroño
logroño	logronyo
hilton	hilton
smithii	smithii
paniculata	paniculata
sexy	sexy
vinyl	vinil
uloborus	uloborus
cược	aposta
lars	lars
jia	jia
krasnodar	krasnodar
wikimapia	wikimapia
chẻ	forat
formosana	formosana
rainer	rainer
vilnius	vílnius
trieste	trieste
pharaon	faraons
miers	miers
phineas	phineas
sirius	sírius
sirius	sirius
arafat	arafat
bèo	agafo
bèo	penós
leonid	leonid
fuller	fuller
kino	kino
phoebe	phoebe
concorde	concorde
fernald	fernald
micrantha	micrantha
benevento	benevent
seok	seok
cervus	cervus
boleslav	boleslav
brevipes	brevipes
sec	sec
natalie	natalie
barca	barca
cassini	cassini
halloween	halloween
midland	midland
narcissus	narcissus
narcissus	narcís
nottingham	nottingham
angelica	angelica
labrador	labrador
shinichi	shinichi
shinichi	kudo
malesia	malèsia
mono	mono
charlton	charlton
rót	pour
skin	pell
doyle	doyle
saturn	saturn
container	contenidor
container	recipient
kerch	kertx
thom	thom
jihlava	jihlava
ocotea	ocotea
gamespot	gamespot
nitrat	nitrat
eight	vuit
cobain	cobain
leigh	leigh
hogg	hogg
núm	estrènyer
núm	mugrons
cody	cody
mitra	mitra
biếng	mandrós
shiva	shiva
shiva	siva
phlegra	phlegra
merlin	merlí
merlin	merlin
gmelin	gmelin
vesoul	vesoul
officiel	officiel
anchor	àncora
anchor	ancoratge
ascii	ascii
vice	vici
vice	vice
phillip	phillip
surrey	surrey
barset	barset
bolzano	bolzano
martinez	martinez
martinez	martínez
nmi	nmi
phalaenopsis	phalaenopsis
teaser	teaser
gill	gill
hilaire	hilaire
hilaire	alari
globe	globus
globe	globe
edison	edison
orton	orton
djokovic	đoković
chằng	lligament
oppenheimer	oppenheimer
cyanea	cyanea
sẹo	cicatrius
sẹo	cicatriu
bravo	bravo
tahiti	tahiti
bauer	bauer
eurovision	eurovision
wolfsburg	wolfsburg
kalinin	kalinin
lateralis	lateralis
celt	celt
hopper	hopper
goa	goa
hyperolius	hyperolius
nicholson	nicholson
dhabi	dhabi
guderian	guderian
tigris	tigris
mladá	mladá
soft	suaus
soft	soft
soft	suau
caproni	caproni
laguna	laguna
engelm	engelm
theodosius	teodosi
satyrium	satyrium
ornatus	ornatus
coca	coca
coca	coca
králové	králové
estadio	estadi
pixel	píxel
pixel	píxels
jörg	jörg
brevis	brevis
breed	raça
cronquist	cronquist
philippi	filipos
titlestyle	titlestyle
lcd	lcd
sphinx	sphinx
sphinx	esfinx
tsubasa	tsubasa
crimea	crimea
breslau	breslau
factbook	factbook
bonus	bonus
bonus	gratificació
bonus	bonificació
flavipes	flavipes
thanatus	thanatus
điốt	díode
abkhazia	abkhàzia
varde	varde
gardenia	gardenia
mồm	desembocadura
mồm	boca
genista	genista
pepper	pebrot
pepper	pebre
hrsg	hrsg
jammu	jammu
griff	griff
koh	koh
dome	cúpula
ramsey	ramsey
infinity	infinit
infinity	infinitat
hayes	hayes
waterhouse	waterhouse
lombard	lombard
bịp	truc
molina	molina
forrest	forrest
chòi	bungalow
chòi	cabina
chòi	cabana
tankōbon	tankōbon
ciliata	ciliata
andrés	andrés
medieval	medieval
tonumber	tonumber
cornelius	corneli
brie	brie
robbie	robbie
sally	sally
tolna	tolna
zurich	zuric
zurich	zurich
choáng	resolutòries
choáng	paralitzant
dressler	dressler
jaén	jaen
mứt	jam
mứt	melmelada
patton	patton
drew	drew
bernhard	bernhard
dentata	dentata
tna	tna
hpa	hpa
benny	benny
elongatus	elongatus
cherokee	cherokee
hindenburg	hindenburg
smile	somriure
attila	attila
leverkusen	leverkusen
tbilisi	tbilisi
plutoni	plutoni
rugby	rugby
rugby	rugbi
kira	kira
oxalis	oxalis
kaoru	wada
marguerite	marguerite
navbox	navbox
laden	laden
benito	benito
aka	àlies
ramesses	ramses
ramesses	ramsès
ambulyx	ambulyx
ngứa	picor
ngứa	urpes
aeroflot	aeroflot
rebecca	rebecca
satoshi	satoshi
stones	pedres
panorama	panorama
chilensis	chilensis
ngấm	abocades
trumpet	trompeta
desc	desc
martens	martens
pot	olla
striatus	striatus
heian	heian
patterson	patterson
sengoku	sengoku
obi	obi
alma	alma
bốt	botes
haryana	haryana
gsm	gsm
hwan	hwan
lysimachia	lysimachia
homer	homer
smaragdina	smaragdina
weasley	weasley
myers	myers
kombat	kombat
fourier	fourier
orchis	orchis
příbram	příbram
tivi	televisió
prinz	prinz
gifford	gifford
argentine	argentina
argentine	argentí
parallelia	dysgonia
benin	benín
sar	sar
intercontinental	intercontinental
tina	tina
saddam	saddam
mystery	misteri
ruth	ruth
carolyn	carolyn
psv	psv
monde	monde
hyllus	hyllus
lehr	lehr
picasso	picasso
bien	visible
bien	visibles
bien	bien
hoffmann	hoffmann
hinton	hinton
heather	heather
geo	geo
sussex	sussex
joey	joey
nuremberg	nuremberg
silicon	silici
silicon	silicona
isabel	isabel
damascus	damasc
batista	batista
velutina	velutina
highland	highland
olt	òlt
avenue	avinguda
cordata	cordata
aspx	aspx
tardieu	tardieu
toyotomi	toyotomi
anemia	anèmia
schwarzenegger	schwarzenegger
chatham	chatham
niels	niels
havlíčkův	havlíčkův
imp	gnom
frazione	frazione
bandai	bandai
holmberg	holmberg
vaucluse	valclusa
smackdown	smackdown
kalimantan	kalimantan
sinai	sinaí
shirak	shirak
huelva	huelva
albus	albus
pmid	pmid
magadi	magadi
beckham	beckham
xuyến	torus
reyes	reyes
gin	gin
camille	camille
wendy	wendy
medicago	medicago
blackwell	blackwell
phoiac	phoiac
oxit	òxid
eteeq	eteeq
echo	eco
echo	ressó
echo	echo
multiflora	multiflora
gneisenau	gneisenau
tbs	tbs
holiday	holiday
holiday	festiu
ribera	ribera
dornier	dornier
eckl	eckl
chocolate	xocolata
transistor	transistor
supermarine	supermarine
exilis	exilis
timur	timur
echinopsis	echinopsis
hemingway	hemingway
táp	mossega
táp	mossegada
chapuis	chapuis
spl	spl
psoe	psoe
capcom	capcom
viz	viz
hybrid	híbrid
euonymus	euonymus
bittorrent	bittorrent
gibbs	gibbs
pushkin	puixkin
neutrino	neutrí
elton	elton
griswold	griswold
herminia	herminia
platanthera	platanthera
circus	circ
subspecies	subespècie
montpellier	montpeller
atatürk	atatürk
dawson	dawson
stress	estrès
sei	sei
sei	zay
baiano	baiano
tak	tak
aet	aet
pattern	patró
etheostoma	etheostoma
greece	grècia
oliva	oliva
brain	cervells
ferb	ferb
levant	levante
fragilis	fragilis
spodoptera	spodoptera
vila	vila
sapporo	sapporo
davao	davao
manduca	manduca
bazan	bazan
buchanan	buchanan
rodriguez	rodríguez
vyazma	viazma
sandy	sandy
fra	fra
cuốc	atzar
cuốc	aleatòria
cuốc	aleatori
cuốc	aixada
ftp	ftp
desmond	desmond
paranaense	paranaense
melaleuca	melaleuca
terra	tera
tudor	tudor
nigripes	nigripes
wikisource	viquitexts
javanica	javanica
hosakote	kodagu
neville	neville
novara	novara
champs	champs
charmed	seduït
ceylon	ceylon
menu	menú
menu	menús
menu	menus
kelvin	kelvin
korlević	korlević
klug	klug
poltava	poltava
sergio	sergio
hawking	hawking
pitt	pitt
orlicí	orlicí
quezon	quezon
nihon	nihon
medium	mitjà
jakob	jakob
somali	somàlia
somali	somali
shane	shane
cal	cal
guettarda	guettarda
hardcore	hardcore
sizedefault	sizedefault
lons	lons
waltz	vals
moreno	moreno
telegraph	telègraf
milk	llet
stadion	stadion
leucas	leucas
daphne	daphne
jackie	jackie
livingston	livingston
grisea	grisea
agelena	agelena
noroeste	noroeste
wollaston	wollaston
thierry	thierry
rupestris	rupestris
gracilipes	gracilipes
serena	serena
graz	graz
fiorentina	fiorentina
malus	pomera
malus	malus
flo	flo
mons	mons
cessna	cessna
quest	quest
kangaroo	cangur
kangaroo	cangurs
chrome	chrome
calophyllum	calophyllum
ismail	ismail
saratoga	saratoga
siamensis	siamensis
irkutsk	irkutsk
liếm	llepar
liếm	llepa
isla	isla
intermedius	intermedius
debilis	debilis
alejandro	alejandro
friuli	friül
lancashire	lancashire
muscicapidae	muscicapidae
albedo	albedo
infinite	infinit
infinite	infinites
infinite	infinits
infinite	infinita
castello	castello
myspace	myspace
erythroxylum	erythroxylum
buri	buri
zhao	zao
draco	draco
gloucester	gloucester
bács	bács
calamagrostis	calamagrostis
puget	puget
sarajevo	sarajevo
baert	baert
macrocarpa	macrocarpa
marvin	marvin
inn	inn
inn	hostal
sonny	sonny
neill	neill
esp	esp
encyclopædia	encyclopædia
aguilar	aguilar
drassodes	drassodes
gore	gore
hayashi	hayashi
kadokawa	kadokawa
fuscus	fusc
sega	sega
kapellen	kapellen
phuket	phuket
donna	donna
pham	pham
kauai	kauai
halle	halle
basalis	basalis
notodontidae	notodontidae
ulrich	ulrich
checkuser	checkuser
alston	alston
gap	gap
tirana	tirana
karelia	carèlia
beaumont	beaumont
hàu	ostra
muhlenbergia	muhlenbergia
mourinho	mourinho
thulin	thulin
ogg	ogg
ulsan	ulsan
frances	frances
rigida	rigida
adriatic	adriatic
viva	viva
conmebol	conmebol
cafe	cafè
cafe	cafe
farm	granja
kwang	kwang
vanilla	tro
lepidium	lepidium
société	société
extreme	extrem
extreme	extrema
extreme	extreme
bilbao	bilbao
bun	búlgar
bun	booleà
bun	bun
auschwitz	auschwitz
multi	multi
iskandar	iskandar
wiedemann	wiedemann
paphiopedilum	paphiopedilum
newark	newark
isidro	isidro
armour	armadura
woody	woody
fat	fat
fat	greix
luffy	luffy
corleone	corleone
mẹo	consells
mẹo	punta
mẹo	propina
seymour	seymour
haw	haw
browne	browne
monogatari	monogatari
racemosa	racemosa
wilde	wilde
glycine	glicina
plato	plató
olympus	olympus
tashkent	taixkent
hcl	hci
lex	lex
fukushima	fukushima
orito	orito
episodes	episodis
muñoz	muñoz
herb	herb
ringo	ringo
nicola	nicola
burgundy	borgonya
renault	renault
mew	mew
minami	minami
bleach	lleixiu
avengers	avengers
weiss	weiss
rousseau	rousseau
tournefortia	tournefortia
mecca	meca
cobos	cobos
kamakura	kamakura
augsburg	augsburg
switch	interruptor
switch	canvia
herald	herald
fide	fide
dickinson	dickinson
melanie	melanie
holloway	holloway
hume	hume
tama	tama
kar	kar
ngơ	ignorant
muse	muses
muse	musa
chamberlain	chamberlain
bruch	bruch
gala	gala
bye	adéu
cằm	barbeta
cằm	chin
pioneer	pioneer
paula	paula
imdb	imdb
toulon	toló
romano	romano
wizard	assistent
selim	selim
yom	yom
elliptica	elliptica
damian	damià
damian	damian
bedford	bedford
hokage	hokage
haifa	haifa
cash	cash
cash	efectiu
sorbonne	sorbona
lugo	luco
lugo	lugo
runner	runner
runner	corredor
teo	teo
villanueva	villanueva
twilight	crepuscle
asclepias	asclepias
kenji	kenji
leme	leme
hispaniola	hispaniola
dorsalis	dorsalis
entropy	entropia
nur	nur
voltaire	voltaire
nhăn	arruga
robson	robson
méneville	méneville
mask	màscara
merton	merton
coa	coa
cluj	cluj
sinclair	sinclair
asparagus	espàrrec
asparagus	espàrrecs
rojas	rojas
salmon	salmó
rufipes	rufipes
dahl	dahl
nhả	alliberació
nhả	alliberament
charlemagne	carlemany
thùa	agave
heathrow	heathrow
jenkins	jenkins
minneapolis	minneapolis
pack	envàs
pack	manada
pack	pack
shorea	shorea
tbd	tbd
machado	machado
purpurascens	purpurascens
modena	mòdena
lions	lions
lions	lleons
kitty	kitty
schneid	schneid
omer	omer
sholokhov	xólokhov
belisana	belisana
petersen	petersen
mona	mona
elsa	elsa
estados	estados
madeleine	madeleine
baba	baba
backstreet	backstreet
tulagi	tulagi
taczanowski	taczanowski
saunier	saunier
campagne	campagne
kana	kana
alagoas	alagoas
coventry	coventry
lathyrus	lathyrus
pbs	pbs
pau	pau
taub	taub
ararat	ararat
lhasa	lhasa
gyeongsang	gyeongsang
ito	ito
calvert	calvert
bethune	bethune
polymer	polímer
nolan	nolan
kom	kom
fitzgerald	fitzgerald
treviso	treviso
romeo	romeu
didier	didier
liguria	liguria
joyce	joyce
coccinea	coccinea
wai	wai
meet	conèixer
alexis	alexis
hajime	hajime
espiritu	espiritu
kin	kin
avenger	flagell
greenwich	greenwich
caserta	caserta
holub	holub
kinabalu	kinabalu
nepalensis	nepalensis
usaf	usaf
asen	asen
titus	tit
titus	titus
rhacophorus	rhacophorus
hayek	hayek
messenger	missatger
messenger	messenger
lagos	lagos
stream	riera
petra	petra
palmas	palmas
gatwick	gatwick
oldenburg	oldenburg
jacobs	jacobs
ngẫm	mastegar
reims	reims
ensign	alferes
sio	sio
carlsen	carlsen
ericsson	ericsson
phalanx	phalanx
gerard	gérard
gerard	gerrard
gerard	gerard
yerevan	erevan
bergman	bergman
cast	elenc
cast	repartiment
oran	orà
ortiz	ortiz
bogotá	bogotà
focke	focke
constance	constança
boca	boca
roem	roem
nếm	gust
nếm	tastat
nếm	tast
nếm	degustació
pusillus	pusillus
guetta	guetta
simoni	simoni
swinhoe	swinhoe
dhaka	dhaka
seem	sem
amour	amour
zara	zara
richelieu	richelieu
