chat	sembang
chat	bual
chat	chat
zen	zen
goth	goth
goth	gothic
scarlett	scarlett
derek	derek
belgrade	volgograd
belgrade	belgrade
teresa	teresa
đuốc	obor
đuốc	obor
bibliography	bibliografi
tru	howling
tru	ugut
katy	katy
jeremy	jeremy
léon	léon
nakamura	nakamura
veronica	veronica
vision	penglihatan
vision	visi
glenn	glenn
manning	manning
mận	plum
mận	plum
nách	ketiak
nách	ketiak
hartmann	hartmann
firenze	firenze
polish	polish
polish	poland
elvis	elvis
benson	benson
sting	sengat
royce	royce
hesse	hesse
mayer	mayer
marcos	marcos
française	française
kırklareli	kırklareli
greenwood	greenwood
parks	taman
xốp	foam
xốp	buih
ilyushin	ilyushin
sưởi	mantel
holocaust	holocaust
lucien	lucien
lisbon	lisbon
reggio	reggio
hyderabad	hyderabad
dion	dion
kay	kay
paramount	paramount
ellen	ellen
benton	benton
baron	baron
hít	breathe
hít	bernafas
continental	continental
continental	benua
sato	sato
rus	rus
canaria	canaria
nexus	nexus
nexus	pertalian
magiê	magnesium
kabul	kabul
còi	buzzer
còi	wisel
pre	pre
pre	pra
preston	preston
phraya	phraya
emi	emi
ulithi	ulithi
luca	luca
aria	aria
saitama	saitama
jake	jake
acanthodelta	achaea
ferruginea	ferruginea
bel	bel
brabant	brabant
cave	gua
brandt	brandt
villosa	villosa
jensen	jensen
tito	tito
lille	lille
splendens	splendens
herrera	herrera
fairy	fairy
vahl	vahl
gustave	gustave
wembley	wembley
vale	vale
mustang	mustang
wwf	wwf
berger	berger
ballet	ballet
ballet	balet
bali	bali
click	klik
malay	melayu
burke	burke
habana	habana
baldwin	baldwin
glauca	glauca
gomez	gomez
diva	diva
mills	mills
vogel	vogel
exo	exo
aquila	aquila
riley	riley
prain	prain
apache	apache
swaziland	swaziland
ngất	pitam
ngất	pengsan
thymus	timus
kirk	kirk
villers	villers
dem	dem
cfg	cfg
humboldt	humboldt
angels	malaikat
cincinnati	cincinnati
stein	stein
jalisco	jalisco
linden	linden
ada	adda
ada	ada
albion	albion
wade	wade
strong	strong
strong	kukuh
strong	kuat
wto	wto
gould	gould
morales	morales
pixar	pixar
campos	campos
kohl	kohl
gardens	gardens
quincy	quincy
ornata	ornata
shizuoka	shizuoka
paz	paz
dante	dante
pilosa	pilosa
gérard	gérard
fury	fury
savage	liar
savage	biadab
maculatus	maculatus
hogwarts	hogwarts
oahu	oahu
moy	moy
gil	gil
cabo	cabo
jolie	jolie
rolls	rolls
rolls	gulung
kota	kota
bauhinia	bauhinia
alessandro	alessandro
log	log
parms	parms
springer	springer
barnard	barnard
sabre	sabre
thebes	thebes
claudius	claudius
schulz	schulz
bari	bari
plasma	plasma
versicolor	panau
sturm	sturm
nathan	nathan
avro	avro
taekwondo	taekwondo
taekwondo	taekwando
shinsengumi	shinsengumi
turk	turk
patricia	patricia
eduard	eduard
bufonidae	bufonidae
yangon	yangon
calamus	jerangau
enrique	enrique
strike	strike
strike	mogok
ranger	ranger
ranger	renjer
yard	ela
yard	yard
bucharest	bucharest
konstantinos	constantine
int	int
shelby	shelby
lufthansa	lufthansa
taken	direbut
taken	diambil
taken	taken
rufus	rufus
connor	connor
dynamo	dinamo
harrier	harrier
hon	hon
hon	say
hon	sayang
hon	dear
ôliu	zaitun
ôliu	zaitun
nola	nola
liechtenstein	liechtenstein
shakira	shakira
benoit	benoit
rabaul	rabaul
richland	richland
atlantique	atlantique
cromwell	cromwell
queens	queens
cello	selo
cello	cello
robertson	robertson
ser	ser
rán	menggoreng
rán	goreng
rán	fry
quầy	chef
hae	hae
dracula	dracula
metropolitan	metropolitan
capparis	capparis
vendée	vendée
tonga	tonga
andaman	andaman
territoire	territoire
pass	watch
pass	tonton
pass	lulus
baja	baja
dam	dam
dam	empangan
yeltsin	yeltsin
lori	lori
canyon	canyon
canyon	ngarai
malacca	melaka
lineata	lineata
walther	walther
christie	christie
oeste	oeste
dominique	dominique
garnier	garnier
ultimate	ultimate
ultimate	muktamad
dieu	dieu
gleason	gleason
crimean	crimea
crimean	crimean
chấu	belalang
quentin	quentin
marlborough	marlborough
uta	uta
fleet	armada
prodcode	prodcode
tours	pelancongan
tours	tours
reeder	reeder
macquart	macquart
girona	girona
hokkaido	hokkaido
hokkaido	hokkaidō
tales	tales
canadensis	canadensis
maldives	maldives
rennes	rennes
castellón	castellón
javier	javier
brod	brod
sharon	sharon
rosario	rosario
suite	deretan
suite	suite
suite	suit
rollins	rollins
clair	clair
antwerp	antwerp
sevastopol	sevastopol
aurea	aurea
jeju	jeju
mirror	cermin
mirror	mirror
diếp	lettuce
lesotho	lesotho
aristotle	aristotle
maslin	maslin
ultra	ultra
xxx	xxx
arcade	arked
ústí	ústí
kolkata	kolkata
reef	karang
reef	laya
reef	terumbu
wasp	penyengat
wasp	wasp
wasp	tebuan
boong	deck
boong	dek
boong	deck
spectabilis	spectabilis
pratt	pratt
andalusia	andalusia
lindau	lindau
kawasaki	kawasaki
amanda	amanda
malcolm	malcolm
joker	joker
yves	yves
goethe	goethe
winchester	winchester
winchester	winchester
cnn	cnn
guillaume	guillaume
cúi	dibengkokkan
juss	juss
thây	zombie
thây	zombi
kant	kant
japonicus	japonicus
chum	chum
granit	granit
nhấp	mengklik
nhấp	diklik
nhấp	klik
fallax	fallax
chronicle	kronik
birdlife	birdlife
turku	turku
bradford	bradford
gaius	gaius
seki	seki
ekaterina	ekaterina
shark	shark
shark	jerung
flagstaff	flagstaff
ein	ein
messina	messina
infraclassis	infraclassis
sếu	kren
sếu	bangau
sếu	crane
sếu	kren
mandela	mandela
metallica	metallica
ramírez	ramírez
kanagawa	kanagawa
burret	burret
asm	asm
xiếc	circus
xiếc	sarkas
dom	dom
gigas	gigas
dae	dae
altlink	altlink
erwin	erwin
belfast	belfast
linn	linn
joy	joy
joy	kegembiraan
verdun	verdun
macau	macau
sint	sint
bryansk	bryansk
hare	kelinci
hare	lepus
hare	hare
jasper	jasper
nba	nba
tristis	tristis
plata	plata
phở	pho
trafford	trafford
emirates	emiriah
emirates	emirates
terme	terme
sum	sum
swiss	switzerland
swiss	swiss
chin	dagu
chin	chin
himmler	himmler
ahn	ivanov
ahn	ahn
dĩa	plate
dĩa	lempeng
dĩa	plat
dĩa	piring
valenciennes	valenciennes
düsseldorf	dusseldorf
düsseldorf	dusseldorf
usda	usda
lives	nyawa
lives	lives
tyson	tyson
sonic	sonic
johor	johor
agm	agm
dượng	vernon
cecil	cecil
larvae	larva
besançon	besançon
javascript	javascript
takeda	takeda
mercedes	mercedes
sigma	sigma
adventures	adventures
adventures	pengembaraan
ryū	ryū
ubuntu	ubuntu
kagoshima	kagoshima
tallinn	tallinn
vito	vito
peruviana	peruviana
varese	varese
sparrow	pipit
banh	bola
banh	bebola
yucatán	yucatan
heli	helium
wakayama	wakayama
wii	wii
orléans	orléans
amazonas	amazonas
almería	almería
ponte	ponte
martínez	martínez
thames	thames
guadeloupe	guadeloupe
@yahoo	@yahoo
jma	jma
cumberland	cumberland
lamarck	lamarck
btr	btr
serv	serv
leslie	leslie
mụn	jerawat
mụn	jerawat
mụn	jerawat
kirby	kirby
mustafa	mustafa
romero	romero
messerschmitt	messerschmitt
pittsburgh	pittsburgh
saladin	saladin
asturias	asturias
weimar	weimar
synonym	sinonim
yoshida	yoshida
vaughan	vaughan
gauss	gauss
gauss	gauss
sakhalin	sakhalin
esp}}	esp}}
banner	sepanduk
banner	banner
banner	panji
pallas	pallas
seth	seth
regia	regia
wikidata	wikidata
pao	paun
pao	lbs
pao	kg
pao	pao
mega	mega
tơi	pembaikan
tơi	memperbetulkan
mindanao	mindanao
nigricans	nigricans
claire	claire
maru	maru
trias	trias
meridionalis	meridionalis
africanus	africanus
heliconia	heliconia
hindi	hindi
tango	tango
tribus	tribus
montréal	montreal
desmodium	desmodium
makoto	makoto
dubia	dubia
empires	empayar
jesse	jesse
walsh	walsh
hey	amboi
adrian	adrian
indicus	indicus
kagome	kagome
prescott	prescott
ark	ark
ark	bahtera
albrecht	albrecht
marsh	marsh
suwon	suwon
gómez	gomez
gómez	gómez
leach	leach
coldplay	coldplay
české	české
olga	olga
carnegie	carnegie
kwon	kwon
yamaguchi	yamaguchi
brit	britt
brit	brit
rod	rod
bờm	mane
hermione	hermione
phẩy	koma
zeno	zeno
mussolini	mussolini
amazing	amazing
amazing	mengkagumkan
nhờn	berminyak
nhờn	berminyak
joshua	joshua
earl	earl
demetrios	demetrius
amber	amber
amber	ambar
nhk	nhk
montevideo	montevideo
neon	neon
hoon	hoon
kenny	kenny
hanoi	hanoi
richter	richter
gamble	judi
gamble	berjudi
shiki	shiki
kurd	kurd
mercer	mercer
bethlehem	bethlehem
invincible	kebal
sidi	sidi
mainz	mainz
pygmaea	pygmaea
tracy	tracy
imf	imf
blanchard	blanchard
mickey	mickey
grenada	grenada
xml	xml
antigua	antigua
claudia	claudia
shogun	shogun
aung	aung
toei	toei
dynamics	dinamik
disa	disa
stella	stella
sunda	sunda
sunda	sundae
stoke	stoke
baku	baku
car	car
car	kereta
eduardo	eduardo
quăng	baling
quăng	balingan
yen	yen
sedis	sedis
werder	werder
seal	mohor
seal	meterai
seal	seal
elliot	elliot
pasteur	pasteur
albany	albany
achaea	achaea
bloch	bloch
yoga	yoga
albacete	albacete
blade	blade
blade	bilah
gundam	gundam
mat	makanan
mat	tikar
mat	mat
nuevo	nuevo
disco	disco
disco	disko
rufa	rufa
heinkel	heinkel
pounder	pounder
gsub	gsub
asp	asp
penny	penny
yuki	yuki
namedata	namedata
quýt	mandarin
sunni	sunni
eve	hawa
eve	eve
minamoto	minamoto
node	nod
hacker	hacker
hacker	penggodam
hacker	hacker
hacker	penggodam
hacker	hack
sendai	sendai
tiberius	tiberius
christophe	christophe
ming	venue
ming	ming
engels	engels
znojmo	znojmo
lynn	lynn
olomouc	olomouc
durham	durham
chae	chae
chong	chong
hót	menyanyi
hót	bernyanyi
hót	nyanyian
hót	bernyanyi
coloma	coloma
thor	thor
padova	padua
padova	padova
ovata	ovata
incertae	incertae
ruby	ruby
dwight	dwight
selena	salina
selena	selena
comoros	comoros
fulton	fulton
xavier	xavier
blücher	blücher
candy	candy
superordo	superordo
sheridan	sheridan
pauly	pauly
xòe	tutu
griffin	griffin
fao	fao
iğdır	iğdır
vtc	vtc
menzies	menzies
khuấy	dikacau
khuấy	kekalutan
khuấy	aduk
konstantin	konstantin
boa	boa
cube	kiub
cube	cube
r}}	r}}
emil	emil
rahman	rahman
glen	glen
klaus	klaus
gorbachev	gorbachev
resort	resort
resort	istirehat
corinna	corinna
benz	benz
hampton	hampton
chandler	chandler
williamson	williamson
pers	pers
papilionidae	papilionidae
göring	goering
göring	goring
samar	samar
quinn	quinn
taira	taira
castel	castel
bmw	bmw
sumer	sumeria
irene	irene
cartoon	kartun
cartoon	cartoon
penang	penang
gớm	keradangan
zeller	zeller
scheer	scheer
oberösterreich	oberösterreich
vocals	vokal
kahn	kahn
toro	toro
gaon	gaon
sủa	salak
sủa	menyalak
sủa	menyalak
sủa	menyalak
carr	carr
betty	betty
wilkinson	wilkinson
cholesterol	kolestrol
cholesterol	kolesterol
constantinople	constantinople
allmusic	allmusic
chihuahua	chihuahua
chihuahua	chihuahua
ancona	ancona
descartes	descartes
tran	tran
madeira	madeira
micro	micro
micro	mikro
micro	mikrofon
thìa	sudu
thìa	sudu
bath	mandian
bath	mandi
bath	bath
blanc	blanc
medici	medici
gien	gen
gien	gen
cornwall	cornwall
uae	uae
scharnhorst	scharnhorst
bains	bains
marche	marche
bremer	bremer
hormone	hormone
hormone	hormon
hormone	hormon
udine	udine
kan	kan
gập	lipatan
gập	lipat
lens	lens
lens	kebocoran
beirut	beirut
hahn	hahn
yamada	yamada
dot	dot
andersson	andersson
elip	elips
lafayette	lafayette
willem	willem
tatar	tatar
boom	bang
boom	boom
luigi	luigi
boone	boone
dumbledore	dumbledore
reo	rang
reo	syak
reo	kemusykilan
reo	ragu
reo	berdengung
garrison	garrison
khun	khun
fiction	fiksyen
sidney	sidney
musashi	musashi
pluto	pluto
adobe	adobe
lexikon	lexikon
shizuka	shizuka
lindsey	lindsey
hyundai	hyundai
direct	direct
primula	primula
vermont	vermont
sụn	rawan
craven	craven
kato	kato
nomura	nomura
diane	diane
thrace	thrace
rivière	rivière
borealis	borealis
anders	anders
sugar	gula
bouchet	bouchet
doc	dok
doc	doc
budějovice	budějovice
khalip	khalifah
khalip	caliph
antiochos	antiochus
schalke	schalke
kyushu	kyushu
cremona	cremona
handel	handel
turing	turing
talbot	talbot
piston	piston
piston	piston
admiralty	admiralti
cattleya	cattleya
kyle	kyle
emerton	emerton
dale	dale
gloria	gloria
oder	oder
lange	lange
dakshin	dakshin
shannon	shannon
liti	litium
mehmed	mehmed
cayman	calgary
cayman	cayman
summit	summit
summit	kemuncak
martinique	martinique
villiers	villiers
gotha	gotha
wanda	wanda
wilcox	wilcox
martino	martino
obscurus	obscurus
saxophone	saksofon
friedman	friedman
vanessa	vanessa
baghdad	baghdad
haas	haas
ryukyu	ryukyu
kanon	kanon
schwartz	schwartz
hohenzollern	hohenzollern
para	para
howell	howell
tolstoy	tolstoy
palawan	palawan
neptune	neptune
jupiter	musytari
jupiter	jupiter
velvet	velvet
mia	mia
alfonso	alfonso
lara	lara
bromley	bromley
proxy	proksi
djibouti	djibouti
hattori	hattori
training	latihan
training	training
musa	musa
acta	acta
akb	akb
californica	californica
marcello	marcello
kırıkkale	kırıkkale
gilles	gilles
shogakukan	shogakukan
norodom	norodom
funk	funk
robustus	robustus
shepard	shepard
zanzibar	zanzibar
lil	lil
dmitry	dmitry
boisduval	boisduval
apiaceae	apiaceae
randolph	randolph
#tôi	#ku
#tôi	#aku
oakland	oakland
toscana	tuscany
ambrose	ambrose
aurelius	aurelius
antioquia	antioquia
sheikh	sheikh
sheikh	syeikh
krai	krai
krai	jajahan
gear	tempo
gear	kelengkapan
gear	gear
gear	kelajuan
olympique	olympique
benedict	benedict
palmer	palmer
irving	irving
trau	letih
trau	penat
bison	bison
lat	lat
lat	malas
coruña	coruña
wigan	wigan
crane	bangau
crane	crane
crane	kren
ôtô	cars
ôtô	kereta
fulva	fulva
nobilis	nobilis
darren	darren
duméril	duméril
beaver	memerang
beaver	berang
paulus	paulus
chopin	chopin
canterbury	canterbury
gerhard	gerhard
ariel	ariel
fujiwara	fujiwara
fasciatus	fasciatus
maxima	maxima
indie	indie
konrad	konrad
castillo	castillo
kung	kung
championships	kejohanan
animax	animax
beograd	belgrade
martha	martha
bloom	mekar
marius	marius
espírito	espírito
helmut	helmut
avril	avril
kure	kure
khuya	terlewat
khuya	mendiang
khuya	late
khuya	lambat
khuya	larut
suffolk	suffolk
liststyle	liststyle
kilis	kilis
niken	nikel
kimi	kimi
beaufort	beaufort
maui	maui
tone	nada
tone	tone
rue	rue
michoacán	michoacán
ferrari	ferrari
stan	stan
loi	loi
regina	regina
laporte	laporte
cherry	cherry
cherry	ceri
cherry	ceri
scout	pengakap
coburg	coburg
lozère	lozère
pereira	pereira
borneensis	borneensis
interscope	interscope
bruxelles	bruxelles
bruxelles	brussels
gaston	gaston
clannad	clannad
sakai	sakai
fairey	fairey
curie	curie
chuck	chuck
dora	dora
aerospace	aeroangkasa
benn	benn
donau	danube
donau	donau
dengeki	dengeki
romagna	romagna
bergen	bergen
hora	hora
laevis	laevis
scottish	scotland
sagar	sagar
turkish	halwa
turkish	turki
turkish	turkish
trinity	trinity
antigonos	antigonus
shop	kedai
shop	kedai
roche	roche
lamiaceae	lamiaceae
parva	parva
gallo	gallo
kafka	kafka
sonora	sonora
leiden	leiden
meteor	meteor
hubert	hubert
schumacher	schumacher
bertrand	bertrand
turin	turin
sylvia	sylvia
wikitext	wikitext
valentin	valentin
thriller	ngeri
thriller	thriller
holly	holly
sensu	sensu
fidel	fidel
ivanovich	ivanovich
ash	ash
ash	abu
brittany	bretagne
ret	ret
benoist	benoist
gentry	berdarjat
pohl	pohl
giặt	dobi
giặt	cucian
giặt	dicuci
wrestlemania	wrestlemania
middlesbrough	middlesbrough
barker	barker
spitfire	spitfire
gurevich	gurevich
philipp	philipp
andre	andre
andre	andré
hibiscus	hibiscus
barton	barton
pierce	menembusi
rfc	rfc
catania	catania
canary	kenari
karst	karst
santana	santana
hilton	hilton
smithii	smithii
blankname	blankname
sexy	sexy
sexy	seksi
vinyl	vinyl
cược	bet
lars	lars
jia	jia
wikimapia	wikimapia
chẻ	lubang
chẻ	hole
rainer	rainer
vilnius	vilnius
trieste	trieste
pharaon	pharaoh
miers	miers
phineas	phineas
sirius	sirius
arafat	arafat
bèo	lame
leonid	leonid
fuller	fuller
kino	kino
phoebe	phoebe
concorde	concorde
micrantha	micrantha
benevento	benevento
seok	seok
cervus	cervus
boleslav	boleslav
brevipes	brevipes
sec	sec
natalie	natalie
barca	barca
cassini	cassini
halloween	halloween
midland	midland
narcissus	narcissus
nottingham	nottingham
boson	boson
angelica	angelica
labrador	labrador
shinichi	shinichi
shinichi	kudo
malesia	malesia
mono	mono
charlton	charlton
rót	tuang
sites	tapak
skin	kulit
doyle	doyle
cedar	cedar
saturn	saturn
saturn	zuhal
container	kontena
kerch	kerch
thom	thom
jihlava	jihlava
gamespot	gamespot
tít	degar
nitrat	nitrat
hilbert	hilbert
eight	lapan
cobain	cobain
leigh	leigh
hogg	hogg
núm	perah
núm	puting
cody	cody
biếng	malas
massa	massa
shiva	shiva
shiva	siva
zing	zing
merlin	merlin
gmelin	gmelin
vesoul	vesoul
officiel	officiel
anchor	sauh
ascii	ascii
unidos	unidos
vice	timbalan
vice	naib
nymphalidae	nymphalidae
phillip	phillip
surrey	surrey
barset	barset
bolzano	bolzano
martinez	martinez
nmi	nmi
teaser	teaser
gill	gill
hilaire	hilaire
globe	glob
globe	globe
edison	edison
orton	orton
djokovic	djokovic
nógrád	nógrád
chằng	ligamen
oppenheimer	oppenheimer
sẹo	parut
sẹo	parut
bravo	bravo
tahiti	tahiti
bauer	bauer
eurovision	eurovision
wolfsburg	wolfsburg
kalinin	kalinin
celt	celt
hopper	hopper
goa	goa
nicholson	nicholson
dhabi	dhabi
guderian	guderian
tigris	tigris
mladá	mladá
soft	soft
soft	lembut
laguna	laguna
pre}}	pre}}
theodosius	theodosius
ornatus	ornate
ornatus	ornatus
coca	coke
coca	coca
králové	králové
estadio	estadio
pixel	pixel
pixel	piksel
pixel	piksel
jörg	jörg
brevis	brevis
breed	breed
breed	baka
cronquist	cronquist
philippi	philippi
titlestyle	titlestyle
lcd	lcd
sphinx	sphinx
tsubasa	tsubasa
anemone	anemone
rogue	rogue
rogue	penyangak
crimea	crimea
breslau	breslau
factbook	factbook
bonus	bonus
điốt	diod
abkhazia	abkhazia
gardenia	gardenia
mồm	mulut
burma	burma
pepper	pepper
pepper	lada
baptist	baptist
hrsg	hrsg
jammu	jammu
hsiu	hsiu
griff	griff
koh	koh
eyed	bermata
dome	kubah
dome	dome
ramsey	ramsey
infinity	infiniti
infinity	infinity
hayes	hayes
waterhouse	waterhouse
lombard	lmo
bịp	helah
molina	molina
forrest	forrest
chòi	banglo
chòi	cabin
chòi	pondok
chòi	kabin
tankōbon	tankōbon
composite	gubahan
composite	komposit
loes	loes
andrés	andrés
tonumber	tonumber
cornelius	cornelius
información	información
tvxq	tvxq
brie	brie
robbie	robbie
sally	sally
tolna	tolna
pardubice	pardubice
zurich	zurich
choáng	terpegun
choáng	bingung
jyp	jyp
jaén	jaén
mứt	jem
mứt	marmalade
patton	patton
psittacidae	psittacidae
drew	drew
bernhard	bernhard
dentata	dentata
tna	tna
hpa	hpa
benny	benny
elongatus	elongatus
cherokee	cherokee
hindenburg	hindenburg
smile	smile
smile	senyum
attila	attila
leverkusen	leverkusen
tbilisi	tbilisi
plutoni	plutonium
vandel	vandel
rochester	rochester
rugby	ragbi
kira	kira
kaoru	wada
marguerite	marguerite
navbox	navbox
laden	sarat
laden	laden
benito	benito
aka	alias
aka	aka
ramesses	ramses
ramesses	ramesses
ngứa	kegatalan
ngứa	gatal
ngứa	gatal
ngứa	cakar
aeroflot	aeroflot
rebecca	rebecca
satoshi	satoshi
stones	batu
panorama	panorama
chilensis	chilensis
schultz	schultz
prop	prop
trumpet	sangkakala
acanthaceae	acanthaceae
martens	martens
pot	periuk
pot	pot
striatus	striatus
heian	heian
mexicanus	mexicanus
obi	obi
alma	alma
bốt	boot
bốt	but
bốt	boots
haryana	haryana
gsm	gsm
hwan	hwan
pomorskie	pomorskie
homer	homer
weasley	weasley
myers	myers
ligue	ligue
hmas	hmas
kombat	kombat
fourier	fourier
allegheny	allegheny
hub	hab
hub	hub
příbram	příbram
tivi	televisyen
tivi	tv
prinz	prinz
gifford	gifford
argentine	argentina
benin	benin
sar	sar
intercontinental	intercontinental
aquino	aquino
philippinensis	philippinensis
tina	tina
saddam	saddam
rugosa	rugosa
mystery	misteri
ruth	ruth
carolyn	carolyn
psv	psv
stall	gerai
stall	stall
monde	monde
página	página
beetle	kumbang
picasso	picasso
bien	kelihatan
bien	tampak
bien	kebolehlihatan
bien	bien
bien	langit
hoffmann	hoffmann
hinton	hinton
heather	heather
geo	geografik
geo	geo
joey	joey
nuremberg	nuremberg
silicon	silikon
silicon	silicon
silicon	silikon
isabel	isabel
damascus	damascus
batista	batista
highland	highland
olt	olt
avenue	avenue
alegre	alegre
paradoxa	paradoxa
cordata	cordata
aspx	aspx
toyotomi	toyotomi
anemia	anemia
schwarzenegger	schwarzenegger
una	una
niels	niels
fountain	pancut
fountain	pancutan
havlíčkův	havlíčkův
frazione	frazione
bandai	bandai
vaucluse	vaucluse
smackdown	smackdown
kalimantan	kalimantan
sinai	sinai
pelhřimov	pelhřimov
shirak	shirak
huelva	huelva
albus	albus
pmid	pmid
magadi	magadi
beckham	beckham
xuyến	torus
reyes	reyes
gin	gin
camille	camille
wendy	wendy
blackwell	blackwell
phoiac	phoiac
oxit	oksida
eteeq	eteeq
echo	gema
echo	echo
sever	sever
gneisenau	gneisenau
tbs	tbs
holiday	percutian
holiday	holiday
ribera	ribera
dornier	dornier
chocolate	coklat
chocolate	chocolate
transistor	transistor
supermarine	supermarine
exilis	exilis
timur	timur
hemingway	hemingway
táp	menggigit
táp	gigit
táp	gigitan
psoe	psoe
capcom	capcom
viz	viz
hybrid	hibrid
hybrid	hybrid
collaris	collaris
bittorrent	bittorrent
gibbs	gibbs
canis	canis
pushkin	pushkin
neutrino	neutrino
elton	elton
griswold	griswold
fiat	fiat
circus	circus
circus	sarkas
subspecies	subspesies
montpellier	montpellier
atatürk	ataturk
dawson	dawson
ivoire	ivoire
stress	stres
stress	stress
sei	sei
baiano	baiano
tak	tak
aet	aet
pattern	pattern
pattern	corak
pattern	pola
greece	yunani
greece	greece
oliva	oliva
brain	otak
ferb	ferb
benešov	benešov
levant	syam
fragilis	fragilis
vila	vila
sapporo	sapporo
davao	davao
bazan	bazan
buchanan	buchanan
alive	alive
rodriguez	rodriguez
cent	cent
leste	leste
sandy	sandy
cuốc	rawak
cuốc	cangkul
cuốc	hoe
ftp	ftp
desmond	desmond
paranaense	paranaense
bvt	bvt
terra	tera
terra	terra
tudor	tudor
nigripes	nigripes
wikisource	wikisource
javanica	javanica
hosakote	kodagu
neville	neville
novara	novara
pal	pal
champs	champs
charmed	charmed
ceylon	ceylon
menu	menu
menu	menu
kelvin	kelvin
klug	klug
poltava	poltava
sergio	sergio
hawking	hawking
pitt	pitt
orlicí	orlicí
trier	trier
quezon	quezon
sistema	sistema
mazowieckie	mazowieckie
nihon	nihon
medium	medium
jakob	jakob
somali	somalia
somali	somalia
shane	shane
cal	cal
cool	sejuk
cool	cool
hardcore	hardcore
sizedefault	sizedefault
lons	lons
moreno	moreno
telegraph	telegraph
hcv	hcv
milk	susu
milk	milk
leucas	leucas
daphne	daphne
jackie	jackie
livingston	livingston
grisea	padi
eos	eos
heves	heves
wollaston	wollaston
thierry	thierry
rupestris	rupestris
serena	serena
graz	graz
fiorentina	fiorentina
malus	malus
haleakala	haleakala
flo	flo
mons	mons
cessna	cessna
angolensis	angolensis
across	merentasi
across	seberang
quest	quest
kangaroo	kangaroo
kangaroo	kangaroos
chrome	chrome
sakleshpur	hanbal
douglass	douglass
lucida	lucida
ismail	ismail
saratoga	saratoga
siamensis	siamensis
irkutsk	irkutsk
liếm	menjilat
liếm	jilat
liếm	menjilat
isla	isla
intermedius	intermedius
alejandro	alejandro
friuli	friuli
lancashire	lancashire
muscicapidae	muscicapidae
albedo	albedo
cundinamarca	cundinamarca
infinite	infinite
castello	castello
myspace	myspace
erythroxylum	erythroxylum
buri	buri
saab	saab
zhao	zao
draco	draco
gloucester	gloucester
bács	bács
puget	puget
hamburger	hamburger
hamburger	hamburger
sarajevo	sarajevo
breda	breda
kolín	kolín
macrocarpa	tampoi
res	res
marvin	marvin
lift	lif
lift	angkat
inn	penginapan
sonny	sonny
neill	neill
esp	esp
encyclopædia	ensaiklopedia
aguilar	aguilar
gore	gore
hayashi	hayashi
kadokawa	kadokawa
fuscus	fuscus
sega	sega
kiskun	kiskun
kapellen	kapellen
phuket	phuket
donna	donna
pham	pham
kauai	kauai
anomala	anomala
yai	yai
halle	halle
blansko	blansko
basalis	basalis
ulrich	ulrich
checkuser	checkuser
alston	alston
nitens	nitens
gap	gap
tirana	tirana
karelia	karelia
beaumont	beaumont
hàu	tiram
hàu	tiram
hàu	oyster
#the	#padang
#the	#the
erie	erie
mourinho	mourinho
ogg	ogg
ulsan	ulsan
adriatic	adriatic
viva	viva
conmebol	conmebol
cafe	coffee
cafe	kopi
cafe	cafe
assassin	pembunuh
farm	ladang
kwang	kwang
vanilla	thunder
vanilla	guruh
vanilla	petir
vanilla	vanilla
vanilla	vanila
société	société
extreme	ekstrem
extreme	melampau
bilbao	bilbao
bun	bulgaria
bun	boolean
bun	sanggul
bun	bun
multi	pelbagai
multi	berbilang
iskandar	iskandar
wiedemann	wiedemann
aragatsotn	aragatsotn
newark	newark
isidro	isidro
armour	armor
armour	armour
woody	woody
fat	platter
fat	gemuk
fat	lemak
luffy	luffy
myrtaceae	myrtaceae
andrey	andrei
corleone	corleone
mẹo	petua
mẹo	tips
mẹo	petua
metropolitana	metropolitana
pegasus	pegasus
coriacea	coriacea
seymour	seymour
haw	haw
browne	browne
monogatari	monogatari
racemosa	racemosa
wilde	wilde
glycine	glycine
plato	plato
olympus	olympus
tashkent	tashkent
lex	lex
fukushima	fukushima
orito	orito
episodes	episod
muñoz	muñoz
herb	jamu
herb	ramuan
herb	herba
ringo	ringo
nicola	nicola
burgundy	burgundy
renault	renault
mew	mew
minami	minami
bleach	bleach
avengers	avenger
avengers	avengers
weiss	weiss
rousseau	rousseau
mecca	makkah
mecca	mekah
cobos	cobos
kamakura	keshogunan
jongno	jongno
augsburg	augsburg
switch	suis
switch	switch
herald	bentara
fide	fide
dickinson	dickinson
melanie	melanie
holloway	holloway
hume	hume
tama	tama
kar	kar
ngơ	mengabaikan
muse	muse
chamberlain	chamberlain
bruch	bruch
gala	gala
kazakh	kazakh
kazakh	kazakhstan
bye	bye
cằm	dagu
cằm	chin
pioneer	perintis
pioneer	pioneer
paula	paula
imdb	imdb
toulon	toulon
romano	romano
wizard	bestari
wizard	wizard
zander	zander
selim	selim
yom	yom
elliptica	elliptica
damian	damian
hokage	hokage
strakonice	strakonice
haifa	haifa
armavir	armavir
bor	bor
cash	cash
sorbonne	sorbonne
lugo	lugo
runner	runner
teo	teo
villanueva	villanueva
twilight	senja
asclepias	asclepias
kenji	kenji
leme	leme
hispaniola	hispaniola
dorsalis	dorsalis
entropy	entropi
nur	nur
voltaire	voltaire
nhăn	kerut
robson	robson
mask	mask
mask	topeng
merton	merton
coa	coa
coa	coas
cluj	cluj
sinclair	sinclair
asparagus	asparagus
tábor	tábor
rojas	rojas
salmon	salmon
dahl	dahl
nhả	lepaskan
nhả	pelepasan
nhả	dedahkan
nhả	release
charlemagne	charlemagne
heathrow	heathrow
jenkins	jenkins
minneapolis	minneapolis
pack	pek
pack	pack
shorea	meranti
tbd	tbd
machado	machado
modena	modena
lions	singa
lions	lions
buckingham	buckingham
kitty	kitty
omer	omer
samara	samara
petersen	petersen
mona	mona
elsa	elsa
maritima	maritima
estados	estados
madeleine	madeleine
baba	baba
ost	ost
backstreet	backstreet
tulagi	tulagi
