vẫy	ওড়ানো
germania	germania
dorothy	ডরোথি
mcmahon	ম্যাকমোহন
hartley	hartley
jobs	চাকরি
jobs	চাকুরি
safari	সাফারি
safari	safari
atr	atr
bonnie	বনি
som	সোম
pictus	pictus
gnome	gnome
gnome	গনোম
guild	গিল্ড
rumble	rumble
novo	নোভো
doubleday	doubleday
vita	ভিটা
nxb	nxb
stay	থাকতে
stay	থাকার
stay	থাকা
stay	থাকে
stay	থাকুন
stay	থাকো
tripura	ত্রিপুরা
mei	মেই
gọt	খোসা
nháy	ফ্ল্যাশ
nháy	ব্যাটিং
nháy	পলক
alfredo	আলফ্রেডো
dayton	ডেটন
vulcan	vulcan
hispida	hispida
superman	সুপারম্যান
champ	champ
saints	সাধুদের
perez	পেরেজ
jerome	জেরোম
clemens	ক্লিমেন্স
gupta	গুপ্ত
hardpoint	hardpoint
nomen	nomen
trọc	টাক
meiji	মেইজি
sạc	চার্জার
sạc	চার্জ
imax	imax
fossil	ফসিল
fossil	জীবাশ্ম
rightarm	rightarm
karachi	করাচী
suvarnabhumi	সুবর্ণভূমি
commonwealth	কমনওয়েলথ
cactus	ক্যাকটাস
bourne	বোর্ন
esther	এস্থার
lester	লেস্টার
cuspidata	cuspidata
carson	কার্সন
ichi	ইচি
oss	oss
henrik	হেনরিক
geoffroy	geoffroy
sicily	সিসিলিয়ান
cream	ক্রিম
cream	ক্রীম
grimm	গ্রিম
antony	এন্টোনি
reeves	রিভস
finn	ফিন
finn	finn
colubridae	কলুব্রিডি
cassette	ক্যাসেট
laplace	লাপ্লাস
ufo	ইউএফও
mendes	মেন্ডেজ
cristiano	ক্রিস্টিয়ানো
cristiano	ক্রিশ্চিয়ানো
platinum	প্ল্যাটিনাম
platinum	প্লাটিনাম
wikitable	wikitable
gfdl	gfdl
cyprus	সাইপ্রেস
bio	জীবনী
fig	fig
nervosa	nervosa
trip	ভ্রমন
trip	ভ্রমণ
trip	ট্রিপ
trip	যাত্রা
morocco	মরোক্কো
morocco	মরক্কো
garde	গ্রেড
camden	ক্যামডেন
tara	তারা
tara	tara
shia	শিয়াদের
shia	শিয়া
hittite	hittite
airplay	airplay
eclipse	মেঘলা
accipitridae	accipitridae
penalty	পেনাল্টি
sts	sts
pinyin	pinyin
ozu	ওজু
hoover	হুভার
rodney	রডনি
foo	ফু
sida	এইডস
sida	এইডসের
sutton	সাটন
zoom	জুম
flynn	ফ্লিন
flynn	উড়ছে
gwangju	গুয়াংজু
negros	নেগ্রোস
frontalis	frontalis
lour	lour
lover	প্রেমিক
lover	প্রেমিকা
lover	প্রেমিকের
lover	প্রেমিকাকে
honshu	হোনশু
superba	চন্ডাল
tor	tor
tor	টর
tor	থর
capo	capo
blyth	ব্লাইদ
orient	ওরিয়েন্ট
hebrides	hebrides
romanov	romanov
eaton	ইটন
lakes	হ্রদ
lakes	লেক
natalia	নাতালিয়া
salazar	সালাজার
diocletianus	diocletian
gmbh	gmbh
abrams	abrams
giles	জাইলস
whole	পুরো
whole	সমগ্র
whole	গোটা
aid	এইড
râm	ছায়া
edith	এডিথ
indianapolis	ইন্ডিয়ানাপোলিস
noah	নোয়া
noah	নূহ
caucasus	ককেশাস
gillespie	গিলেস্পি
lynx	lynx
ayuntamiento	ayuntamiento
app	অ্যাপ
presley	প্রিসলি
vhs	ভিএইচএস
troll	ট্রল
osiris	ওসিরিস
caillat	caillat
sora	সোরা
ethernet	ইথারনেট
peso	পেসো
peso	পেসো
muon	চাও
muon	চান
muon	চাই
muon	চায়
shock	শক
tutu	টুটু
serviceyears	serviceyears
nhử	প্রলুব্ধ
tchaikovsky	tchaikovsky
fusion	ফিউশন
fyodor	ফিওদর
kat	ক্যাট
coffee	কফি
task	কর্ম
task	কাজ
bak	bak
tobias	টোবিয়াস
pla	প্লা
rivers	নদী
kew	kew
sorex	shrew
cctld	cctld
itf	আইটিএফ
dash	ড্যাশ
isis	আইএসআইএস
isis	আইসিস
isis	isis
trek	ট্রেক
pizza	পিৎজা
pizza	পিজা
shikoku	শিকোকু
cobra	কোবরা
unicef	ইউনিসেফ
lumia	লুমিয়া
kissinger	কিসিঞ্জার
dee	ডি
dee	দি
rsa	rsa
hockey	হকি
xỉn	মাতাল
sars	সার্স
cristatus	cristatus
vic	ভিক
nico	নিকো
fed	খাইয়ে
antoinette	antoinette
kuril	কুরিল
trevor	ট্রেভর
sherlock	শার্লক
dolby	ডলবি
avatar	অবতার
ivanov	ইভানভ
chhattisgarh	ছত্তিশগড়
briggs	briggs
julio	জুলিও
ricky	রিকি
reader	পাঠক
reader	রিডার
fortune	ফরচুন
doo	ডু
tate	টেট
baird	বেয়ার্ড
arborea	arborea
lesnar	লেসনার
wiktionary	wiktionary
rowling	রাউলিং
clyde	ক্লাইড
kiribati	কিরিবাস
shb	সাহেবের
goodman	গুডম্যান
cowboy	কাউবয়
samantha	সামান্থা
analog	অ্যানালগ
kei	kei
memoirs	memoirs
takashi	তাকাশি
shih	শিহ
kerry	কেরি
muller	মুলার
muller	muller
ramón	রামোন
merry	মেরী
chirac	শিরাক
pagan	কাফের
pagan	কাফেরদের
mendelssohn	mendelssohn
ria	রিয়া
mem	মেম
dodge	ডজ
augustine	অগাস্টিন
gangnam	গ্যাংনাম
chloris	chloris
cdma	cdma
aruba	আরুবা
hawkins	হকিন্স
monarch	সম্রাট
sala	sala
olive	অলিভ
soares	সোয়ারেস
femme	femme
tuva	tuva
bowman	বোম্যান
sqft	sqft
kitts	কিটস
magellan	ম্যাজেলানিয়
magellan	ম্যাগেলান
equus	equus
dốt	মূর্খ
dốt	অজ্ঞ
sumner	সামনার
dalmatia	dalmatia
haydn	haydn
murad	মুরাদ
escape	অব্যাহতি
escape	এস্কেপ
escape	escape
salon	পার্লার
lama	লামা
mara	mara
mara	মারা
bikini	বিকিনি
mika	মিকা
lia	লিয়া
maggie	ম্যাগি
bua	ফুফু
jürgen	ইয়ুর্গেন
siết	জড়িয়ে
siết	আদর
visa	ভিসা
button	বোতাম
button	বাটন
saline	saline
alger	শৈবাল
gong	গং
subtemplates	subtemplates
pompey	পম্পে
gerd	গের্ড
pet	পোষা
pet	পোষ্য
pet	ইন্টেলিজেন্স
pet	বুদ্ধি
pet	বুদ্ধিমত্তা
pet	বুদ্ধির
drum	ড্রাম
drum	ঢোল
amman	আম্মান
nazi	স্বেচ্ছাচারী
nazi	নাৎসি
spartan	স্পার্টান
tul	তুল
tởm	বিরক্তিকর
tởm	অসহ্য
tởm	জঘন্য
brazilian	ব্রাজিলিয়ান
brazilian	ব্রাজিলীয়
brazilian	ব্রাজিলের
ceres	সেরেস
malfoy	malfoy
bosco	বস্কো
shore	তীরে
lipid	লিপিড
prentice	প্রেন্টিস
chaos	বিশৃঙ্খলা
chaos	বিশৃঙ্খলার
umbrella	ছাতা
karaoke	কারাওকে
textcolor	textcolor
quick	কুইক
aziz	আজিজ
cramer	cramer
vargas	ভার্গাস
pomerania	পোমেরানিয়া
pomerania	westfalen
ping	পিং
ping	ping
abs	এবিএস
keller	কেলার
nod	কষ
spot	স্পট
cctv	সিসিটিভি
dar	দার
matter	মাদুর
herodotus	হিরোডোটাস
schumann	schumann
jaya	জয়া
melissa	মেলিসা
fujiko	ফুজিকো
americanus	americanus
tar	tar
tribune	ট্রিবিউন
aden	এডেন
erectus	ইরেক্টাস
elias	এলিয়াস
elias	ইলিয়াস
angus	angus
horus	হোরাস
yui	ইউই
cas	cas
cas	ক্যাস
hamas	হামাস
systematics	systematics
rutherford	রাদারফোর্ড
loc	এলওসি
merriam	মেরিয়াম
jansen	জ্যানসেন
schubert	schubert
frozen	হিমায়িত
frozen	আবদ্ধ
megapixel	মেগাপিক্সেল
dyer	ডায়ার
cauca	কাউকা
vogue	ভোগ
josephine	জোসেফিন
xíu	ক্ষুদ্র
ilyich	ইলিচ
atlantis	আটলান্টিস
dewey	ডিউই
sulu	সুলু
barbuda	বার্বুডা
akita	আকিতা
jih	jih
dreamworks	dreamworks
oliveira	অলিভেইরা
polyommatus	polyommatus
geoff	জিওফ
bark	বার্ক
mêtan	মিথেন
guru	গুরু
sanders	স্যান্ডার্স
aztec	অ্যাজটেক
potomac	পোটোম্যাক
cor	cor
spy	বমি
clem	ক্লেম
murcia	murcia
georgetown	জর্জটাউন
fermi	ফার্মি
lance	ল্যান্স
dal	ডাল
amd	এএমডি
whois	whois
vida	vida
nora	নোরা
dubius	dubius
blogger	ব্লগার
blogger	ব্লগ
stephanie	স্টেফানি
bing	বিং
shotgun	শটগান
shotgun	শটগান
kgb	কেজিবি
chapel	চ্যাপেল
commentary	ভাষ্য
commentary	ধারাভাষ্য
betta	betta
confederations	কনফেডারেশন
spice	মসলা
radiohead	রেডিওহেড
octopus	অক্টোপাস
acb	acb
reprint	পুনর্মুদ্রণ
khít	গোছানো
khít	প্যাকিং
khít	গোছগাছ
gee	গি
nubia	নুবিয়া
cinnyris	টুনি
antioch	antioch
bohol	বহল
rhodesia	rhodesia
harmony	সম্প্রীতি
diaz	ডিয়াজ
vầng	গোল্ডেন
vầng	সোনালী
tostring	tostring
odyssey	odyssey
ngo	এনজিও
sciuridae	sciuridae
progressive	প্রগতিশীল
progressive	ক্রমবর্ধমান
davidson	ডেভিডসন
ndt	ndt
murakami	মুরাকামি
cisticola	ছোটন
gaya	গায়া
olsen	ওলসেন
fairfield	ফেয়ারফিল্ড
biella	biella
superfamilia	superfamilia
boyer	বয়ার
găm	ড্যাগার
găm	চাকু
ava	আভা
riyadh	রিয়াদ
booth	বুথ
cristina	ক্রিস্টিনা
plc	পিএলসি
gerrard	জেরার্ড
negro	নেগ্রো
rum	রাম
acuta	acuta
argus	argus
vasco	ভাস্কো
futsal	ফুটসাল
authorlink	authorlink
mahmoud	মাহমুদ
pia	পিয়া
gorky	গোর্কি
steam	স্টীম
steam	বাষ্প
steam	ধোঁয়ায়
phoenicia	phoenicia
spa	স্পা
addis	আদ্দিস
thaksin	থাকসিন
belowstyle	belowstyle
vijaya	বিজয়া
tornado	টর্নেডো
vin	ভিন
chorus	কোরাস
maluku	maluku
brahms	brahms
aphrodite	আফ্রোদিতি
lone	লোন
dolly	ডলি
char	চর
kramer	ক্রেমার
wushu	wushu
rae	রে
genesis	জেনেসিস
genesis	জনন
mir	মির
mir	মীর
mogul	mogul
ogv	ogv
fernandez	ফার্নান্দেজ
gustaf	গুস্তাফ
garrett	গ্যারেট
reuters	রয়টার্স
nilsson	nilsson
officinalis	officinalis
nach	nach
hodgson	hodgson
josep	জোসেপ
providence	প্রোভিডেন্স
generic	সামগ্রিক
generic	সাধারণ
emberiza	চটক
emberiza	emberiza
ploceus	weaver
sampson	sampson
papa	পাপা
sha	শা
identity	পরিচয়
telescope	দূরবীন
collapsible	collapsible
rodgers	রজার্স
dolphin	ডলফিন
swing	দোল
swing	সুইং
pavlov	পাভলভ
martins	মার্টিন্স
frederik	frederik
aleksey	আলেক্সি
squad	স্কোয়াড
coleman	কোলম্যান
oro	অরো
steiner	steiner
ipod	ipod
packard	প্যাকার্ড
arlington	আর্লিংটন
ascoli	ascoli
stellata	stellata
biếc	nil
sedgwick	সেজউইক
brotherhood	ব্রাদারহুডের
brotherhood	ভ্রাতৃত্ব
tampa	টাম্পা
siegfried	siegfried
banda	বান্দা
vat	ভ্যাট
vat	ভিজা
vat	ভিজিয়ে
vat	ভেজা
vat	সিক্ত
vat	ভিজে
poseidon	পসেইডন
vigna	vigna
hades	হেডিস
dominic	ডমিনিক
hague	হেগ
ochracea	ochracea
pskov	pskov
richie	রিচি
satan	শয়তানের
satan	শয়তান
arch	আর্চ
groupstyle	groupstyle
piceno	piceno
liam	লিয়াম
horace	horace
mathias	mathias
hilary	হিলারী
hilary	হিলারি
hilary	হিলারী
hilary	হিলারি
mel	মেল
nest	নীড়
dress	স্যুট
aureus	aureus
guevara	গুয়েভারা
uranium	ইউরেনিয়াম
saxicola	saxicola
pinto	পিন্টো
conquest	বিজয়
claus	ক্লজ
dnepr	dnieper
daisy	ডেইজি
katie	কেটি
anthus	তুলিকা
léopold	লিওপোল্ড
pleistocene	প্লাইস্টোসিন
rubik	কিউব
rubik	ঘনক
rubik	rubik
entre	entre
madhuca	madhuca
activeusers	activeusers
ker	ker
reese	রিজ
natasha	নাতাশা
ribbon	ফিতা
ribbon	ফিতে
primeminister	primeminister
owl	পেঁচা
numberofpages	numberofpages
numberofactiveusers	numberofactiveusers
numberofadmins	numberofadmins
molly	মলি
numberofarticles	numberofarticles
numberoffiles	numberoffiles
numberofusers	numberofusers
sassari	sardinia
siêng	পরিশ্রমী
numberofedits	numberofedits
cdc	সিডিসি
vát	মাথা
vát	হেড
sanskrit	সংস্কৃত
crash	ক্র্যাশ
crash	বিপর্যয়
ulus	ulus
adsl	adsl
gaia	গাইয়া
pycnonotus	বুলবুল
hanna	হান্না
fragrans	fragrans
theropoda	থেরোপোডা
hardcover	hardcover
challenger	চ্যালেঞ্জার
zheng	ঝেং
ribosome	রাইবোজোম
cinereus	cinereus
cska	সিএসকেএ
bục	পোডিয়াম
ula	উলা
esa	esa
rết	বিছে
seasons	ঋতু
proctor	প্রক্টর
osman	ওসমান
hasan	hasan
hasan	হাসানের
hasan	হাসান
lte	এলটিই
meshid	meshid
patel	প্যাটেল
mangifera	ম্যাঙ্গিফেরা
neymar	নেইমারের
neymar	নেইমার
oecd	ওইসিডি
freud	freud
emilio	এমিলিও
asiatica	asiatica
demi	ডেমি
loop	লুপ
nasser	নাসের
rfa	nrc
sulla	sulla
naga	নাগা
vittatus	vittatus
voa	voa
rizal	রিজাল
tau	টাও
tau	tau
miocene	miocene
bmg	বিএমজি
booker	বুকার
lure	প্রলুব্ধ
raphael	রাফায়েল
ipairs	ipairs
designations	designations
ami	ami
colonial	ঔপনিবেশিক
wenger	ওয়েঙ্গার
zulu	জুলু
surabaya	সুরাবায়া
pub	পাব
platon	প্লেটো
khon	খন
khon	খোন
mccarthy	ম্যাকার্থি
sal	sal
ulmus	এলম
ulmus	elm
mora	মোরা
pyrenees	পিরেনে
cyril	সিরিল
kremlin	ক্রেমলিন
griffith	গ্রিফিথ
everett	এভারেট
khalid	খালিদ
naturelle	naturelle
shu	শু
mercy	রহমতের
mercy	করুণা
mercy	রহমত
somebody	কেউ
grenadines	গ্রেনাডাইনস
scarlet	স্কারলেট
villar	ভিলার
jaguar	জাগুয়ার
mathieu	মাতিয়ো
mathieu	ম্যাথিউ
princeps	princeps
firefly	জোনাকী
mcpherson	mcpherson
lyndon	লিন্ডন
biol	biol
rận	উকুন
rận	louse
rolf	rolf
villarreal	ভিয়ারিয়াল
dartmouth	ডার্টমাউথ
luiz	লুইজ
himachal	হিমাচল
mamluk	মামলুক
burnett	burnett
gar	গার
gar	gar
inchi	inchi
spence	স্পেন্স
hystrix	সজারু
northumberland	northumberland
hollow	ফাঁপা
ipad	ipad
ipad	আইপ্যাড
fifth	পঞ্চম
pauli	পাউলি
isa	ইসা
isa	ঈসা
gpu	জিপিও
trent	ট্রেন্ট
lodge	লজ
willie	উইলি
anita	অনিতা
hắt	হাঁচি
vđv	ক্রীড়াবিদ
evan	ইভান
stafford	স্ট্যাফোর্ড
cocktail	ককটেল
pamela	পামেলা
minerva	মিনার্ভা
audrey	অড্রে
luanda	লুয়ান্ডা
kumar	কুমার
thin	পাতলা
thin	চিকন
sql	sql
brooke	ব্রুক
riparia	riparia
giganteus	giganteus
esztergom	esztergom
toby	টবি
chennai	চেন্নাই
byzantium	byzantium
surat	সুরা
surat	সুরাট
gale	গেইল
gale	gale
gammarus	gammarus
damon	ডেমন
isabelle	ইসাবেল
expo	এক্সপো
tráp	ফাঁদ
banksia	বাঁকসিয়া
vince	ভিন্স
barber	নাপিতের
barber	নাপিত
bos	bos
danish	ডেনিশ
danish	ড্যানিশ
romanos	romanos
omaha	ওমাহা
corinthians	করিন্থিয়ান
meson	meson
stdinchi	stdinchi
picidae	picidae
hutchinson	হাচিনসন
samson	স্যামসন
tulip	টিউলিপ
mergedtoprow	mergedtoprow
gmail	ক্রেডিট
gmail	মেইলার
gmail	জিমেইল
xyanua	সায়ানাইড
gradient	গ্র্যাডিয়েন্ট
gradient	গ্রেডিয়েন্ট
cosmos	কসমস
cellspacing	cellspacing
kamchatka	কামচাটকা
civic	নাগরিক
alves	আলভেস
faa	faa
marxist	মার্কসবাদী
oleg	ওলেগ
willy	উইলি
maori	মাওরি
albifrons	albifrons
fips	fips
kami	কামি
maki	মাকি
shuttle	শাটল
serge	serge
darmstadt	ডার্মষ্টাট
stdinchikey	stdinchikey
xịt	টুপি
xịt	hat
xịt	হ্যাট
xịt	ছিল
xịt	করতাম
duff	ডাফ
bunker	বাঙ্কার
strabo	strabo
selen	সেলেনিয়াম
còng	কাফ
nicobar	নিকোবর
cliff	ক্লিফ
bernstein	bernstein
morse	মোর্স
lympho	লিম্ফোমা
dfb	dfb
hedge	হেজ
varanus	varanus
emerald	পান্না
palaiologos	palaiologos
duỗi	প্রসারিত
duỗi	ছড়ানো
cory	কোরি
rhinolophus	rhinolophus
accipiter	accipiter
beer	বিয়ার
federico	ফেদেরিকো
internacional	internacional
boss	বস
boss	boss
coppola	কপোলা
tacitus	tacitus
casno	casno
sasaki	সাসাকি
groove	খাঁজ
freddie	ফ্রেডি
crocus	জাফরানের
crocus	জাফরান
theodora	থিওডোরা
brenda	ব্রেন্ডা
xắt	কাটা
xắt	কাটা
dreyfus	dreyfus
guido	guido
philips	ফিলিপস
philips	ফিলিপস
barlow	বার্লো
asiatic	এশিয়াটিক
novae	novae
lodi	লোদি
needham	needham
gateway	গেটওয়ে
fujio	ফুজিও
novak	নোভাক
anastasia	আনাস্তাসিয়া
đỉa	leech
rudolph	রুডলফ
anatomy	এনাটমি
avon	avon
siam	সিয়াম
willard	উইলার্ড
vincenzo	ভিনসেঞ্জো
tomb	সমাধি
andromeda	অ্যানড্রোমিডা
caltech	caltech
allah	আল্লাহ্
allah	allah
allah	আল্লাহর
allah	আল্লাহ
condor	কন্ডর
shine	উজ্জ্বল
shine	চকচক
shine	জ্বলতে
shine	জ্বলে
macro	ম্যাক্রো
gel	জেল
donovan	donovan
petite	petite
steele	স্টিল
clive	ক্লাইভ
hbo	এইচবিও
copernicus	কোপের্নিকুস
zola	জোলা
grayson	গ্রেসন
crc	crc
romain	রোম্যাঁ
alphonse	alphonse
jeddah	জেদ্দা
heraclius	হিরাক্লিয়াস
mira	মীরা
mira	মীরার
mira	মিরা
flensburg	ফ্লেন্সবুর্গ
crop	ফসল
crop	শস্য
nme	nme
pirates	পাইরেটস
doris	ডরিস
factsheet	factsheet
elder	এল্ডার
vittorio	ভিত্তোরিও
moody	মুডি
volta	ভোল্টা
caligula	caligula
rei	রেই
atv	atv
dolls	পুতুল
ncbi	ncbi
mitch	মিচ
avellino	avellino
directx	ডাইরেক্টএক্স
shetland	shetland
marks	মার্কস
marks	চিহ্ন
levine	levine
sinica	sinica
langley	ল্যাংলি
claudio	ক্লডিও
burm	burm
naomi	নাওমি
bashkortostan	bashkortostan
pei	পেই
siena	siena
franck	ফ্রাঙ্ক
marty	মার্টি
triton	ট্রাইটন
anatoly	আনাতোলি
nichols	নিকোলস
ich	ich
amino	অ্যামিনো
evelyn	ইভলিন
edmonton	এডমন্টন
sởi	হাম
chou	চৌ
torch	মশাল
torch	টর্চ
fernandes	ফার্নান্ডেজ
panda	পান্ডা
frisch	frisch
tribal	উপজাতি
tribal	আদিবাসী
brighton	ব্রাইটন
frederic	ফ্রেডরিক
khalifa	খলিফা
khalifa	খালিফা
asteroids	গ্রহাণু
sếp	স্যারের
sếp	স্যার
sếp	প্রধান
sếp	নেতা
sếp	বস
sếp	boss
giầy	জুতা
giầy	জুতো
moe	মো
ntv	এনটিভি
westland	westland
matthews	ম্যাথিউজ
junction	জাংশন
rowley	রাউলি
mifflin	mifflin
mimi	মিমি
mimi	মিমির
mor	মোর
plastic	প্লাস্টিক
magnitude	উজ্জ্বলতা
messiah	মসীহ
lies	মিথ্যা
lies	মিথ্যে
blackberry	ব্ল্যাকবেরি
gallus	gallus
travis	ট্রাভিস
mahmud	মাহমুদ
halogen	হ্যালোজেন
glacier	হিমবাহ
rúp	রুবেল
rúp	রুবল
imam	ইমাম
dio	dio
wise	জ্ঞানী
wise	ওয়াইস
kathy	ক্যাথি
doom	ডুম
ella	এলা
burger	বার্গার
lise	লিজে
chôm	চুরি
gondwana	গন্ডোয়ানা
dustin	ডাস্টিন
schaeffer	schaeffer
deck	ডেক
cooke	cooke
serial	ক্রমিক
serial	সিরিয়াল
beth	বেথ
pelé	পেলে
mos	মস
nia	nla
nia	নিয়া
bowers	bowers
falling	পড়ছে
rayment	rayment
unity	ইউনিটি
unity	ঐক্য
unity	একতা
odin	ওডিন
nhòm	বাইনোকুলার
bra	ব্রাজিল
pictogram	pictogram
rupee	রুপি
henning	henning
nộm	ডামি
markus	লোকোমোটিভ
bora	বরা
würzburg	উর্জবার্গ
taurus	বৃষ
middleton	মিডলটন
stokes	স্টোকস
shen	শেন
nebulosa	nebulosa
enter	লিখুন
bride	বধূ
bride	কনে
bride	নববধূ
nikki	নিকি
survival	বাঁচার
mio	দাড়ানো
dirac	ডিরাক
indien	indien
reptilia	reptilia
imperia	imperia
sandwich	স্যান্ডউইচ
fabio	ফাবিও
sibirica	sibirica
peck	পেক
trend	ট্রেন্ড
trend	প্রবণতা
louisa	লুইসা
sos	এসওএস
ole	ওলে
dane	ডেন
gpcm	gpcm
hera	হেরা
views	দর্শন
shepherd	শেফার্ড
rosenberg	rosenberg
cocos	কোকোস
moo	মু
cuscuta	স্বর্ণলতা
archibald	আর্চিবল্ড
mica	অভ্র
nivea	nivea
sale	বিক্রয়
sale	সেল
sale	sale
vue	vue
storia	storia
siu	siu
khay	ট্রে
kristen	ক্রিস্টেন
abdel	আবদেল
abdel	আব্দেল
aachen	aachen
oracle	ওরাকল
brendan	ব্রেন্ডন
buzz	গুঞ্জন
buzz	বাজ
parnassius	parnassius
bastille	বাস্তিল
sabina	সাবিনা
scan	স্ক্যান
trồi	ভাসে
#efefef	#efefef
muỗng	চামচ
muỗng	ঘটে
skull	খুলি
lawson	লসন
rhea	রিয়া
bernadotte	bernadotte
comments	মন্তব্য
ferreira	ফেরেইরা
alec	অ্যালেক
karel	karel
karim	করিম
hipposideros	hipposideros
motorola	মটোরোলা
primera	প্রিমেরা
schiller	সিলার
gotham	গথাম
alam	আলম
beetles	beetles
vote	ভোট
seto	seto
boot	বুট
stadt	stadt
hex	হেক্স
münster	মন্সটার
urbino	urbino
uri	uri
phasianidae	phasianidae
afghan	আফগান
khm	khm
pls	pls
oka	ওকা
jill	জিল
rowan	রোয়ান
septentrionalis	septentrionalis
trụy	ধর্ষক
courtney	কোর্টনি
deborah	ডেবোরা
dominican	ডোমিনিকান
graves	কবরে
graves	কবরের
graves	কবর
nathaniel	নাথানিয়েল
comet	ধূমকেতু
tabernaemontana	টগর
underwood	আন্ডারউড
loud	জোরে
loud	জোরালো
hangal	হাঙ্গাল
sage	সেজ
mải	চিরকাল
mải	চিরতরে
mải	অনন্তকাল
mải	অনন্ত
mải	চিরন্তন
mải	শাশ্বত
kojima	kojima
mick	মিক
walton	ওয়ালটন
hói	টাক
ortega	ওর্তেগা
apec	apec
cellpadding	cellpadding
heron	বক
rữa	পচে
passeriformes	passeriformes
globalsecurity	globalsecurity
ramon	রামোন
hulk	হাল্ক
nhóc	কিড
sunny	রৌদ্রোজ্জ্বল
sunny	সানি
schrödinger	শ্রোডিঙার
vái	দুয়া
vái	দোয়া
varia	varia
rügen	রুগেন
stanisław	stanisław
holden	holden
merkel	মার্কেল
corvus	কাক
corvus	ক্রো
lit	জ্বালানো
lit	লিট
hormon	হরমোন
hormon	হরমোন
celsius	সেলসিয়াস
rough	খসখসে
rough	রুক্ষ
cecilia	সিসিলিয়া
mah	mah
boo	বুয়েট
boo	বু
stamp	স্ট্যাম্প
persona	পার্সোনা
coleoptera	coleoptera
cindy	সিন্ডি
poison	poisson
poison	বিষ
scorpion	বৃশ্চিক
scorpion	স্করপিয়ন
hazard	বিপত্তি
township	জনপদ
quây	পার্শ্ববর্তী
quây	ঘিরে
dioxide	dioxide
pong	পং
panel	পাভেল
gustavo	গুস্তাভো
bagdad	বাগদাদ
subgenus	subgenus
accra	আক্রা
ilya	ইলিয়া
horizon	দিগন্ত
kao	কাও
veron	ভেরন
blast	ব্লাস্ট
kedah	কেদাহ
phết	কমা
hamlet	হ্যামলেট
lasker	লস্কর
nou	ন্যু
darkness	অন্ধকার
arkhangelsk	arkhangelsk
sprint	স্প্রিন্ট
methyl	মিথাইল
aleppo	আলেপ্পো
headerstyle	headerstyle
aol	aol
thrash	থ্রাশ
kpa	kpa
kathmandu	কাঠমান্ডু
terminator	টার্মিনেটর
bitcoin	বিটকয়েন
ursus	ursus
dir	dir
brent	ব্রেন্ট
rms	rms
reina	রেইনা
afrika	afrika
alvin	আলভিন
lbs	পাউন্ড
aquarium	অ্যাকোয়ারিয়াম
wifi	wifi
wifi	ওয়াইফাই
gregor	গ্রেগর
judas	জুডাস
telecom	টেলিকম
ubisoft	ইউবিসফট
carmel	কার্মেল
silvestris	silvestris
bhutto	ভুট্টো
azov	আজভ
pony	পনি
yusuf	ইউসুফ
quad	quad
sgt	সার্জেন্ট
plexippus	plexippus
dorothea	dorothea
aaa	এএএ
supplement	সম্পূরক
toba	toba
astana	আস্তানা
lindsay	লিন্ডসে
alexa	আলেক্সা
hélène	হেলেনের
hezbollah	হিজবুল্লাহ
freddy	ফ্রেডি
osama	ওসামা
portage	পোর্টেজ
gonzalez	গঞ্জালেজ
hdtv	এইচডিটিভি
blaise	ব্লেইজ
fix	সংশোধন
degli	দেলি
dexter	ডেক্সটার
nigricollis	nigricollis
theresa	থেরেসা
mut	মুতা
mut	মুত
lilly	লিলি
johansson	জোহানসন
insulin	ইনসুলিন
jennings	জেনিংস
gesellschaft	gesellschaft
katrina	ক্যাটরিনা
sama	সামা
sindh	সিন্ধ
sindh	সিন্ধু
resistivity	resistivity
gagarin	গ্যাগারিন
patch	প্যাচ
tcp	টিসিপি
tcp	tcp
khiêng	বহন
ulan	উলান
cesar	সিজার
astro	অ্যাস্ট্রো
joong	জুং
griseus	griseus
phelps	ফেলপস
tver	tver
inchikey	inchikey
airline	এয়ারলাইন্স
nestor	নেস্টর
sasha	সাশা
alison	অ্যালিসন
octavian	অক্টোভিয়ান
wilder	ওয়াইল্ডার
couple	দম্পতির
couple	জুটি
couple	দম্পতি
couple	যুগল
plo	plo
hertz	হের্ৎস
kimono	কিমোনো
bovidae	বোভিডি
cali	ক্যালি
dima	দিমা
tibet	তিব্বত
vodka	ভদকা
mie	মেই
depp	ডেপ
goo	goo
pod	pod
khomeini	খোমেনী
munda	মুন্ডা
ata	আতা
ata	ata
guerre	guerre
gượng	বন্যা
gượng	বিব্রতকর
whisky	হুইস্কি
gorilla	গরিলা
mauro	মাউরো
christa	ক্রিস্টা
scorsese	স্কোরসেজি
buddy	বাডি
twins	জমজ
twins	যমজ
ferrer	ফেরের
nehru	নেহেরু
integrated	ইন্টিগ্রেটেড
integrated	সমন্বিত
woodward	উডওয়ার্ড
chrysanthemum	চন্দ্রমল্লিকা
huxley	হাক্সলি
kata	কাতা
psi	স্পিন
psi	সাই
nike	সাইলো
ulster	ulster
fans	ভক্ত
fans	ভক্তরা
tex	টেক্স
mojo	মোজো
mina	মিনা
push	পুশ
push	ধাক্কা
sanchez	সানচেজ
fda	এফডিএ
hartford	হার্টফোর্ড
wikia	উইকিয়া
chaco	চাকো
pretoria	প্রিটোরিয়া
ira	ইরা
genome	জিনোম
euphrates	ইউফ্রেটিস
ethan	ইথান
nic	নিক
#không	#no
hanks	হ্যাঙ্কস
grin	grin
oryol	oryol
ariana	আরিয়ানা
islamabad	ইসলামাবাদ
corpus	কর্পাস
perak	পেরাক
eureka	ইউরেকা
vnd	usd
kappa	কাপ্পা
cation	cation
melville	মেলভিল
ursula	উরসুলা
bode	বোড
sharif	শরিফ
sharif	শরীফ
adi	আদি
trainer	প্রশিক্ষক
rutaceae	রুটেসি
goya	goya
goya	গোয়া
medusa	মেডুসা
brando	ব্রান্ডো
godfrey	গডফ্রে
alexei	আলেক্সি
cad	cad
toho	তোহো
jesús	জেসাস
jesús	জিসাস
manipur	মণিপুর
ney	নে
ney	ney
cinderella	সিন্ডারেলা
galapagos	গালাপাগোস
shea	শিয়া
anten	অ্যান্টেনা
scholes	স্কোলস
wilczek	wilczek
adolphe	adolphe
gilmour	গিলমোর
chn}}	chn}}
fatima	ফাতিমা
navarro	নাভারো
gon	gon
johanna	johanna
carnival	কার্নিভাল
carnival	উৎসব
carnival	কার্নিভ্যাল
saxe	saxe
debian	ডেবিয়ান
linus	লিনুস
mahathir	মাহাথির
nadia	নাদিয়া
minaj	মিনাজ
ofc	ofc
primorsky	primorsky
bose	বোস
bose	বসু
chandra	চন্দ্র
lina	লিনা
sochi	সোচি
deluxe	ডিলাক্স
constant	কনস্ট্যান্ট
constant	ধ্রুবক
dent	ডেন্ট
quote	কোট
quote	উক্তি
quote	উদ্ধৃতি
brahman	ব্রাহ্মণ
hobbit	হবিট
annales	annales
abba	আব্বা
boxer	বক্সার
sitcom	সিটকম
cynthia	সিনথিয়া
marcelo	মার্সেলো
facto	ফ্যাক্টো
juliette	juliette
diptera	diptera
lòi	লাঠির
nagorno	nagorno
humphrey	হামফ্রে
nivalis	nivalis
cunha	কুনহা
morava	মোরাভা
foucault	ফুকো
megan	মেগান
dwyer	dwyer
mohs	mohs
strigidae	strigidae
leary	লিয়ারি
angelina	অ্যাঞ্জেলিনা
rss	আরএসএস
rss	rss
nelly	নেলি
lum	lum
isabela	ইসাবেলা
heracles	heracles
emedicinesubj	emedicinesubj
dow	dow
chừa	এড়ানো
topic	বিষয়
topic	প্রসঙ্গ
burnley	বার্নলি
lithuania	লিথুয়ানিয়া
null	null
plug	প্লাগ
arabian	আরব
airasia	এয়ারএশিয়া
doll	পুতুল
riverside	রিভারসাইড
chon	অতিক্রম
chon	ক্রুশ
chon	ক্রস
kassel	ক্যাসেল
buteo	buteo
terrestrial	টেরেস্ট্রিয়াল
covers	কভার
uhfffaoysa	uhfffaoysa
naked	উলঙ্গ
naked	নগ্ন
supreme	সুপ্রিম
parabol	প্যারাবোলা
ucla	ucla
strawberry	স্ট্রবেরি
hamid	হামিদ
kush	কুশ
thirty	ত্রিশ
thirty	thirty
thirty	তিরিশ
jessie	জেসি
townsend	টাউনসেন্ড
streaming	স্ট্রিমিং
massimo	মাসিমো
bou	bou
balfour	বেলফোর
gris	gris
pythagoras	পিথাগোরাস
eocene	ইওসিন
phốtpho	ফসফরাস
lepton	lepton
infraordo	infraordo
hitchcock	হিচকক
granger	গ্রেঞ্জার
resident	বাসিন্দা
arias	arias
bytes	বাইট
safia	সাফিয়া
#ff	#ff
nikola	নিকোলা
solaris	solaris
heroin	হেরোইন
heroin	হিরোইন
gardiner	গার্ডিনার
mandarin	ম্যান্ডারিন
brett	ব্রেট
gôn	গলফ
gôn	গল্ফ
eli	এলি
adaptation	অভিযোজন
irina	ইরিনা
punctulata	punctulata
share	শেয়ার
niue	নিউয়ে
niue	নিউ
sas	এসএএস
domenico	ডোমেনিকো
patrice	প্যাট্রিস
biogeography	জীবভূগোল
rabin	rabin
akkad	আক্কাদ
carlisle	কার্লাইল
boulder	বোল্ডার
bragg	ব্র্যাগ
lucca	lucca
hidro	হাইড্রোজেন
kluge	ক্লুগে
gage	গেজ
hind	ডো
hind	হিন্দ
chavez	শ্যাভেজ
giỡn	জগাখিচুড়ি
giỡn	ঝামেলা
jeans	জিন্স
jeans	জিনস
marlon	মার্লোন
magnifier	বিবর্ধক
bowling	বোলিং
socrates	সক্রেটিস
inst	inst
porsche	porsche
thornton	থর্নটন
naka	নাকা
mom	মাকে
mom	মায়ের
mom	মা
amateur	অপেশাদার
amateur	শখের
arunachal	অরুণাচল
verdi	ভের্দি
ups	ups
mahal	মহল
puma	পুমা
gem	জেম
gem	রত্ন
kandahar	কান্দাহার
estrogen	ইস্ট্রোজেন
ginger	আদা
ginger	আদার
jurassic	জুরাসিক
rochelle	রোশেল
serinus	ক্যানারি
premium	প্রিমিয়াম
percival	percival
lepus	হরে
klose	ক্লোসা
speciosus	speciosus
volkswagen	ভক্সওয়াগেন
cristo	ক্রিস্টো
lovato	লোভাটো
rpm	rpm
ipv	ipv
xxxx	xxxx
icd	icd
amer	আমের
brevirostris	brevirostris
duma	দুমা
hamad	হামাদ
welt	welt
capture	প্রে
mila	মিলা
shinkansen	শিনকানসেন
bone	হাড়
kilo	কিলো
kilo	কেজি
chekhov	চেখভ
imperialis	imperialis
phenol	ফেনল
passer	চড়ুই
mein	mein
altvar	altvar
medellín	মেডেলিন
qualcomm	qualcomm
norma	nic
ras	রাস
ras	ras
bridges	ব্রিজ
bridges	সেতু
ludlow	ludlow
maradona	ম্যারাডোনা
sobre	sobre
rovigo	rovigo
illyria	illyria
woodrow	উড্রো
mauritania	মৌরিতানিয়া
agatha	আগাথা
gokak	গোকাক
lovers	প্রেমীদের
lovers	প্রেমী
htc	htc
spectrum	বর্ণালী
nos	নস
miki	মিকি
tiển	দায়ে
tiển	দায়ের
greer	গ্রিয়ার
audition	অডিশন
bst	bst
selangor	সেলাঙ্গর
banana	কলা
banana	কলার
gideon	গিডিওন
gestapo	গেস্টাপো
rubia	rubia
augusto	অগাস্টো
halo	halo
#eee	#eee
gum	গাম
dryandra	বাঁকসিয়া
milner	milner
gecko	gecko
gecko	টিকটিকি
bani	বানি
otus	otus
nebula	নীহারিকা
tba	tba
hayden	হেডেন
bmi	ছাত্রী
bmi	স্টুডেন্ট
bmi	ছাত্রের
bmi	ছাত্র
shelley	শেলি
václav	ভাকল্যাভ
sik	sik
sik	শিক
zell	জেল
semimajor	semimajor
burgess	বার্জেস
flint	ফ্লিন্ট
rallidae	রেলিডি
asa	asa
robben	রোবেন
kurosawa	কুরোসাওয়া
svetlana	সভেতলানা
luciano	লুসিয়ানো
aspirin	অ্যাসপিরিন
temps	temps
cucurbita	cucurbita
hydrogen	হাইড্রোজেন
siro	সিরো
endemic	এনডেমিক
hobart	হোবার্ট
giza	গিজা
wikipe	wikipe
icc	icc
icc	আইসিসির
icc	আইসিসি
cure	নিরাময়
cure	আরোগ্য
fanny	fanny
cbc	সিবিসি
aceh	আচেহ
kiwi	কিউই
borges	borges
sabha	সভা
alberti	alberti
funny	মাত্র
funny	শুধু
barbatus	barbatus
hawthorne	হথর্ন
whig	whig
ast	ast
torpedo	torpedo
stephenson	স্টিফেনসন
bloomington	ব্লুমিংটন
bts	bts
arboretum	আরবোরেটুম
willow	উইলো
pico	pico
hirohito	হিরোহিতো
havana	হাভানা
crom	ক্রোমিয়াম
indomitable	অদম্য
abovestyle	abovestyle
rift	রিফট
moro	moro
souza	সুজা
foggia	foggia
deutscher	deutscher
sệt	ভঙ্গুর
blackbird	ব্ল্যাকবার্ড
dual	দ্বৈত
dual	ডুয়েল
toru	তরু
sonia	সোনিয়া
faq	faq
royale	রয়্যাল
reza	রেজা
mint	মিন্ট
mint	পুদিনা
bol	বোল
doppler	ডপলার
mariano	মারিয়ানো
hutton	হাটন
slim	পাতলা
slim	স্লিম
duo	জোড়
duo	মানিকজোড়
katakana	কাতাকানা
byung	byung
divine	ঐশ্বরিক
divine	ঐশী
divine	স্বর্গীয়
reilly	রেইলি
rye	রাই
och	och
sae	sae
eberhard	eberhard
berne	berne
babcock	babcock
hewitson	hewitson
charadrius	plover
drogba	দ্রগবা
walls	দেয়াল
walls	দেওয়াল
somethin	সামথিং
sawyer	সয়্যার
giants	দৈত্যদের
yugoslavia	যুগোস্লাভিয়া
yugoslavia	তিব্বত
dickson	ডিকসন
iptv	iptv
fitch	ফিচ
initiative	উদ্যোগ
initiative	উদ্যোগী
initiative	ইনিশিয়েটিভ
kendall	কেন্ডাল
metcalf	metcalf
kor	kor
rus}}	rus}}
gyu	gyu
