börngen	börngen
saitama	saitama
jake	jake
acanthodelta	akhaia
ferruginea	ferruginea
bel	bel
brabant	brabant
cave	hule
cave	cave
cave	grotte
brandt	brandt
villosa	villosa
jensen	jensen
tito	tito
lille	lille
herrera	herrera
fairy	feen
vahl	vahl
gustave	gustave
wembley	wembley
vale	vale
mustang	mustang
wwf	wwf
berger	berger
ballet	ballett
bali	balinesisk
bali	bali
click	klikke
click	klikk
burke	burke
sophronica	sophronica
habana	habana
baldwin	balduin
baldwin	baldwin
gomez	gomez
diva	diva
mills	mills
vogel	vogel
katsuura	katsuura
exo	exo
aquila	aquila
riley	riley
apache	apache
swaziland	swaziland
ngất	besvimt
ngất	besvimte
kirk	kirk
villers	villers
bissau	bissau
cfg	cfg
humboldt	humboldt
angels	engler
cincinnati	cincinnati
stein	stein
jalisco	jalisco
linden	linden
ada	adda
ada	ada
albion	albion
wade	wade
strong	sterk
strong	strong
strong	sterke
strong	sterkt
wto	wto
gould	gould
morales	morales
pixar	pixar
campos	campos
kohl	kohl
gardens	haver
gardens	hagene
gardens	hager
gardens	gardens
quincy	quincy
shizuoka	shizuoka
paz	paz
dante	dante
pilosa	pilosa
gérard	gérard
fury	fury
savage	savage
savage	villmann
hogwarts	galtvort
oahu	oahu
acalolepta	acalolepta
moy	moy
gil	gil
cabo	cabo
tmesisternus	tmesisternus
jolie	jolie
rolls	ruller
rolls	rundstykker
rolls	rolls
lviv	lviv
kota	kota
alessandro	alessandro
log	logg
log	logge
parms	parms
springer	springer
barnard	barnard
sabre	sabel
sabre	sabre
thebes	theben
claudius	claudius
tricolor	tricolor
schulz	schulz
bari	bari
plasma	plasma
sturm	sturm
nathan	nathan
avro	avro
taekwondo	taekwondo
turk	turk
turk	tyrker
patricia	patricia
minutus	minutus
eduard	eduard
yangon	yangon
enrique	enrique
strike	streike
strike	strike
strike	streik
ranger	ranger
yard	yard
yard	tunet
bucharest	bucurești
konstantinos	konstantin
konstantinos	constantine
int	int
shelby	shelby
lufthansa	lufthansa
taken	tatt
rufus	rufus
connor	connor
harrier	harrier
caudata	caudata
hon	hon
hon	kjære
ôliu	olive
ôliu	oliven
ôliu	oliven
nola	nola
liechtenstein	liechtensteins
liechtenstein	liechtenstein
shakira	shakira
sứa	manet
sứa	maneter
benoit	benoit
rabaul	rabaul
richland	richland
atlantique	atlantique
cromwell	cromwell
queens	dronninger
queens	queens
plain	sletten
cello	celloen
cello	cello
robertson	robertson
ser	ser
rán	steking
rán	fry
quầy	chef
quầy	kjøkkensjef
quầy	kokk
quầy	kokken
hae	hae
maxon	maxon
dracula	dracula
metropolitan	metropolitan
vendée	vendée
tonga	tonga
andaman	andaman
territoire	territoire
pass	watch
pass	bestå
pass	pasning
baja	baja
dam	dam
dam	demning
dam	demningen
yeltsin	jeltsin
lori	lori
canyon	canyon
malacca	malakka
lineata	lineata
walther	walther
christie	christie
oeste	oeste
dominique	dominique
garnier	garnier
ultimate	ypperste
ultimate	ultimate
dieu	dieu
gleason	gleason
crimean	krim
chấu	gresshoppene
chấu	gresshopper
quentin	quentin
marlborough	marlborough
uta	uta
fleet	fleet
fleet	flåten
fleet	flåte
prodcode	prodcode
tours	tours
reeder	reeder
macquart	macquart
girona	girona
hokkaido	hokkaido
tales	tales
maldives	maldivene
rennes	rennes
castellón	castellón
javier	javier
brod	brod
sharon	sharon
rosario	rosario
suite	suite
suite	suiten
erigone	erigone
rollins	rollins
rollins	rawlins
clair	clair
antwerp	antwerpen
sevastopol	sevastopol
jeju	jeju
mirror	speil
diếp	salat
macrophylla	macrophylla
lesotho	lesotho
aristotle	aristoteles
ultra	ultra
xxx	xxx
arcade	arkaden
arcade	arcade
ústí	ústí
kolkata	calcutta
reef	revet
reef	rev
reef	reef
wasp	veps
boong	dekk
spectabilis	spectabilis
pratt	pratt
andalusia	andalucia
lindau	lindau
kawasaki	kawasaki
bactria	baktriske
amanda	amanda
malcolm	malcolm
joker	joker
yves	yves
mrkos	mrkos
goethe	goethe
winchester	winchester
cnn	cnn
guillaume	guillaume
cúi	bøy
cúi	bøye
cúi	bend
thây	zombier
granit	granit
nhấp	klikket
nhấp	klikke
nhấp	klikk
fallax	fallax
chronicle	kronikk
chronicle	krønike
chronicle	krøniken
chronicle	chronicle
pumila	pumila
birdlife	birdlife
turku	åbo
bradford	bradford
gaius	gaius
antilles	antillene
seki	seki
ekaterina	jekaterina
shark	shark
flagstaff	flagstaff
ein	ein
messina	messina
sếu	traner
sếu	kran
sếu	crane
mandela	mandela
metallica	metallica
ramírez	ramírez
kanagawa	kanagawa
asm	asm
xiếc	sirkuset
xiếc	sirkus
xiếc	circus
dom	dom
gigas	gigas
dae	dae
erwin	erwin
belfast	belfast
linn	linn
picta	picta
joy	joy
joy	glede
verdun	verdun
macau	macao
sint	sint
bryansk	brjansk
hare	hare
jasper	jasper
nba	nba
tristis	tristis
plata	plata
phở	pho
affairs	affairs
affairs	anliggender
affairs	affærer
emirates	emirater
terme	terme
sum	sum
sum	summen
swiss	sveitsiske
swiss	sveitsisk
swiss	swiss
chin	hake
chin	chin
chin	haken
chin	haka
clemson	clemson
himmler	himmler
ahn	ivanov
ahn	ahn
dĩa	tallerken
valenciennes	valenciennes
muang	muang
rna	rna
khoe	serier
khoe	viser
khoe	show
düsseldorf	düsseldorf
düsseldorf	düsseldorf
maha	maha
lives	lives
tyson	tyson
sonic	sonic
johor	johor
agm	agm
dượng	vernon
dượng	stefaren
dượng	stefar
cecil	cecil
besançon	besançon
javascript	javascript
rzhev	rzjev
takeda	takeda
mercedes	mercedes
sigma	sigma
adventures	adventures
adventures	eventyr
ubuntu	ubuntu
kagoshima	kagoshima
tallinn	tallinn
vito	vito
peruviana	peruviana
varese	varese
sparrow	spurv
sparrow	sparrow
origins	opprinnelsen
banh	ball
yucatán	yucatán
heli	helium
wakayama	wakayama
wii	wii
orléans	orléans
lutea	nøkkerose
almería	almería
ponte	ponte
agamidae	agamer
martínez	martínez
guadeloupe	guadeloupe
cumberland	cumberland
lamarck	lamarck
craugastor	craugastor
btr	btr
leslie	leslie
mụn	kviser
mụn	kviser
kirby	kirby
mustafa	mustafa
zona	zona
romero	romero
messerschmitt	messerschmitt
pittsburgh	pittsburgh
saladin	saladin
nigrescens	nigrescens
asturias	asturias
weimar	weimar
synonym	synonym
yoshida	yoshida
vaughan	vaughan
seydlitz	seydlitz
gauss	gauss
sakhalin	sakhalin
banner	stier
banner	banner
banner	banneret
pallas	pallas
seth	seth
regia	regia
wikidata	wikidata
pao	pao
mega	mega
tơi	fikser
mindanao	mindanao
nigricans	nigricans
claire	claire
maru	maru
meridionalis	meridionalis
africanus	africanus
hindi	hindi
tango	tango
montréal	montreal
makoto	makoto
thank	takke
empires	imperier
jesse	jesse
walsh	walsh
hey	hei
adrian	hadrian
adrian	adrian
prescott	prescott
ark	ark
albrecht	albrecht
marsh	marsh
suwon	suwon
gómez	gomez
gómez	gómez
leach	leach
višnjan	višnjan
coldplay	coldplay
české	české
olga	olga
carnegie	carnegie
kwon	kwon
dyar	dyar
yamaguchi	yamaguchi
brit	britt
brit	brit
rod	rod
bờm	manen
hermione	hermine
phẩy	komma
zeno	zeno
mussolini	mussolini
amazing	utrolig
amazing	amazing
joshua	joshua
joshua	josva
earl	earl
earl	jarl
demetrios	demetrios
demetrios	demetrius
amber	amber
amber	rav
montevideo	montevideo
neon	neon
hoon	hoon
kenny	kenny
hanoi	hanoi
richter	richter
gamble	sjansespill
gamble	gamble
kurd	kurdisk
kurd	kurd
mercer	mercer
bethlehem	betlehem
bolt	bolt
invincible	uovervinnelige
invincible	uslåelig
invincible	uovervinnelig
sidi	sidi
mainz	mainz
moure	moure
tracy	tracy
imf	imf
blanchard	blanchard
mickey	mikke
mickey	mickey
grenada	grenada
uesac	uesac
xml	xml
noctuinae	noctuinae
antigua	antigua
claudia	claudia
shogun	shogun
aung	aung
dynamics	dynamikk
disa	disa
stella	stella
sunda	sunda
stoke	stoke
baku	baku
car	bil
eduardo	eduardo
quăng	kast
quăng	sleng
quăng	slenger
quăng	kaste
yen	yen
sedis	sedis
werder	werder
seal	segl
seal	sel
seal	seglet
seal	seal
elliot	elliot
pasteur	pasteur
albany	albany
achaea	akhaia
decipiens	decipiens
bloch	bloch
yoga	yoga
albacete	albacete
blade	klinge
mat	mat
mat	matta
nuevo	nuevo
nol	nol
disco	disko
disco	disco
heinkel	heinkel
pounder	pounder
gsub	gsub
asp	asp
penny	penny
yuki	yuki
blackwall	blackwall
quýt	mandarin
quýt	mandarin
sunni	sunni
sunni	sunniislam
eve	eva
eve	eve
minamoto	minamoto
node	node
node	noden
hacker	hacker
hacker	hackere
hacker	hacke
hacker	hack
sendai	sendai
tiberius	tiberius
christophe	christophe
ming	ming
engels	engels
znojmo	znojmo
lynn	lynn
olomouc	olomouc
durham	durham
chae	chae
chong	chong
hót	syngende
hót	synger
hót	synging
hót	sang
hót	synger
coloma	coloma
thor	tor
thor	thor
sandbox	sandkasse
padova	padua
padova	padova
ovata	ovata
ruby	ruby
dwight	dwight
selena	salina
selena	selena
comoros	komorene
fulton	fulton
palustris	palustris
xavier	xavier
blücher	blücher
candy	godteri
sheridan	sheridan
pauly	pauly
xòe	tutu
broun	broun
griffin	griffin
fao	fao
iğdır	iğdır
menzies	menzies
khuấy	rørt
boa	boa
cube	kube
r}}	r}}
emil	emil
rahman	rahman
glen	glen
glen	glenn
klaus	klaus
gorbachev	gorbatsjov
resort	resort
resort	feriested
corinna	corinna
benz	benz
hampton	hampton
chandler	chandler
williamson	williamson
pers	pers
papilionidae	svalestjerter
göring	göring
samar	samar
quinn	quinn
bmw	bmw
sumer	sumerisk
irene	irene
cartoon	tegneserie
cartoon	tegnefilm
cartoon	tegneseriefigur
penang	penang
gớm	betennelse
zeller	zeller
scheer	scheer
oberösterreich	oberösterreich
vocals	vokalist
kahn	kahn
toro	toro
gaon	gaon
sủa	bark
sủa	bjeffer
carr	carr
betty	betty
wilkinson	wilkinson
cholesterol	kolesterol
constantinople	konstantinopel
allmusic	allmusic
chihuahua	chihuahua
ancona	ancona
descartes	descartes
tran	tran
madeira	madeira
micro	micro
micro	mikro
micro	mikrofonen
micro	mikrofon
thìa	skjeer
thìa	skje
bath	bad
blanc	blanc
medici	medici
gien	gener
gien	genene
gien	gene
gien	gen
cornwall	cornwall
uae	uae
scharnhorst	scharnhorst
bains	bains
confusa	nellikfly
luzula	luzula
marche	marche
bremer	bremer
hormone	hormon
hormone	hormonene
hormone	hormoner
udine	udine
gập	folde
lens	linse
lens	lekke
lens	lekkasjen
lens	lekkasje
beirut	beirut
hahn	hahn
yamada	yamada
linearis	linearis
carabus	carabus
dot	prikk
dot	dot
andersson	andersson
elip	ellipse
lafayette	lafayette
willem	willem
tatar	tatar
boom	bang
boom	boom
luigi	luigi
polygonum	tungras
boone	boone
dumbledore	humlesnurr
reo	ringte
reo	tvile
reo	tvil
reo	tviler
garrison	garrison
garrison	garnisonen
garrison	garnison
brunnea	teglfly
khun	khun
fiction	fiksjon
sidney	sidney
repens	repens
zelotes	zelotes
musashi	musashi
pluto	pluto
adobe	adobe
lexikon	lexikon
lindsey	lindsey
hyundai	hyundai
direct	direkte
direct	direct
primula	primula
vermont	vermont
sụn	brusk
craven	craven
kato	kato
nomura	nomura
diane	diane
thrace	trakia
rivière	rivière
borealis	borealis
anders	anders
sugar	sukker
sugar	sugar
bouchet	bouchet
evarcha	evarcha
doc	doc
budějovice	budějovice
antiochos	antiokos
schalke	schalke
kyushu	kyushu
cremona	cremona
handel	händel
turing	turing
talbot	talbot
piston	stempler
admiralty	admiralitetet
kyle	kyle
emerton	emerton
dale	dale
gloria	gloria
oder	oder
lange	lange
shannon	shannon
liti	litium
mehmed	mehmet
cayman	calgary
cayman	cayman
summit	summit
summit	toppmøte
martinique	martinique
villiers	villiers
gotha	gotha
wanda	wanda
wilcox	wilcox
martino	martino
obscurus	obscurus
budde	budde
saxophone	saksofon
friedman	friedman
canescens	canescens
vanessa	vanessa
baghdad	bagdad
haas	haas
schwartz	schwartz
hohenzollern	hohenzollern
para	para
howell	howell
tolstoy	tolstoj
palawan	palawan
neptune	neptune
neptune	neptun
jupiter	jupiter
velvet	fløyel
mia	mia
alfonso	alfonso
lara	lara
bromley	bromley
proxy	proxy
djibouti	djibouti
hattori	hattori
training	trening
training	opplæring
musa	musa
acta	acta
californica	californica
marcello	marcello
gilles	gilles
norodom	norodom
funk	funk
robustus	robustus
jharkhand	jharkhand
shepard	shepard
zanzibar	zanzibar
lil	lil
lil	lill
dmitry	dmitrij
boisduval	boisduval
apiaceae	skjermplantefamilien
cowan	cowan
randolph	randolph
oakland	oakland
toscana	toscana
ambrose	ambrose
aurelius	aurelius
sheikh	sheikh
sheikh	sjeik
krai	kraj
kottelat	kottelat
gear	tempo
gear	utstyr
gear	gear
gear	hastigheter
andorra	podgorica
olympique	olympique
benedict	benedict
benedict	benedikt
palmer	palmer
gerstaecker	gerstäcker
irving	irving
trau	trøtte
trau	trøtt
trau	sliten
bison	bison
medeiros	medeiros
lat	lat
lat	late
lat	lazy
coruña	coruña
wigan	wigan
crane	kran
crane	crane
ôtô	cars
ôtô	biler
clement	klemens
clement	clement
darren	darren
beaver	beaver
beaver	bever
paulus	paulus
chopin	chopin
canterbury	canterbury
gerhard	gerhard
ariel	ariel
fujiwara	fujiwara
maxima	maxima
indie	indie
konrad	konrad
castillo	castillo
kung	kung
championships	mesterskap
championships	allround
animax	animax
beograd	beograd
martha	martha
bloom	blomstre
bloom	bloom
marius	marius
espírito	espírito
helmut	helmut
avril	avril
kure	kure
khuya	sen
khuya	seint
khuya	sein
khuya	sent
suffolk	suffolk
liststyle	liststyle
kilis	kilis
kimi	kimi
beaufort	beaufort
maui	maui
tone	tone
rue	rue
calédonie	calédonie
ferrari	ferrari
stan	stan
rebel	rebell
rebel	opprører
rebel	rebel
loi	loi
regina	regina
laporte	laporte
cherry	cherry
cherry	kirsebær
scout	scout
scout	speider
coburg	coburg
lozère	lozère
pereira	pereira
borneensis	borneensis
interscope	interscope
orissa	orissa
bruxelles	brussel
gaston	gaston
citation	forelegg
sakai	sakai
fairey	fairey
curie	curie
chuck	chuck
dora	dora
két	safer
symplocos	symplocos
aerospace	luftfart
aerospace	aerospace
benn	benn
donau	donau
punctatus	punctatus
romagna	romagna
bergen	bergen
laevis	laevis
vols	vols
scottish	skotsk
sagar	sagar
turkish	tyrkisk
trinity	trinity
trinity	treenighet
antigonos	antigonos
shop	handle
shop	butikk
shop	sløyd
shop	butikker
shop	butikkene
roche	roche
lamiaceae	leppeblomstfamilien
parva	parva
gallo	gallo
kafka	kafka
sonora	sonora
leiden	leiden
truncata	truncata
meteor	meteor
hubert	hubert
schumacher	schumacher
bertrand	bertrand
turin	torino
tibialis	tibialis
sylvia	sylvia
wikitext	wikitext
valentin	valentin
thriller	thriller
holly	holly
sensu	sensu
fidel	fidel
ivanovich	ivanovitsj
ash	aske
ash	ash
brittany	bretagne
brittany	brittany
ret	ret
benoist	benoist
gentry	gentry
pohl	pohl
wickes	wickes
giặt	klesvask
giặt	skylt
giặt	vaska
giặt	vasket
wrestlemania	wrestlemania
middlesbrough	middlesbrough
barker	barker
spitfire	spitfire
gurevich	gurevitsj
philipp	philipp
andre	andre
andre	andré
andre	andré
hibiscus	hibiscus
barton	barton
pierce	pierce
rfc	rfc
catania	catania
falcata	falcata
karst	karst
santana	santana
logroño	logroño
hilton	hilton
smithii	smithii
spotted	sett
spotted	observert
paniculata	paniculata
sexy	sexy
vinyl	vinyl
cược	veddemål
cược	sats
cược	satse
cược	satset
lars	lars
jia	jia
krasnodar	krasnodar
wikimapia	wikimapia
chẻ	hull
chẻ	hole
rainer	rainer
vilnius	vilnius
trieste	trieste
pharaon	faraoer
miers	miers
phineas	phineas
sirius	sirius
arafat	arafat
bèo	teit
leonid	leonid
fuller	fuller
kino	kino
phoebe	phoebe
concorde	concorde
fernald	fernald
benevento	benevento
seok	seok
cervus	cervus
boleslav	boleslav
brevipes	brevipes
sec	sek
sec	sec
natalie	natalie
barca	barca
cassini	cassini
halloween	halloween
midland	midland
narcissus	narcissus
nottingham	nottingham
boson	boson
angelica	angelica
labrador	labrador
shinichi	shinichi
malesia	malesia
mono	mono
charlton	charlton
sites	nettsteder
skin	hud
skin	flå
skin	huden
doyle	doyle
cedar	cedar
saturn	saturn
container	beholder
container	container
kerch	kertsj
thom	thom
jihlava	jihlava
gamespot	gamespot
tít	hører
tít	høre
nitrat	nitrat
hilbert	hilbert
rising	stigende
rising	stiger
rising	oppgang
eight	atte
eight	eight
eight	åtte
cobain	cobain
leigh	leigh
hogg	hogg
núm	klemt
núm	brystvorter
cody	cody
mitra	mitra
biếng	lat
biếng	late
biếng	lazy
massa	massa
shiva	shiva
shiva	shiva
shiva	siva
phlegra	phlegra
merlin	merlin
gmelin	gmelin
vesoul	vesoul
officiel	officiel
anchor	ankeret
anchor	anker
unidos	unidos
vice	vice
nymphalidae	flikvinger
phillip	phillip
phillip	philip
surrey	surrey
barset	barset
bolzano	bolzano
martinez	martinez
teaser	teaser
gill	gill
hilaire	hilaire
globe	globe
edison	edison
orton	orton
djokovic	đoković
oppenheimer	oppenheimer
sẹo	arr
sẹo	arr
bravo	bravo
honshū	honshū
tahiti	tahiti
bauer	bauer
eurovision	eurovision
mcdunnough	mcdunnough
wolfsburg	wolfsburg
kalinin	kalinin
hopper	hopper
goa	goa
nicholson	nicholson
dhabi	dhabi
smirnova	smirnova
guderian	guderian
tigris	tigris
mladá	mladá
soft	myke
soft	mykt
soft	soft
soft	myk
caproni	caproni
laguna	laguna
theodosius	theodosius
ornatus	ornatus
coca	coke
coca	cola
coca	coca
králové	králové
estadio	estadio
pixel	piksel
pixel	piksler
jörg	jörg
brevis	brevis
breed	breed
breed	rase
breed	oppdretter
cronquist	cronquist
philippi	filippi
titlestyle	titlestyle
sphinx	sphinx
sphinx	sfinksen
anemone	anemone
rogue	rogue
crimea	krim
breslau	breslau
factbook	factbook
bonus	bonus
flavipes	flavipes
thanatus	thanatus
điốt	diode
abkhazia	abkhasia
varde	varde
gardenia	gardenia
mồm	kjeften
mồm	munn
mồm	munnen
burma	burma
burma	burmas
pepper	pepper
baptist	baptist
hrsg	hrsg
jammu	jammu
griff	griff
koh	koh
dome	kuppel
dome	kuppelen
ramsey	ramsey
infinity	infinity
hayes	hayes
waterhouse	waterhouse
lombard	lombard
bịp	triks
bịp	knep
molina	molina
forrest	forrest
chòi	bungalow
chòi	feriehus
chòi	hytte
tankōbon	tankōbon
composite	composite
composite	sammensatt
loes	loes
andrés	andrés
medieval	middelalderske
pavonia	pavonia
tonumber	tonumber
cornelius	cornelius
brie	brie
robbie	robbie
sally	sally
pardubice	pardubice
zurich	zürich
choáng	sjokkert
jaén	jaén
mứt	syltetøy
mứt	jam
mứt	marmelade
patton	patton
psittacidae	parakitter
longicornis	longicornis
drew	trakk
drew	tegnet
drew	drew
bernhard	bernhard
dentata	dentata
tna	tna
hpa	hpa
benny	benny
elongatus	elongatus
cherokee	cherokee
hindenburg	hindenburg
smile	smile
smile	smil
attila	attila
leverkusen	leverkusen
tbilisi	tbilisi
plutoni	plutonium
rochester	rochester
rugby	rugby
kira	kira
kaoru	wada
marguerite	marguerite
navbox	navbox
laden	laden
benito	benito
aka	aka
ramesses	ramses
ambulyx	ambulyx
ngứa	klør
ngứa	kløe
ngứa	klør
ngứa	kløe
ngứa	klør
aeroflot	aeroflot
rebecca	rebecca
satoshi	satoshi
stones	stones
stones	steiner
panorama	panorama
chilensis	chilensis
schultz	schultz
prop	prop
trumpet	trompeten
trumpet	trompet
acanthaceae	akantusfamilien
desc	desc
martens	martens
pot	kjele
pot	pot
striatus	striatus
heian	heian
mexicanus	mexicanus
patterson	patterson
sengoku	sengoku
obi	obi
alma	alma
bốt	støvler
bốt	støvlene
bốt	boots
haryana	haryana
gsm	gsm
hwan	hwan
homer	homer
smaragdina	smaragdina
weasley	wiltersen
myers	myers
ligue	ligue
parvula	parvula
hmas	hmas
kombat	kombat
fourier	fourier
allegheny	allegheny
hub	senter
hub	hub
příbram	příbram
tivi	tv
tivi	fjernsyn
prinz	prinz
gifford	gifford
argentine	argentinsk
benin	benin
sar	sar
intercontinental	interkontinentale
aquino	aquino
philippinensis	philippinensis
tina	tina
saddam	saddam
mystery	mystikk
mystery	mysterium
ruth	ruth
carolyn	carolyn
psv	psv
stall	stall
monde	monde
hyllus	hyllos
página	página
beetle	biller
beetle	bille
picasso	picasso
bien	synlig
bien	synlige
bien	bien
hoffmann	hoffmann
hinton	hinton
heather	heather
geo	geo
sussex	sussex
joey	joey
nuremberg	nürnberg
silicon	silicon
silicon	silikon
isabel	isabel
nakane	nakane
damascus	damaskus
batista	batista
pirata	pirata
highland	highland
highland	høyland
olt	olt
avenue	avenue
alegre	alegre
aspx	aspx
tardieu	tardieu
toyotomi	toyotomi
anemia	anemi
schwarzenegger	schwarzenegger
chatham	chatham
una	una
niels	niels
fountain	fontene
imp	imp
frazione	frazione
bandai	bandai
holmberg	holmberg
vaucluse	vaucluse
smackdown	smackdown
sinai	sinai
huelva	huelva
albus	albus
pmid	pmid
beckham	beckham
xuyến	torus
reyes	reyes
gin	gin
camille	camille
wendy	wendy
blackwell	blackwell
phoiac	phoiac
oxit	oksid
eteeq	eteeq
echo	ekko
echo	echo
gneisenau	gneisenau
tbs	tbs
holiday	holiday
holiday	ferie
holiday	helligdag
ribera	ribera
dornier	dornier
chocolate	sjokolade
transistor	transistor
supermarine	supermarine
exilis	exilis
timur	timur
hemingway	hemingway
táp	bit
táp	bite
táp	jafs
chapuis	chapuis
spl	spl
psoe	psoe
capcom	capcom
viz	viz
hybrid	hybrid
collaris	collaris
bittorrent	bittorrent
gibbs	gibbs
battlefield	battlefield
battlefield	slagmark
pushkin	pushkin
neutrino	nøytrino
elton	elton
fiat	fiat
solidago	solidago
circus	sirkuset
circus	sirkus
circus	circus
subspecies	underart
montpellier	montpellier
atatürk	atatürk
dawson	dawson
ivoire	ivoire
stress	stress
sei	sei
baiano	baiano
tak	tak
aet	aet
pattern	mønster
greece	hellas
oliva	oliva
brain	hjerner
brain	hjerne
brain	hjernen
ferb	ferb
landmark	landmark
landmark	landemerke
levant	levant
vila	vila
sapporo	sapporo
manduca	manduca
buchanan	buchanan
alive	levende
alive	alive
rodriguez	rodriguez
comba	comba
vyazma	vjazma
volkhov	volkhov
cent	cent
leste	timor
lẻn	snik
lẻn	snike
sandy	sandy
cuốc	tilfeldige
cuốc	vilkårlig
cuốc	random
cuốc	tilfeldig
cuốc	hoe
desmond	desmond
paranaense	paranaense
terra	tera
terra	terra
tudor	tudor
nigripes	nigripes
javanica	javanica
neville	nilus
neville	neville
novara	novara
pal	pal
champs	champs
charmed	sjarmert
ceylon	ceylon
menu	menyen
menu	meny
menu	menyer
kelvin	kelvin
korlević	korlević
klug	klug
poltava	poltava
sergio	sergio
hawking	hawking
pitt	pitt
trier	trier
medium	medium
medium	middels
jakob	jakob
somali	somalia
somali	somalisk
somali	somaliere
shane	shane
cal	cal
cool	kult
cool	stilig
cool	kul
hardcore	hardcore
lons	lons
waltz	vals
waltz	waltz
waltz	valse
moreno	moreno
telegraph	telegraf
milk	melk
stadion	stadion
daphne	daphne
jackie	jackie
livingston	livingston
eos	eos
wollaston	wollaston
thierry	thierry
gracilipes	gracilipes
serena	serena
graz	graz
fiorentina	fiorentina
haleakala	haleakala
flo	flo
mons	mons
cessna	cessna
angolensis	angolensis
quest	quest
quest	søken
quest	tokt
zhuravleva	zhuravleva
kangaroo	kenguru
kangaroo	kenguruer
chrome	chrome
chrome	krom
douglass	douglass
ismail	ismail
saratoga	saratoga
irkutsk	irkutsk
liếm	slikke
liếm	slikker
isla	isla
intermedius	intermedius
debilis	debilis
alejandro	alejandro
friuli	friuli
lancashire	lancashire
muscicapidae	fluesnapperfamilien
albedo	albedo
cundinamarca	cundinamarca
infinite	uendelig
infinite	uendelige
castello	castello
myspace	myspace
buri	buri
saab	saab
zhao	zao
draco	draco
hale	hale
gloucester	gloucester
puget	puget
hamburger	hamburger
hamburger	hamburgere
sarajevo	sarajevo
baert	baert
breda	breda
res	res
marvin	marvin
lift	løft
lift	løfte
lift	haik
inn	vertshus
inn	kro
sonny	sonny
sonny	solan
neill	neill
esp	esp
aguilar	aguilar
drassodes	drassodes
gore	gore
hayashi	hayashi
kadokawa	kadokawa
sega	sega
phuket	phuket
donna	donna
pham	pham
kauai	kauai
anomala	anomala
yai	yai
halle	halle
basalis	basalis
notodontidae	tannspinnere
ulrich	ulrich
checkuser	checkuser
alston	alston
nitens	nitens
gap	gap
tirana	tirana
karelia	karelen
beaumont	beaumont
hàu	østers
hàu	østers
#the	#the
#the	#den
erie	erie
mourinho	mourinho
thulin	thulin
ogg	ogg
ulsan	ulsan
frances	frances
viva	viva
conmebol	conmebol
cafe	kaffe
cafe	café
cafe	cafe
cafe	kafé
assassin	snikmorder
farm	farm
farm	gård
farm	bondegård
kwang	guangxu
kwang	kwang
vanilla	thunder
vanilla	torden
vanilla	vanilje
lepidium	lepidium
extreme	ekstrem
extreme	ekstremt
extreme	ekstreme
extreme	extreme
bilbao	bilbao
bun	bulgarsk
bun	bulgarske
bun	bolle
multi	multi
newark	newark
isidro	isidro
armour	armour
woody	woody
fat	sølvfat
fat	fett
fat	tjukk
fat	fat
fat	fet
fat	feit
luffy	ruffy
myrtaceae	myrtefamilien
andrey	andrej
corleone	corleone
mẹo	tips
mẹo	tips
pegasus	pegasus
coriacea	coriacea
panamensis	panamensis
seymour	seymour
oligia	rødgult
haw	haw
browne	browne
wilde	wilde
glycine	glycin
plato	platon
olympus	olympus
tashkent	tasjkent
lex	lex
magnifica	magnifica
fukushima	fukushima
episodes	episoder
muñoz	muñoz
herb	herb
ringo	ringo
nicola	nicola
burgundy	burgund
burgundy	burgunder
renault	renault
mew	mew
minami	minami
stub	stub
avengers	avengers
weiss	weiss
rousseau	rousseau
mecca	mekka
cobos	cobos
kamakura	kamakura
augsburg	augsburg
switch	switch
switch	bytt
switch	bytte
herald	herald
herald	herold
fide	evangelisering
dickinson	dickinson
melanie	melanie
holloway	holloway
hume	hume
tama	tama
kar	kar
ngơ	ignorerer
ngơ	overser
muse	muse
chamberlain	chamberlain
bruch	bruch
gala	galla
gala	gallaen
bye	bye
cằm	hake
cằm	chin
cằm	haken
cằm	haka
pioneer	pioneer
pioneer	pioner
paula	paula
imdb	imdb
toulon	toulon
romano	romano
wizard	veiviseren
wizard	trollmann
zander	zander
selim	selim
yom	jom
elliptica	elliptica
damian	damian
bedford	bedford
hokage	hokage
haifa	haifa
armavir	armavir
cash	kontant
cash	cash
cash	kontanter
sorbonne	sorbonne
lugo	lugo
runner	runner
runner	løper
teo	teo
villanueva	villanueva
twilight	skumring
twilight	twilight
kenji	kenji
leme	leme
hispaniola	hispaniola
dorsalis	dorsalis
nur	nur
voltaire	voltaire
nhăn	rynke
robson	robson
méneville	méneville
mask	maske
merton	merton
cluj	cluj
sinclair	sinclair
asparagus	asparges
tábor	tábor
rojas	rojas
salmon	laks
salmon	salmon
rufipes	rufipes
dahl	dahl
nhả	frigi
nhả	slipp
nhả	løslatelse
thùa	agave
heathrow	heathrow
jenkins	jenkins
minneapolis	minneapolis
pack	pakke
pack	pakk
tbd	tbd
machado	machado
purpurascens	purpurascens
modena	modena
lions	lions
lions	løvene
lions	løver
buckingham	buckingham
kitty	kitty
kitty	pus
omer	omer
samara	samara
sholokhov	sjolokhov
petersen	petersen
mona	mona
elsa	elsa
maritima	maritima
estados	estados
madeleine	madeleine
baba	baba
backstreet	backstreet
tulagi	tulagi
taczanowski	taczanowski
saunier	saunier
nagano	nagano
spielberg	spielberg
kana	kana
alagoas	alagoas
coventry	coventry
pbs	pbs
pau	pau
baek	baek
lhasa	lhasa
ito	ito
calvert	calvert
bethune	bethune
polymer	polymer
nolan	nolan
fitzgerald	fitzgerald
treviso	treviso
mama	mama
mama	mamma
romeo	romeo
didier	didier
liguria	liguria
joyce	joyce
coccinea	coccinea
meet	meet
meet	møte
meet	møtes
meet	møt
alexis	alexis
annonaceae	annonaceae
radiata	radiata
hajime	hajime
avenger	hevner
greenwich	greenwich
caserta	caserta
kinabalu	kinabalu
nepalensis	nepalensis
usaf	usaf
nigriceps	nigriceps
revue	revy
revue	revyen
titus	titus
hayek	hayek
messenger	budbringer
messenger	messenger
por	por
lagos	lagos
stream	bekk
stream	bekken
stream	strøm
petra	petra
palmas	palmas
gatwick	gatwick
oldenburg	oldenburg
jacobs	jacobs
sikorsky	sikorsky
ngẫm	tygge
reims	reims
ensign	ensign
ensign	fenrik
lamiinae	vedbukker
nưa	lenger
nưa	lengere
niigata	niigata
carlsen	carlsen
ericsson	ericsson
achilles	akilles
achilles	achille
phalanx	falanks
gerard	gérard
gerard	gerrard
gerard	gerard
yerevan	jerevan
bergman	bergman
oran	oran
ortiz	ortiz
bogotá	bogotá
ropica	ropica
focke	focke
constance	constance
guiana	guyana
boca	boca
nếm	smak
nếm	smakebit
nếm	smake
nếm	smakte
nếm	smakt
nếm	smaker
ski	ski
guetta	guetta
simoni	simoni
swinhoe	swinhoe
dhaka	dhaka
seem	sem
amour	amour
amor	amor
theresia	theresia
zara	zara
richelieu	richelieu
snape	slur
michele	michele
