marilyn	マリリン
vincennes	ヴァンセンヌ
vincennes	ヴィンセンス
koyama	小山
cabin	キャビン
cabin	船室
simone	シモーネ
simone	シモーヌ
gifu	岐阜
rệp	バグ
rệp	不具合
rệp	クリープ
tanganyika	タンガニーカ
sacramento	サクラメント
genji	源氏
lecco	レッコ
wallis	ウォリス
hoét	ツグミ
jericho	エリコ
thatcher	サッチャー
faber	フェイバー
zip	zip
moravia	モラヴィア
tagawa	田川
nal	nal
fermat	フェルマー
raoul	ラウル
wiener	ウィーナー
colt	コルト
clarence	クラレンス
watt	ワット
watt	ワッツ
yoko	洋子
yoko	ヨーコ
caracas	カラカス
bomb	爆弾
sarkozy	サルコジ
judy	ジュディ
astronomy	天文学
pom	pom
mầu	カラー
poker	ポーカー
humeralis	humeralis
tal	タル
aya	あや
aya	aya
meade	ミード
dorothy	ドロシー
mcmahon	マクマホン
epstein	エプスタイン
jobs	ジョブ
jobs	求人
safari	サファリ
safari	safari
atr	atr
bonnie	ボニー
bonnie	bonnie
campobasso	カンポバッソ
gnome	ノーム
gnome	gnome
gutenberg	グーテンベルク
guild	ギルド
novo	ノヴォ
vita	ヴィータ
nxb	nxb
nantes	ナント
stay	滞在
stay	ステイ
hersilia	hersilia
worms	ミミズ
enrico	エンリコ
nháy	flash
nháy	フラッシュ
nháy	打撃
nháy	点滅
calhoun	カルフーン
alfredo	アルフレード
castilla	カスティーリャ
dayton	デイトン
takeo	武雄
bougainville	ブーゲンビル
thun	トゥーン
vulcan	バルカン
superman	スーパーマン
champ	チャンプ
saints	聖徒
saints	セインツ
sasebo	佐世保
kochi	高知
perez	ペレス
jerome	ヒエロニムス
jerome	ジェローム
rapunzel	ラプンツェル
pacifica	パシフィカ
hentz	hentz
trọc	ハゲ
meiji	明治
neal	ニール
sạc	充電器
sạc	チャージャー
sạc	チャージ
sạc	課金
sạc	充電
sạc	チャージ
sạc	充電
imax	imax
fossil	化石
bart	バート
rightarm	rightarm
karachi	カラチ
suvarnabhumi	スワンナプーム
commonwealth	コモンウェルス
cactus	サボテン
leroy	リロイ
cdp	cdp
dinamo	dinamo
biswas	biswas
prostějov	prostějov
mitterrand	ミッテラン
doug	ダグ
aoi	あおい
aoi	aoi
arroyo	アロヨ
anelosimus	anelosimus
oss	oss
alpine	高山
henrik	ヘンリク
sicily	シチリア
cream	クリーム
grimm	グリム
reeves	リーブス
finn	フィン
cassette	カセット
zlín	ズリーン
ufo	ufo
mendes	メンデス
cristiano	クリスティアーノ
aberdeen	アバディーン
platinum	プラチナ
platinum	白金
arad	arad
wikitable	wikitable
gfdl	gfdl
savoy	サヴォイ
savoy	サヴォワ
deportivo	デポルティーボ
cyprus	ヒノキ
bio	バイオ
kuban	クバーニ
fig	イチジク
electra	エレクトラ
neglecta	neglecta
trip	旅行
trip	トリップ
morocco	モロッコ
tara	タラ
airplay	airplay
eclipse	eclipse
penalty	ペナルティ
sts	sts
jeolla	全羅道
brandon	ブランドン
ozu	小津
ozu	大洲
hoover	フーヴァー
borgo	ボルゴ
rodney	ロドニー
foo	foo
sida	エイズ
sutton	サットン
zoom	ズーム
lover	恋人
honshu	本州
thera	thera
kirov	キーロフ
tor	tor
tor	トール
dallwitz	dallwitz
orient	オリエント
petrunkevitch	petrunkevitch
cos	cos
eaton	イートン
lakes	湖沼
suharto	スハルト
natalia	ナタリア
miwa	みわ
miwa	三輪
miwa	美和
diocletianus	ディオクレティアヌス
gmbh	gmbh
abrams	エイブラムス
giles	ジャイルズ
warwick	ワーウィック
whole	全体
aid	扶助
aid	援助
râm	シェイド
râm	日陰
râm	シェード
milwaukee	ミルウォーキー
noah	ノア
canavese	カナヴェーゼ
caucasus	コーカサス
lynx	lynx
ayuntamiento	ayuntamiento
app	アプリ
brook	小川
vhs	vhs
troll	トロール
troll	トロール
swanborough	swanborough
ethernet	イーサネット
peso	ペソ
peso	ペソ
carvalho	カルヴァーリョ
muon	欲しい
shock	ショック
shock	衝撃
tutu	チュチュ
serviceyears	serviceyears
nhử	ルアー
bend	曲げる
tchaikovsky	チャイコフスキー
caldwell	コールドウェル
fusion	フュージョン
obtusa	obtusa
kat	kat
königsberg	ケーニヒスベルク
coffee	コーヒー
task	タスク
ger	ger
sulfat	硫酸
tobias	トバイアス
pla	プラ
rivers	河川
sorex	トガリネズミ
legion	レギオン
ala	アラ
itf	itf
dash	ダッシュ
isis	イシス
trek	トレック
trek	トレッキング
lowe	ロウ
hikari	ひかり
pizza	ピザ
shikoku	四国
cobra	コブラ
akatsuki	あかつき
mindoro	ミンドロ島
unicef	ユニセフ
lumia	lumia
dee	ディー
rsa	rsa
argeș	アルジェシュ
hockey	ホッケー
hockey	アイスホッケー
xỉn	酔っぱらい
bow	ボウ
bow	お辞儀
bow	おじぎ
bow	船首
vic	ビック
nico	ニコ
pzl	pzl
jardin	jardin
ramsay	ラムジー
trevor	トレヴァー
trevor	トレバー
sherlock	シャーロック
avatar	アヴァターラ
avatar	アバター
briggs	ブリッグス
julio	フリオ
ricky	リッキー
reader	読者
reader	リーダー
harald	ハーラル
fortune	フォーチュン
tate	テート
tate	テイト
rand	ランド
baird	ベアード
rubin	ルービン
lesnar	レスナー
wiktionary	ウィクショナリー
rapid	快速
kiribati	キリバス
karlsruhe	カールスルーエ
shb	shb
cowboy	カウボーイ
samantha	サマンサ
analog	アナログ
kei	ケイ
ourense	オウレンセ
takashi	タカシ
takashi	たかし
kerry	ケリー
muller	ミュラー
muller	ミュラー
horst	ホルスト
merry	メリー
pagan	異教徒
mendelssohn	メンデルスゾーン
perseus	ペルセウス
olivia	オリヴィア
mem	mem
dodge	ダッジ
dodge	ドッジ
spike	スパイク
matsumoto	松本
gangnam	江南
aruba	アルバ
hawkins	ホーキンス
burt	バート
avignon	アヴィニョン
monarch	君主
monarch	モナーク
ashikaga	足利
olive	オリーブ
soares	ソアレス
femme	femme
bacău	バカウ
sqft	sqft
albescens	albescens
magellan	マゼラン
voyage	航海
agnes	アグネス
dốt	無知
calgary	カルガリー
jena	イェーナ
thessaloniki	テッサロニキ
gol	ゴル
tetra	テトラ
juno	ジュノー
sumner	サムナー
bock	ボック
haydn	ハイドン
murad	ムラト
malik	マリック
escape	エスケープ
escape	脱出
salon	サロン
salon	サロン
durban	ダーバン
lama	ラーマ
lama	ラマ
oswald	オズワルド
mara	マーラ
bikini	ビキニ
tomoya	智也
mika	美香
mika	ミカ
lia	リア
maggie	マギー
nicolet	nicolet
jürgen	ユルゲン
siết	ハグ
siết	スクイーズ
visa	visa
visa	ビザ
visa	査証
tokusatsu	特撮
francois	フランソワ
button	ボタン
tsushima	津島
alger	藻類
gong	ゴング
subtemplates	subtemplates
millot	millot
pet	pet
pet	ペット
pet	知能
drum	ドラム
drum	太鼓
merino	メリノ
martini	マルティーニ
martini	マティーニ
manfred	マンフレート
varna	ヴァルナ
amman	アンマン
nazi	ファシズム
jiménez	ヒメネス
brazilian	ブラジル
khabarovsk	ハバロフスク
creed	信条
creed	教義
technologies	テクノロジー
ceres	ケレス
lag	ラグ
trail	トレイル
bosco	ボスコ
lipid	脂質
yamagata	山形
chaos	カオス
chaos	混沌
umbrella	アンブレラ
karaoke	カラオケ
takao	高尾
textcolor	textcolor
aziz	アジズ
aziz	アズィーズ
vargas	バルガス
pomerania	ポメラニア
ping	ping
marin	マリン
marin	マラン
nazareth	ナザレ
abs	腹筋
abs	abs
keller	ケラー
boyle	ボイル
nod	遭難
spot	スポット
kuznetsov	クズネツォフ
cctv	cctv
matter	マッツ
herodotus	ヘロドトス
schumann	シューマン
vidal	ヴィダル
vidal	ビダル
jaya	ジャヤ
melissa	メリッサ
tar	タール
mureș	ムレシュ
casas	カサス
tribune	トリブヌス
aden	アデン
uppsala	ウプサラ
juliet	ジュリエット
elias	エリアス
elias	イライアス
yui	yui
cas	cas
cas	カス
cas	キャス
hamas	ハマース
reinhard	ラインハルト
vfl	vfl
idf	idf
chevalier	シュヴァリエ
sakurai	桜井
guillermo	ギリェルモ
guillermo	ギレルモ
mchenry	マクヘンリー
rutherford	ラザフォード
schubert	シューベルト
ensemble	アンサンブル
ishikawa	石川
frozen	フローズン
dyer	ダイアー
pieve	ピエーヴェ
vogue	ヴォーグ
nouméa	ヌメア
josephine	ジョゼフィーヌ
ilocos	イロコス
xíu	タイニー
xíu	ちっちゃい
xíu	ちび
xíu	小さい
decatur	ディケーター
atlantis	アトランティス
dewey	デューイ
capra	カプラ
sepia	セピア
akita	秋田
madman	狂人
madman	気違い
zenit	ゼニット
soto	ソト
charter	チャーター
charter	憲章
charter	貸切
neustadt	ノイシュタット
pamplona	パンプローナ
kyiv	キエフ
autobiography	自伝
bark	バーク
bark	樹皮
mêtan	メタン
mack	マック
guru	グル
aztec	アステカ
cor	コル
bmp	bmp
stereo	ステレオ
murcia	ムルシア
falco	ファルコ
lance	ランス
gettysburg	ゲティスバーグ
perspective	視点
dal	ダール
amd	amd
whois	whois
blogger	blogger
blogger	ブロガー
blogger	ブログ
stephanie	ステファニー
bing	ビング
castanopsis	シイ
itō	伊藤
itō	伊東
kaga	加賀
chapel	チャペル
commentary	解説
betta	ベタ
spice	香辛料
spice	スパイス
pires	ピレス
radiohead	レディオヘッド
octopus	オクトパス
octopus	タコ
acb	acb
reprint	翻刻
severin	セヴェリン
khít	荷造り
khít	梱包
sink	亜鉛
yamashita	山下
antioch	アンティオキア
rhodesia	ローデシア
bert	バート
makarov	マカロフ
harmony	ハーモニー
harmony	調和
diaz	ディアス
vầng	ゴールデン
vầng	黄金
gui	gui
odyssey	オデッセイ
ngo	ngo
kashima	鹿島
progressive	プログレッシブ
ndt	ndt
chernobyl	チェルノブイリ
murakami	村上
cisticola	cisticola
hammond	ハモンド
hastings	ヘイスティングス
patagonia	パタゴニア
gaya	ガヤ
olsen	オルセン
fairchild	フェアチャイルド
biella	ビエッラ
consolidated	連結
boyer	ボイヤー
găm	ダガー
găm	短剣
riyadh	リヤド
booth	ブース
plc	plc
gerrard	ジェラード
rum	ラム
argus	アーガス
vasco	バスコ
vasco	ヴァスコ
leibniz	ライプニッツ
futsal	フットサル
authorlink	authorlink
mandalay	マンダレー
anthology	アンソロジー
ishida	石田
pia	ピア
amenhotep	アメンホテプ
gorky	ゴーリキー
steam	スチーム
steam	蒸気
helgoland	ヘルゴラント
spa	スパ
spa	spa
spa	スパ
matsumura	松村
punta	プンタ
parvus	parvus
thaksin	タクシン
belowstyle	belowstyle
styles	スタイル
pool	ポル
boyd	ボイド
tornado	トルネード
tornado	竜巻
dmt	dmt
keane	キーン
chorus	コーラス
brahms	ブラームス
aphrodite	アプロディーテー
aphrodite	アフロディーテ
paso	パソ
paxton	パクストン
char	char
kramer	クレイマー
genesis	ジェネシス
saaristo	saaristo
frosinone	フロジノーネ
nissan	日産
namur	namur
mir	ミール
mogul	ムガル
ogv	ogv
fernandez	フェルナンデス
vader	ベイダー
yume	ゆめ
garrett	ギャレット
reuters	ロイター
nilsson	ニルソン
rình	ストーカー
rình	ストーカー
aladdin	アラジン
nach	nach
gpl	gpl
hodgson	ホジソン
piccolo	ピッコロ
providence	プロビデンス
psp	psp
generic	ジェネリック
malmö	マルメ
sampson	サンプ
sampson	サンプソン
daniels	ダニエルズ
sha	シャア
brady	ブレイディ
identity	アイデンティティー
identity	アイデンティティ
launch	打ち上げ
launch	起動
telescope	望遠鏡
vfb	vfb
rodgers	ロジャース
dolphin	ドルフィン
dolphin	イルカ
swing	スウィング
swing	スイング
inornata	inornata
syracuse	シラキュース
moritz	モーリッツ
cydia	cydia
gdi	gdi
buena	ブエナ
aleksey	アレクセイ
aleksey	アレクセイ
squad	分隊
kuroda	黒田
oro	オロ
khartoum	ハルツーム
steiner	シュタイナー
macrobrachium	テナガエビ
mackenzie	マッケンジー
regan	リーガン
steroid	ステロイド
steroid	ステロイド
scene	uml
dakar	ダカール
ipod	ipod
atkinson	アトキンソン
arlington	アーリントン
dahlgren	ダールグレン
kessler	ケスラー
exeter	エクセター
carrefour	カルフール
sedgwick	セジウィック
fax	ファックス
fax	ファクシミリ
fax	ファクス
fax	fax
tampa	タンパ
stevie	スティービー
siegfried	ジークフリート
banda	バンダ
vat	vat
vat	濡れ
liberec	リベレツ
buzău	ブザウ
mateo	マッテオ
mateo	マテオ
madame	マダム
rewrite	書き換え
rewrite	書き直し
rewrite	リライト
turdus	ツグミ
sylvatica	sylvatica
niño	niño
quito	キト
hades	ハーデース
dominic	ドミニク
sook	ソク
chelyabinsk	チェリャビンスク
hague	ハーグ
coracina	coracina
astoria	アストリア
richie	リッチー
satan	サタン
arch	アーチ
groupstyle	groupstyle
lübeck	リューベック
śląskie	śląskie
liam	リアム
tiffany	ティファニー
plutarch	プルタルコス
mathias	マティアス
mathias	マチアス
hilary	ヒラリー
hilary	ヒラリー
mel	メル
dress	スーツ
dress	背広
aureus	アウレウス
savannah	サバンナ
uranium	ウラン
pinto	ピント
conquest	征服
daisy	デイジー
katie	ケイティ
nucleotide	ヌクレオチド
uesugi	上杉
rubik	立方体
rubik	キューブ
rubik	ルービック
osborne	オズボーン
entre	entre
matthias	matthias
activeusers	activeusers
freshwater	淡水
natasha	ナターシャ
ribbon	リボン
nhọ	すす
owl	フクロウ
owl	ふくろう
numberofpages	numberofpages
numberofactiveusers	numberofactiveusers
numberofadmins	numberofadmins
molly	モリー
numberofarticles	numberofarticles
numberoffiles	numberoffiles
numberofusers	numberofusers
siêng	勤勉
soprano	ソプラノ
numberofedits	numberofedits
cdc	cdc
stellaria	ハコベ
vát	ヘッズ
vát	ヘッド
sanskrit	サンスクリット
crash	クラッシュ
ulus	ウルス
adsl	adsl
aki	アキ
aki	aki
ganymede	ガニメデ
hardcover	ハードカバー
challenger	チャレンジャー
rieti	リエーティ
cska	cska
bục	表彰台
stirling	スターリング
duffy	ダフィー
terrier	テリア
krupp	クルップ
austerlitz	アウステルリッツ
rết	ムカデ
seasons	季節
seasons	シーズン
osman	オスマン
hasan	ハサン
lte	lte
vẩn	でたらめ
meshid	meshid
ppm	ppm
patel	パテル
clan	氏族
prado	プラド
markov	マルコフ
oecd	oecd
emilio	エミリオ
demi	デミ
loop	ループ
mayo	マヨ
crimson	クリムゾン
asuka	あすか
asuka	飛鳥
asuka	明日香
sargent	サージェント
nasser	ナーセル
rfa	nrc
vip	vip
noaa	noaa
vittatus	vittatus
maple	メープル
maple	カエデ
tau	タウ
pesaro	ペーザロ
bmg	bmg
booker	ブッカー
lure	ルアー
ipairs	ipairs
payne	ペイン
ami	アミ
avex	avex
szolnok	ソルノク
zulu	ズールー
surabaya	スラバヤ
pub	パブ
platon	プラトン
mccarthy	マッカーシー
sal	サル
fin	フィン
ulmus	エルム
ulmus	ニレ
malpensa	マルペンサ
pyrenees	ピレネー
cyril	シリル
cyril	セロ
kremlin	クレムリン
griffith	グリフィス
everett	エヴァレット
naturelle	naturelle
mercy	慈悲
mercy	マーシー
scarlet	スカーレット
jaguar	ジャガー
mathieu	マチュー
firefly	ホタル
mcpherson	マクファーソン
rận	シラミ
rận	シラミ
rolf	ロルフ
villarreal	ビジャレアル
moulin	ムーラン
mamluk	マムルーク
motonari	元就
miura	三浦
blanche	ブランシュ
gar	ガー
sverdlovsk	スヴェルドロフスク
calcutta	コルカタ
calcutta	カルカッタ
spence	スペンス
hystrix	山嵐
hollow	中空
torii	鳥居
tierra	tierra
ozawa	小沢
ipad	ipad
fifth	フィフス
pauli	パウリ
belluno	ベッルーノ
isa	isa
trạc	御所
gpu	gpu
trent	トレント
elle	エル
lodge	ロッジ
celle	celle
bac	bac
anita	アニタ
hắt	くしゃみ
vđv	選手
vđv	アスリート
evan	エヴァン
evan	エバン
shoten	聖天
cocktail	カクテル
hiro	ヒロ
pamela	パメラ
minerva	ミネルウァ
audrey	オードリー
luanda	ルアンダ
loki	ロキ
perm	パーマ
wta	wta
thin	薄い
thin	細い
sql	sql
brooke	ブルック
riparia	riparia
toyama	富山
kaufman	カウフマン
tanh	サテン
anguilla	アンギラ
toby	トビー
chennai	チェンナイ
fribourg	フリブール
byzantium	ビザンチウム
geisha	芸妓
geisha	芸者
gale	風力
magdeburg	マクデブルク
dinar	ディナール
dart	ダーツ
pentium	pentium
expo	エキスポ
tráp	トラップ
flowering	開花
vince	ビンス
vince	ヴィンス
weibo	weibo
barber	理容師
barber	床屋
omaha	オマハ
cologne	ケルン
schmadel	schmadel
meson	中間子
stdinchi	stdinchi
kimura	木村
tulip	チューリップ
haruka	はるか
mergedtoprow	mergedtoprow
gmail	信用
gmail	クレジット
gmail	gmail
gradient	グラデーション
gradient	勾配
schwerin	シュヴェリーン
cosmos	cosmos
cosmos	コスモス
osamu	太宰
catanzaro	カタンザーロ
lotte	ロッテ
civic	シビック
chesapeake	チェサピーク
basil	バジル
basil	バジリコ
curran	カラン
oleg	オレグ
willy	ウィリー
shiro	シロ
shiro	四郎
fips	fips
pygmy	ピグミー
furious	激怒
maki	マキ
maki	真木
shuttle	シャトル
serge	セルジュ
darmstadt	ダルムシュタット
stdinchikey	stdinchikey
xịt	ハット
xịt	帽子
xịt	had
duff	ダフ
bunker	バンカー
froese	froese
selen	セレン
còng	手錠
còng	袖口
còng	手錠
tome	登米
urquhart	urquhart
brutus	ブルトゥス
brutus	ブルータス
cliff	クリフ
bernstein	バーンスタイン
eagles	イーグルス
morse	モース
hedge	垣根
emerald	エメラルド
frey	フレイ
duỗi	ストレッチ
duỗi	ストレッチ
cory	コーリー
beer	ビール
federico	フェデリコ
boss	ボス
coppola	コッポラ
casno	casno
sasaki	佐々木
indi	インジウム
groove	グルーヴ
crocus	クロッカス
avant	avant
theodora	テオドラ
tráo	インストール
brenda	ブレンダ
xắt	スライス
frodo	フロド
dreyfus	ドレイファス
guido	グイド
navajo	ナバホ
philips	フィリップス
philips	フィリップス
barlow	バーロウ
bangs	前髪
bronx	ブロンクス
lodi	ローディ
needham	ニーダム
maastricht	マーストリヒト
fujio	富士夫
steph	ステフ
novak	ノヴァク
anastasia	アナスタシア
ratchasima	ナコーンラーチャシーマー
rudolph	ルドルフ
avon	エイヴォン
linz	リンツ
siam	サイアム
timiș	ティミシュ
willard	ウィラード
udon	うどん
vincenzo	ヴィンチェンツォ
andromeda	アンドロメダ
sậm	ブロンコ
allah	アッラーフ
allah	アラー
sousa	ソウザ
megumi	めぐみ
condor	コンドル
shine	磨き
macro	マクロ
gel	ジェル
gel	ゲル
donovan	ドノヴァン
petite	ぷち
zaire	ザイール
colossus	コロッサス
hbo	hbo
caterpillar	ケムシ
copernicus	コペルニクス
montmartre	モンマルトル
dietrich	ディートリヒ
isola	イソラ
isola	イーゾラ
zola	ゾラ
kiso	木曽
hin	hin
crc	crc
alphonse	アルフォンス
jeddah	ジッダ
flensburg	フレンスブルク
crop	トリミング
crop	切り取る
crop	切り取り
pirates	パイレーツ
pirates	海賊
factsheet	factsheet
myth	神話
elder	長老
vittorio	ヴィットリオ
vittorio	ヴィットーリオ
frameless	frameless
vaslui	ヴァスルイ
moody	ムーディ
sands	サンズ
observer	オブザーバー
observer	オブザーバ
isu	isu
volta	ボルタ
volta	ヴォルタ
caligula	カリグラ
atv	atv
dolls	人形
tarawa	タラワ
ncbi	ncbi
avellino	アヴェッリーノ
akagi	赤城
marks	マークス
levine	レヴィン
claudio	クラウディオ
tenor	テナー
naomi	ナオミ
astrakhan	アストラハン
volgograd	ヴォルゴグラード
siena	シエナ
uniflora	uniflora
marty	マーティ
nichols	ニコルス
arturo	アルトゥーロ
ich	ich
void	無効
void	ボイド
amino	網野
amino	アミノ酸
hazegray	hazegray
edmonton	エドモントン
tuvalu	ツバル
rufiventris	rufiventris
sởi	麻疹
emery	エメリー
torch	トーチ
torch	たいまつ
fernandes	フェルナンデス
panda	パンダ
trachea	気管
parque	パルケ
shire	シャイア
brighton	ブライトン
asteroids	小惑星
coco	ココ
sếp	サー
sếp	チーフ
sếp	ボス
albatros	アルバトロス
tobruk	トブルク
matthews	マシューズ
stephan	ステファン
calder	カルダー
kuma	くま
mimi	ミミ
mor	モル
compostela	コンポステーラ
plastic	ビニール
plastic	プラスチック
plastic	プラスティック
magnitude	等級
messiah	メシア
totti	トッティ
lhp	lhp
apink	apink
ababa	ababa
blackberry	blackberry
travis	トラヴィス
baikonur	バイコヌール
halogen	ハロゲン
glacier	氷河
gomes	ゴメス
rúp	ルーブル
heredia	エレディア
imam	イマーム
dio	ディオ
wise	英明
cathay	キャセイ
doom	ドゥーム
ella	エラ
burger	バーガー
burger	ハンバーガー
bourdon	bourdon
lise	リーゼ
dustin	ダスティン
schaeffer	シェーファー
deck	甲板
deck	デッキ
zum	zum
holst	ホルスト
serial	シリアル
beth	ベス
dms	dms
bayes	ベイズ
mos	mos
nia	nla
nia	ニア
prelude	前奏曲
prelude	prelude
bombardier	ボンバルディア
fage	fage
bowers	バワーズ
guernsey	ガーンジー
falling	落下
unity	統一
rodrigo	ロドリゴ
artemis	アルテミス
suvorov	スヴォーロフ
majuro	マジュロ
nhòm	双眼鏡
abbott	アボット
bra	ブラジル
pts	pts
pictogram	ピクトグラム
yalta	ヤルタ
ibiza	ibiza
elf	エルフ
vicenza	ヴィチェンツァ
rupee	ルピー
rupee	ルピー
henning	ヘニング
nộm	ダミー
enzo	エンツォ
würzburg	ヴュルツブルク
bale	ベール
stokes	ストークス
pci	pci
frankie	フランキー
lond	lond
bride	花嫁
nikki	ニッキ
nikki	ニッキー
survival	サバイバル
mio	mio
sept	三軒茶屋
sept	sep
harmonica	ハーモニカ
sandwich	サンドイッチ
sandwich	サンドウィッチ
arenas	アレナス
emb	emb
fabio	ファビオ
fabio	ファビオ
peck	ペック
sensei	先生
trend	トレンド
trend	流行
sos	sos
ole	ole
gpcm	gpcm
mayotte	マヨット
vlaanderen	vlaanderen
views	ビュー
shepherd	シェパード
bunko	文庫
rosenberg	ローゼンベルク
cocos	ココス
moo	moo
archibald	アーチボルド
mica	雲母
sale	セール
sale	サドル
sétif	セティフ
vue	vue
siu	シウ
khay	トレイ
mcclellan	マクレラン
aachen	アーヘン
oracle	oracle
oracle	オラクル
oracle	神託
brendan	ブレンダン
ise	伊勢
buzz	バズ
sabina	サビーナ
scan	スキャン
penelope	ペーネロペー
penelope	ペネロペ
muỗng	スプーン
skull	髑髏
skull	頭蓋骨
lawson	ローソン
clk	clk
fier	フィエル
rhea	レア
sokolov	ソコロフ
hirsutus	hirsutus
bernadotte	ベルナドッテ
titans	タイタンズ
vis	vis
comments	コメント
rupert	ルパート
sarge	sarge
torah	トーラー
minato	みなと
alec	アレク
alec	アレック
karel	カレル
montserrat	モントセラト
bowie	ボウイ
karim	カリム
mueller	ミュラー
motorola	motorola
primera	プリメーラ
wiesbaden	ヴィースバーデン
canaan	カナン
gotham	ゴッサム
vote	投票
seto	瀬戸
boot	ブート
boot	ブーツ
naoh	naoh
hex	ヘックス
takumi	たくみ
münster	ミュンスター
castiglione	カスティリオーネ
nghẹt	混雑
urbino	ウルビーノ
uri	uri
chakri	チャクリー
marmara	マルマラ
concepción	コンセプシオン
afghan	アフガン
afghan	アフガニスタン
khm	khm
pls	pls
jill	ジル
murmansk	ムルマンスク
drusus	ドルスス
feyenoord	フェイエノールト
stavropol	スタヴロポリ
albizia	ネム
dominican	ドミニカ
kagawa	香川
nathaniel	ナサニエル
nghêu	ハマグリ
comet	彗星
sage	セージ
anpơ	アルプス山脈
anpơ	アルプス
mải	フォーエバー
kojima	小島
kojima	児島
emerson	エマーソン
closer	近い
wilkes	ウィルクス
mick	ミック
walton	ウォルトン
hói	ハゲ
noether	ネーター
addison	アディソン
trim	整える
trim	トリム
honorius	ホノリウス
harding	ハーディング
apec	apec
cellpadding	cellpadding
heron	サギ
hiroyuki	博之
globalsecurity	globalsecurity
berryz	berryz
nhóc	キッド
lib	lib
sunny	晴れ
sunny	サニー
enix	エニックス
vái	dua
varia	varia
tirol	チロル
enigma	エニグマ
nicaea	ニカイア
vase	花瓶
merkel	メルケル
corvus	カラス
corvus	クロウ
lit	カウント
hormon	ホルモン
hormon	ホルモン
celsius	摂氏
patterns	パターン
rough	ラフ
rough	乱暴
orochi	orochi
mah	mah
anas	anas
sus	sus
boo	ブー
boo	boo
stamp	切手
stamp	スタンプ
persona	ペルソナ
cindy	シンディ
barrier	バリア
barrier	障壁
pachycephala	ウィスラー
poison	ポアソン
scorpion	スコーピオン
scorpion	サソリ
gambit	ギャンビット
rockefeller	ロックフェラー
koga	甲賀
koga	古河
koga	古賀
gustavo	グスタボ
regensburg	レーゲンスブルク
bagration	バグラチオン
paulista	パウリスタ
accra	アクラ
ibaraki	茨城
ilya	イリヤ
aikido	合気道
horizon	地平線
horizon	ホライズン
horizon	水平線
dekalb	デカルブ
vigo	ビーゴ
phết	コンマ
hamlet	ハムレット
darkness	暗闇
dijon	ディジョン
arkhangelsk	アルハンゲリスク
mclaren	マクラーレン
nishimura	西村
sprint	スプリント
methyl	メチル
aleppo	アレッポ
verne	ヴェルヌ
ludwigslust	メクレンブルク
headerstyle	headerstyle
aol	aol
domino	ドミノ
kathmandu	カトマンズ
terminator	ターミネーター
produce	プロデュース
sucre	スクレ
ulm	ウルム
dir	dir
suzanne	スザンヌ
cdo	cdo
rms	rms
hiragana	平仮名
reina	レイナ
kenichi	健一
poe	ポー
mccoy	マッコイ
kagura	神楽
grundy	グランディ
gregorio	グレゴリオ
pagasa	pagasa
ghibli	ジブリ
lbs	lbs
winx	winx
aquarium	アクアリウム
aquarium	水族館
wifi	wifi
gregor	グレゴール
geh	geh
judas	ユダ
ubisoft	ubisoft
botoșani	ボトシャニ
carmel	カルメル
carmel	カーメル
bhutto	ブットー
azov	アゾフ
pony	ポニー
quad	quad
sgt	sgt
dorothea	ドロテア
aaa	aaa
hijikata	土方
toba	鳥羽
toba	トバ
ruficeps	ruficeps
berlusconi	ベルルスコーニ
astana	アスタナ
groningen	フローニンゲン
lindsay	リンジー
alexa	アレクサ
hélène	エレーヌ
hezbollah	ヒズボラ
latium	ラティウム
freddy	フレディ
vivaldi	ヴィヴァルディ
emanuel	エマニュエル
seneca	セネカ
rota	ロタ
portage	portage
hdtv	hdtv
secrets	秘密
jpn	jpn
blaise	ブレーズ
fix	フィックス
fix	修正
theresa	テレサ
aosta	アオスタ
jennings	ジェニングス
magnum	マグナム
katrina	カトリーナ
patch	パッチ
tcp	tcp
afonso	アフォンソ
khiêng	運ぶ
khiêng	持ち込み
cui	クイ
neamț	ネアムツ
saratov	サラトフ
chanel	シャネル
barros	バロス
dunkerque	ダンケルク
astro	アストロ
macerata	マチェラータ
nobelprize	nobelprize
phelps	フェルプス
tver	トヴェリ
inchikey	inchikey
downey	ダウニー
sasha	サーシャ
riva	リヴァ
hunedoara	フネドアラ
wilder	ワイルダー
adonis	アドーニス
couple	カップル
hertz	ヘルツ
kimono	着物
kimono	和服
scarborough	スカーバロー
scarborough	スカボロー
scarborough	scarborough
cali	カリ
dima	デミ
tibet	チベット
vodka	ウォッカ
mie	三重
revival	リバイバル
goo	グー
munda	ムンダ
ata	ata
gượng	洪水
gượng	恥ずかしい
dillon	ディロン
whisky	ウィスキー
whisky	ウイスキー
gorilla	ゴリラ
mauro	マウロ
christa	クリスタ
scorsese	スコセッシ
fibonacci	フィボナッチ
buddy	バディ
múc	スクープ
twins	双子
lupin	ルパン
gloucestershire	グロスタシャー
urawa	浦和
xerxes	クセルクセス
integrated	統合
constanţa	コンスタンツァ
urbana	アーバナ
woodward	ウッドワード
ripley	リプリー
sagan	サガン
nike	ナイキ
nike	nike
fans	ファン
tex	tex
linder	リンデル
mojo	mojo
mina	mina
mina	ミナ
mina	ミナト
push	プッシュ
push	押す
sanchez	サンチェス
raleigh	ローリー
tacoma	タコマ
mascara	マスカラ
pretoria	プレトリア
melo	メロ
ira	アイラ
genome	ゲノム
dioxin	ダイオキシン
ethan	イーサン
nic	nic
tdp	tdp
véc	スライス
fantasia	ファンタジア
grin	ニヤニヤ
ares	アレス
oryol	オリョール
corpus	コーパス
eureka	eureka
kabuki	歌舞伎
gorj	ゴルジュ
saul	ソール
saul	サウル
vnd	usd
kappa	カッパ
miyamoto	宮本
parry	パリー
melville	メルヴィル
ursula	ウルスラ
sharif	シャリフ
macintosh	macintosh
adi	シャン
clint	クリント
bonnet	ボンネット
trainer	トレーナー
poor	por
medusa	メドゥーサ
bulldog	ブルドッグ
godfrey	ゴドフリー
alexei	アレクセイ
innsbruck	インスブルック
toho	東宝
jesús	ヘスス
nickelodeon	ニコロデオン
enthusiast	enthusiast
ney	ナーイ
cinderella	シンデレラ
harten	harten
oshima	大島
fresno	フレズノ
galapagos	ガラパゴス
dino	ディーノ
dino	ディノ
shea	シェイ
anten	アンテナ
sakamoto	坂本
fatima	ファティマ
babylonia	バビロニア
gon	ゴン
carnival	カーニバル
debian	debian
nadia	ナディア
hasselt	ハッセルト
siebold	シーボルト
subic	スービック
mckinley	マッキンリー
ofc	ofc
villanova	ヴィッラノーヴァ
bose	ボーズ
pandora	パンドラ
astrid	アストリッド
lina	リナ
sochi	ソチ
deluxe	デラックス
constant	定数
dent	デント
quote	引用
brahman	ブラフマン
brahman	バラモン
abba	アバ
boxer	ボクサー
shkodër	シュコドラ
fps	fps
nấc	しゃっくり
salvatore	サルヴァトーレ
lòi	スティック
foucault	フーコー
megan	メーガン
groves	グローヴズ
kamiya	神谷
farrell	ファレル
wrightii	wrightii
vegeta	ベジータ
skipper	スキッパー
rss	rss
oca	oca
heracles	ヘーラクレース
kiyosato	清里
emedicinesubj	emedicinesubj
dow	ダウ
chừa	スペア
chừa	忌避
kano	カノ
kano	カヌー
asunción	アスンシオン
dns	dns
topic	話題
topic	トピック
busch	ブッシュ
palembang	パレンバン
lithuania	リトアニア
null	null
null	ヌル
plug	プラグ
convair	コンベア
doll	人形
riverside	リヴァーサイド
lilium	ユリ
chon	十字架
chon	クロス
chon	cross
chon	十字
corona	コロナ
terrestrial	地上波
nagato	長門
uhfffaoysa	uhfffaoysa
bios	bios
supreme	supreme
tuscany	トスカーナ
parabol	放物線
ucla	ucla
mya	mya
strawberry	いちご
strawberry	イチゴ
horner	ホーナー
thirty	三十
thirty	thirty
gothenburg	ヨーテボリ
townsend	タウンゼント
luz	ルス
massimo	マッシモ
wessex	ウェセックス
ebay	ebay
nieuw	nieuw
gris	グリ
lasalle	ラサール
bournemouth	ボーンマス
pythagoras	ピタゴラス
yahiko	弥彦
phốtpho	リン
herbst	herbst
torrent	torrent
orly	オルリー
dumas	デュマ
yamazaki	山崎
eskov	eskov
hitomi	ひとみ
hitomi	hitomi
resident	住民
fff	fff
bytes	バイト
solaris	solaris
heroin	ヘロイン
gardiner	ガーディナー
komatsu	小松
aral	アラ
gaertn	gaertn
poggio	ポッジョ
brett	ブレット
arles	アルル
gôn	ゴルフ
eli	エリ
eli	イーライ
adaptation	適応
maramureș	マラムレシュ
irina	イリナ
irina	イリーナ
share	共有
share	シェア
niue	ニウエ
dubrovnik	ドゥブロヴニク
pasadena	パサデナ
auflage	auflage
sas	sas
domenico	ドメニコ
patrice	パトリス
rabin	ラビン
robbins	ロビンス
carlisle	カーライル
bragg	ブラッグ
lucca	ルッカ
hidro	水素
doleschall	doleschall
hind	ドウ
hind	ハインド
raptor	ラプター
giỡn	混乱
jeans	ジーンズ
kirsch	キルシュ
marlon	マーロン
bowling	ボウリング
bowling	ボーリング
socrates	ソクラテス
weinberg	ワインバーグ
porsche	ポルシェ
tourisme	tourisme
chow	チャウ
chow	チャウチャウ
koro	コロ
lamar	ラマー
mom	ママ
amateur	アマチュア
kurata	倉田
okayama	岡山
verdi	ヴェルディ
miyagi	宮城
