parva	parva
gallo	gallo
kafka	kafka
sonora	sonora
leiden	leidenes
meteor	meteorīts
hubert	hubert
schumacher	šūmahers
bertrand	bertrand
turin	turīna
tibialis	tibialis
sylvia	silvija
wikitext	wikitext
valentin	valentīns
thriller	thriller
sensu	sensu
fidel	fidel
ash	pelni
ash	pelnu
ash	pelnus
brittany	bretaņas
ret	ret
giặt	veļas
giặt	veļa
giặt	mazgā
wrestlemania	wrestlemania
middlesbrough	middlesbrough
spitfire	spitfire
andre	andrē
andre	andrē
pierce	pīrss
rfc	rfc
catania	catania
canary	kanāriju
karst	karsta
cynanchum	cynanchum
santana	santana
hilton	hilton
smithii	smithii
spotted	pamanīja
vinyl	vinila
cược	derēt
cược	derības
lars	lars
krasnodar	krasnodara
wikimapia	wikimapia
chẻ	caurumu
chẻ	caurums
rainer	rainers
vilnius	viļņas
vilnius	viļņā
vilnius	viļņa
trieste	triestes
phineas	fineass
sirius	sirius
arafat	arafats
leonid	leonīds
fuller	pilnīgāku
phoebe	fēbe
concorde	concorde
boleslav	boleslav
sec	sek
sec	sec
natalie	natālija
barca	barca
cassini	cassini
midland	midland
nottingham	nottingham
boson	bozoni
labrador	labradora
mono	mono
charlton	čarltons
rót	lej
rót	ielej
sites	vietnes
skin	ādas
skin	ādu
skin	āda
doyle	doyle
cedar	ciedra
saturn	saturnu
container	tvertne
container	konteiners
container	konteinera
kerch	kerčas
jihlava	jihlava
gamespot	gamespot
tít	dzird
tít	dzirdu
tít	dzirdēt
nitrat	nitrātu
nitrat	nitrāti
nitrat	nitrāts
hilbert	hilberta
rising	aug
rising	celšanās
rising	pieaug
eight	astoņas
eight	astoņi
eight	astoņus
eight	astoņiem
cobain	kobeins
leigh	leigh
núm	izspieda
biếng	slinks
massa	massa
shiva	šivu
merlin	merlin
gmelin	gmelin
anchor	enkura
ascii	ascii
nymphalidae	nymphalidae
surrey	surrey
barset	barset
bolzano	bolcāno
martinez	martinez
gill	žaunu
edison	edison
djokovic	džokovičs
cyanea	cyanea
sẹo	rētas
sẹo	rēta
sẹo	rētas
bravo	bravo
tahiti	taiti
bauer	bauer
eurovision	eirovīzijas
wolfsburg	volfsburga
kalinin	kaļiņins
lateralis	lateralis
vittata	vittata
hopper	bunkura
goa	av
nicholson	nicholson
dhabi	dabī
smirnova	smirnova
guderian	guderians
mladá	mladá
soft	mīksto
soft	mīksti
soft	maiga
soft	mīkstie
soft	mīksta
soft	mīksts
laguna	laguna
theodosius	teodosijs
ornatus	ornatus
coca	koksa
coca	kokss
coca	coca
estadio	estadio
pixel	pikseļu
pixel	pikseļi
jörg	jörg
brevis	brevis
breed	šķirne
lcd	lcd
sphinx	sfinksa
anemone	anemones
rogue	negodīgi
crimea	krimas
factbook	factbook
bonus	bonus
bonus	bonusu
flavipes	flavipes
điốt	diode
abkhazia	abhāzijas
mồm	muti
mồm	mutē
mồm	mutes
mồm	mute
burma	birmu
burma	birmā
burma	birma
pepper	pipari
baptist	baptistu
hrsg	hrsg
jammu	džammu
griff	grifs
koh	koh
castanea	castanea
dome	dome
infinity	bezgalība
waterhouse	waterhouse
bịp	triks
molina	molina
chòi	kabīne
chòi	salona
composite	salikta
composite	kompozītu
andrés	andress
medieval	viduslaiku
tonumber	tonumber
cornelius	kornēlijs
robbie	robijs
sally	sallija
pardubice	pardubice
zurich	cīrihe
choáng	sairšanas
jyp	jiveskiles
mứt	jam
patton	patons
longicornis	longicornis
drew	pievērsa
bernhard	bernhards
tna	tna
hpa	hpa
hindenburg	hindenburgs
smile	smaidi
smile	smaids
leverkusen	leverkūzene
tbilisi	tbilisi
plutoni	plutonija
rochester	rochester
rugby	regbija
kira	kira
kaoru	wada
marguerite	marguerite
navbox	navbox
benito	benito
ngứa	nieze
ngứa	niezi
ngứa	nagus
ngứa	nagi
aeroflot	aeroflot
rebecca	rebeka
satoshi	satoši
stones	akmeņiem
stones	akmeņi
panorama	panorama
panorama	panorāma
chilensis	chilensis
ngấm	ieplūda
schultz	šulcs
prop	balsts
trumpet	trompete
desc	desc
martens	martens
pot	katlā
striatus	striatus
mexicanus	mexicanus
obi	obi
alma	alma
bốt	zābaki
gsm	gsm
pomorskie	pomorske
homer	homērs
weasley	vīzlijs
parvula	parvula
kombat	kombat
fourier	furjē
hub	rumbas
hub	hub
tivi	televizors
tivi	televīzijas
tivi	televīzija
prinz	princa
argentine	argentīna
argentine	argentīnas
benin	azerbaidžāna
benin	beninas
sar	sar
intercontinental	starpkontinentu
aquino	akino
tina	tīna
rugosa	rugosa
mystery	noslēpumainā
ruth	ruta
ruth	rūta
monde	monde
beetle	vaboles
picasso	pikaso
bien	redzams
bien	pamanāma
bien	redzami
bien	redzamais
bien	redzama
bien	debesis
hoffmann	hofmanis
heather	viršu
geo	geo
sussex	sussex
nuremberg	nirnbergas
silicon	silīcija
silicon	silīcijs
silicon	silīciju
silicon	silikona
isabel	izabella
damascus	damaska
batista	batista
highland	augstienes
avenue	avenue
cordata	cordata
aspx	aspx
chatham	chatham
una	una
niels	niels
fountain	strūklakas
fountain	strūklaka
vaucluse	voklīza
smackdown	smackdown
sinai	sinaja
pelhřimov	pelhržimovas
albus	baltus
pmid	pmid
beckham	bekhema
gin	džins
camille	kamila
wendy	vendija
medicago	medicago
phoiac	phoiac
oxit	oksīds
oxit	oksīdu
eteeq	eteeq
echo	echo
gneisenau	gneizenavs
holiday	brīvdiena
holiday	brīvdienu
ribera	ribera
dornier	dornier
chocolate	šokolādes
chocolate	šokolādi
chocolate	šokolāde
transistor	tranzistors
exilis	exilis
timur	timurs
hemingway	hemingvejs
táp	bite
táp	kož
psoe	psoe
capcom	capcom
viz	viz
hybrid	hibrīds
hybrid	hibrīda
collaris	collaris
bittorrent	bittorrent
gibbs	gibbs
canis	canis
battlefield	battlefield
pushkin	puškina
neutrino	neitrīno
elton	eltons
fiat	fiat
circus	cirks
circus	cirka
subspecies	pasugas
montpellier	monpeljē
atatürk	atatürk
ivoire	ivoire
stress	stress
sei	sei
tak	tak
pattern	raksts
greece	grieķijā
greece	grieķija
brain	smadzenes
benešov	benešova
levant	levant
fragilis	fragilis
vila	vila
sapporo	saporo
davao	davao
alive	dzīvs
alive	dzīva
volkhov	volhova
cent	centu
cent	centi
sandy	sandija
fra	fra
cuốc	nejauši
cuốc	nejauša
cuốc	gadījuma
cuốc	nejaušības
cuốc	izlases
ftp	ftp
desmond	dezmonds
paranaense	paranaense
terra	tera
terra	terra
tudor	tudor
nigripes	nigripes
wikisource	wikisource
javanica	javanica
pal	pal
champs	champs
menu	izvēlne
menu	menu
menu	ēdienkarte
menu	izvēlnes
menu	ēdienkartes
menu	izvēlnes
kelvin	kelvinos
klug	klugs
poltava	poltava
sergio	sergio
hawking	hokings
pitt	pits
orlicí	orlices
trier	trier
sistema	sistema
mazowieckie	mazowieckie
nihon	nihon
medium	vidēja
medium	vidējs
jakob	jakobs
somali	somālija
somali	somālijas
somali	somālijas
cal	kal
cool	forša
cool	forši
cool	cool
hardcore	hardcore
sizedefault	sizedefault
lons	lons
waltz	valsis
moreno	moreno
telegraph	telegrāfa
hcv	hcv
milk	piens
leucas	leucas
daphne	daphne
livingston	livingstona
eos	eos
wollaston	vulastona
thierry	thierry
rupestris	rupestris
serena	serena
graz	grācas
fiorentina	fiorentina
malus	malus
flo	flo
mons	monsa
quest	meklējumi
quest	meklējumos
kangaroo	ķengurs
kangaroo	ķenguri
lucida	lucida
ismail	ismail
siamensis	siamensis
irkutsk	irkutska
isla	isla
intermedius	intermedius
alejandro	alejandro
potamogeton	potamogeton
friuli	friuli
muscicapidae	muscicapidae
albedo	albedo
infinite	bezgalīgu
saab	saab
draco	drako
hale	heils
bács	bāčas
hamburger	hamburgers
hamburger	hamburgeri
sarajevo	sarajeva
breda	breda
res	res
marvin	mārvins
lift	pacelt
lift	lifts
inn	snn
inn	inn
neill	nīls
esp	esp
encyclopædia	encyclopædia
gore	gors
kiskun	kiškunas
donna	donna
kauai	kauai
anomala	anomala
halle	halle
halle	halles
blansko	blansko
ulrich	ulrich
checkuser	checkuser
nitens	nitens
gap	plaisu
gap	llp
tirana	tirānas
karelia	karēlijas
hàu	austeres
hàu	austeru
hàu	austeru
erie	erie
mourinho	mourinju
ogg	ogg
ulsan	ulsan
frances	frānsiss
adriatic	adrijas
viva	viva
conmebol	conmebol
cafe	kafiju
cafe	kafija
cafe	kafejnīca
farm	saimniecība
farm	audzētava
farm	ferma
farm	saimniecības
vanilla	pērkons
vanilla	vaniļas
société	société
extreme	ārkārtīgi
bilbao	bilbao
bun	bulgāru
bun	būla
bun	bun
auschwitz	aušvices
wiedemann	wiedemann
isidro	isidro
armour	bruņas
fat	tauki
fat	tauku
fat	taukiem
andrey	andrejs
mẹo	uzgaļi
mẹo	padomi
mẹo	ieteikumi
mẹo	tip
mẹo	padoms
mẹo	gals
metropolitana	metropolitana
pegasus	pegasus
seymour	sīmora
wilde	vailds
glycine	glicīns
plato	plato
olympus	olimps
tashkent	taškenta
lex	lex
magnifica	magnifica
fukushima	fukušimas
episodes	epizodes
herb	augam
herb	auga
ringo	ringo
nicola	nicola
burgundy	bordo
renault	renault
mew	mew
bleach	balinātāju
stub	pusass
avengers	avengers
weiss	weiss
rousseau	ruso
mecca	meku
augsburg	augsburga
switch	pārslēgties
switch	slēdzis
switch	pārslēgt
switch	slēdzi
herald	herald
fide	fide
dickinson	dikinsons
melanie	melānija
ngơ	ignorējot
ngơ	ignorē
muse	mūza
chamberlain	čemberlens
kazakh	kazahstānas
bye	bye
bye	atā
cằm	zoda
pioneer	pioneer
paula	paula
imdb	imdb
toulon	tulonas
romano	romano
wizard	burvis
zander	canders
selim	selims
hokage	hokage
haifa	haifas
cash	nauda
sorbonne	sorbonnas
lugo	lugo
twilight	krēslas
twilight	krēsla
entropy	entropijas
sardegna	sardīnijas
nur	nur
voltaire	voltērs
mask	maska
coa	coa
cluj	cluj
sinclair	sinclair
asparagus	sparģeļu
rojas	rojas
salmon	lasis
salmon	lašu
salmon	laša
salmon	laši
rufipes	rufipes
dahl	dahl
nhả	atlaist
nhả	atbrīvot
nhả	izlaišana
nhả	atbrīvošana
charlemagne	charlemagne
thùa	agave
heathrow	hītrovas
jenkins	jenkins
minneapolis	mineapolisā
pack	iepakojums
machado	mačado
modena	modena
lions	lauvas
buckingham	bekingemas
kitty	kitija
samara	samāras
sholokhov	šolohovs
mona	mona
elsa	elza
maritima	maritima
baba	baba
ost	ost
backstreet	backstreet
saunier	saunier
nagano	nagano
spielberg	spīlberga
kana	kana
coventry	coventry
pbs	pbs
pau	pau
svitavy	svitavi
ito	ito
calvert	kalverts
polymer	polimēri
polymer	polimērs
nolan	nolans
fitzgerald	ficdžeralds
treviso	treviso
linum	linum
mama	mamma
romeo	romeo
didier	didjē
liguria	ligūrijas
meet	satiekas
meet	tiekas
meet	sanāk
alexis	aleksis
radiata	radiata
greenwich	griničas
kinabalu	kinabalu
nigriceps	nigriceps
titus	tits
hayek	hayek
messenger	messenger
por	por
lagos	lagosa
stream	straumes
stream	straume
stream	stream
petra	petra
gatwick	getvikas
oldenburg	oldenburgas
jacobs	jacobs
reims	reimsas
ensign	ensign
niigata	niigata
carlsen	kārlsens
ericsson	ericsson
achilles	ahileja
phalanx	phalanx
gerard	gérard
gerard	džerards
yerevan	erevāna
bergman	bergmane
cast	lietos
focke	focke
constance	konstances
boca	boca
nếm	garšu
nếm	gaume
nếm	garša
nếm	garšas
ski	slēpju
ski	slēpošanas
pusillus	pusillus
dhaka	daka
seem	sem
amour	amour
amor	amor
theresia	theresia
zara	zāra
richelieu	rišeljē
snape	strups
cappadocia	kapadokija
michele	michele
swansea	swansea
guadalupe	guadalupe
españa	españa
mendoza	mendoza
judo	džudo
gmt+	gmt+
lampard	lampards
tunis	tunisa
allard	allard
lyudmila	ludmila
nigel	nigel
garfield	gārfīlds
tula	tulas
texte	texte
aff	aff
hermes	hermes
alicia	alīsija
registry	reģistrs
registry	kanceleja
eindhoven	eindhoven
seinen	seinen
archipelago	arhipelāga
kakashi	kakaši
gogh	goga
iglesias	iglesias
nirvana	nirvana
harley	harley
wanted	gribēju
wanted	gribēja
wanted	vēlējās
reno	reno
lagrange	lagrange
chát	skarbi
chát	chat
lahore	lahorā
melody	melodija
beretta	bereta
sterling	sterliņu
chambers	kameras
chambers	palātas
mari	mari
sikh	sikhu
sikh	turbānu
chevrolat	chevrolat
constantius	konstancijs
shirley	šērlija
michelangelo	mikelandželo
nairobi	nairobi
xui	neveiksme
lou	lū
boulogne	buloņas
pocket	kabatas
pocket	kabatā
akbar	akbar
sandra	sandra
krasnoyarsk	krasnojarska
buch	buch
elite	elite
elite	elites
interwiki	interwiki
acad	acad
angry	dusmīgs
angry	dusmīga
lisboa	lisabona
lisboa	lisabonas
lisboa	lisabonā
cotton	kokvilna
dispar	mūķene
shevchenko	ševčenko
klm	klm
kansai	kansai
oval	ovālas
marca	marca
lineatus	lineatus
mannheim	manheimā
everest	everest
nationale	nationale
mpeg	mpeg
ida	ida
atm	atm
deutsch	deutsch
cantor	kantors
dorset	dorsetā
dover	dover
avia	avia
tarsus	pakaļkāju
lamb	jērs
lamb	jēra
noir	noir
brezhnev	brežņevs
giỏ	kabatas
giỏ	kabatā
giỏ	grozs
giỏ	grozu
giỏ	grozi
sap	sap
lauren	lorēna
marta	marta
ruficollis	ruficollis
tạt	sinepes
tạt	sinepju
ars	ars
iana	iana
hana	hana
tristan	tristana
cascade	kaskāde
howe	howe
saunders	saunders
manitoba	manitoba
ausf	ausf
cật	nieres
almeida	almeida
tea	tēja
tea	tējas
tea	tēju
stern	pakaļgala
chrudim	hrudima
teddy	tedijs
marek	mareks
breaking	pārkāpj
alien	svešzemju
alien	sveša
schindler	šindlera
raja	radžu
lydia	lidija
fun	jautrība
fun	jautri
fun	prieki
kumamoto	kumamoto
jungle	džungļos
jungle	džungļu
hillary	hilarija
wolfram	volframa
dalton	dalton
gottfried	gotfrīds
stephens	stephens
mangan	mangāna
lesser	mazākā
bluetooth	bluetooth
conway	conway
msn	msn
schuster	šusters
fleming	flemings
rodrigues	rodrigesa
topo	topo
glucose	glikoze
credit	kredīta
credit	kredīts
credit	credit
carrie	kerija
classics	klasika
classics	klasikas
axel	aksels
corp	corp
punic	pūniešu
molotov	molotova
vieux	vieux
novosibirsk	novosibirska
frost	sals
bratislava	bratislavas
utrecht	utrehtas
herschel	heršels
obovata	obovata
munro	manro
endangered	apdraudēti
endangered	apdraudētas
endangered	apdraudēta
lausanne	lozanna
jacqueline	žaklīna
café	kafejnīca
café	kafejnīcas
café	kafejnīcu
café	kafejnīca
café	kafejnīcā
alata	alata
norris	norris
freiburg	freiburgas
sui	sun
sui	sui
amadeus	amadeus
nikita	ņikita
giacomo	džakomo
pleasant	patīkama
pleasant	patīkami
pleasant	patīkamas
pleasant	patīkams
davy	deivijs
magdalena	magdalena
arras	arrasa
điếc	nedzirdīgo
lupus	lupus
fimbriata	fimbriata
xxi	xxi
concept	jēdziens
concept	koncepciju
concept	koncepcija
concept	koncepts
archimedes	arhimēds
neu	neu
concinna	concinna
casino	kazino
sami	sāmu
marilyn	merilina
vincennes	vinsēnas
morebits	morebits
hyde	haida
lugubris	lugubris
fejér	fejēras
cabin	kabīne
cabin	salona
simone	simona
ulysses	ulysses
gifu	gifu
lacertidae	lacertidae
sacramento	sakramento
genji	gendži
lecco	leko
wallis	wallis
jericho	jericho
thatcher	thatcher
byron	bairons
vandal	vandal
khz	khz
faber	faber
bromwich	bromwich
zip	zip
arthropoda	arthropoda
kharkiv	harkova
toni	toni
moravia	morāvijas
wiener	wiener
danzig	dancigas
watt	vatu
senegalensis	senegalensis
caracas	karakasas
ned	ned
bomb	bumba
sarkozy	sarkozy
jerzy	jerzy
pole	polis
pole	pole
judy	džūdija
neue	neue
astronomy	astronomijas
crassus	crassus
mầu	krāsu
mầu	krāsa
poker	pokera
higgins	higgins
humeralis	humeralis
tal	tal
aya	aya
nevis	nevisa
inermis	inermis
internazionale	internazionale
germania	germania
dorothy	dorothy
hartley	hārtlijs
epstein	epšteins
jobs	darbi
jobs	darbavietas
safari	safari
atr	atr
bonnie	bonija
som	som
campobasso	kampobaso
pictus	pictus
gnome	gnome
gutenberg	gūtenberga
terre	terre
guild	ģilde
rumble	kautiņš
novo	novo
gloster	gloster
doubleday	doubleday
vita	vita
armata	armata
nantes	nante
stay	uzturēties
stay	paliec
stay	palikt
panthera	panteras
psyche	psihi
agard	agard
worms	tārpu
stefano	stefano
enrico	enrico
nháy	flash
nháy	blink
église	église
alfredo	alfredo
castilla	kastīlija
dayton	deitonas
angulata	angulata
bougainville	bugenvila
thun	thun
hispida	hispida
superman	supermens
champ	čempions
saints	svēto
aves	aves
perez	peresa
jerome	džeroms
clemens	klemenss
pacifica	pacifica
gupta	guptu
trọc	kailā
trọc	skūtgalvji
als	rl
als	als
als	ils
meiji	meidzi
neal	nīla
neal	nīls
sạc	lādētājs
sạc	uzlādes
imax	imax
fossil	fosilo
bart	bart
rightarm	rightarm
karachi	karači
commonwealth	sadraudzības
cactus	kaktuss
esther	estere
laurence	laurence
callas	kallasa
lester	lester
mérimée	merimē
carson	carson
mitterrand	mitterrand
doug	dags
amanita	mušmires
oss	oss
alpine	alpu
henrik	henrik
geoffroy	geoffroy
sicily	sicīlijas
sicily	sicīlijas
cream	krējums
grimm	grimmi
finn	fin
colubridae	colubridae
cassette	kasešu
laplace	laplass
argentea	argentea
ufo	ufo
mendes	mendes
platinum	platīna
kladno	kladno
wikitable	wikitable
castelnau	castelnau
gfdl	gfdl
savoy	savojas
deportivo	deportivo
kleist	kleist
cyprus	cipreses
bio	bio
kuban	kubaņ
electra	electra
nervosa	nervosa
trip	brauciens
trip	ceļojums
minimus	minimus
morocco	maroka
garde	garde
trois	trois
tara	tara
shia	šiītu
hittite	hetu
airplay	airplay
guthrie	gatrijs
eclipse	aptumsums
accipitridae	accipitridae
tap	dalībniece
penalty	sods
penalty	soda
sts	sts
pinyin	piņjiņa
brandon	brendons
hoover	hūvers
alnus	alnus
foo	foo
sida	palīglīdzekļi
sida	aids
sida	atbalsti
littoralis	littoralis
zoom	mērogs
zoom	zoom
muelleri	muelleri
flynn	flynn
gwangju	kvandžu
frontalis	frontalis
lover	mīļākais
honshu	honsju
kirov	kirovas
superba	superba
tor	tpr
capo	capo
orient	orient
hebrides	hebridu
eaton	ītons
lakes	ezeri
suharto	suharto
aspera	aspera
natalia	natālija
salazar	salazars
diocletianus	diokletiāns
gmbh	gmbh
abrams	abrams
giles	giles
watford	watford
whole	vesels
whole	veseli
whole	veselas
whole	vesela
aid	palīdzība
aid	atbalsts
râm	ēnā
milwaukee	milwaukee
edith	edīte
indianapolis	indianapolisa
noah	noā
caucasus	kaukāza
lynx	lūsis
app	app
app	lietotnes
app	aplikāciju
presley	presley
brook	strauts
vhs	vhs
troll	troļļu
troll	troļļi
osiris	ozīriss
calea	calea
ethernet	ethernet
peso	peso
fontainebleau	fontenblo
perugia	perudža
carvalho	carvalho
muon	gribu
muon	gribam
muon	gribi
muon	grib
shock	šoks
tutu	tutu
bend	līkumu
hirta	hirta
artiodactyla	artiodactyla
fusion	kodolsintēzes
xoang	sinusa
fyodor	fjodors
kat	kat
königsberg	kēnigsbergas
reiche	reiche
coffee	kafiju
coffee	kafija
task	uzdevumu
task	uzdevums
ger	ger
sulfat	sulfāts
tobias	tobias
pla	pla
iroquois	irokēzi
rivers	upēm
rivers	upēs
rivers	upes
flemish	flāmu
legion	leģiona
ala	ala
cctld	cctld
itf	itf
dash	domuzīme
isis	isis
trek	trek
pizza	pizza
pizza	pica
pizza	picas
shikoku	šikoku
cobra	kobra
akatsuki	akatsuki
ischnura	daiļspāres
unicef	unicef
lumia	lumia
dee	dī
rsa	rsa
hockey	hokejs
hockey	hokeja
xỉn	piedzēries
bow	tauriņi
sars	sars
sars	sar
vic	vic
nico	nico
fed	baro
antoinette	antuanete
kuril	kuriļu
jardin	jardin
ramsay	remzijs
trevor	trevors
limburg	limburgas
dolby	dolbijs
avatar	avatars
sinatra	sinatra
ivanov	ivanovs
chhattisgarh	čhatīsgarha
julio	julio
ricky	rikijs
reader	lasītājs
harald	haralds
fortune	bagātību
fortune	laimes
faraday	faradeja
tate	teita
baird	baird
arborea	arborea
cristóbal	cristóbal
rubin	rubin
cana	kānu
wiktionary	wiktionary
pteropus	pteropus
rowling	roulinga
rapid	ātra
rapid	ātrs
rapid	straujš
potosí	potosi
campestris	campestris
kiribati	kiribati
karlsruhe	karlsrūes
goodman	goodman
cowboy	kovbojs
samantha	samanta
analog	analogs
analog	analogā
memoirs	memuārus
takashi	takaši
kerry	kerry
muller	müller
ramón	ramón
ramón	ramon
horst	horst
merry	priecīgus
pagan	pagānu
mendelssohn	mendelsons
perseus	persejs
olivia	olīvija
mem	mem
dodge	dodge
augustine	augustīna
celebensis	celebensis
houghton	houghton
matsumoto	macumoto
gangnam	gangnam
chloris	chloris
horizonte	orizonti
cdma	cdma
aruba	aruba
communis	communis
monarch	monarhs
olive	olīvu
femme	femme
bowman	boumens
marginatus	marginatus
kitts	komplekti
magellan	magelāns
equus	equus
voyage	pārgājiena
voyage	reiss
agnes	agnese
dốt	vienaldzīgi
calgary	kalgari
jena	jēna
thessaloniki	saloniku
gol	gol
tetra	tetra
juno	juno
sumner	samners
bock	bock
dalmatia	dalmācija
haydn	haidns
murad	murads
malik	malik
escape	evakuācijas
escape	izbēgt
escape	aizbēgt
salon	salonos
salon	salons
durban	durbanas
lama	lama
squamata	zvīņrāpuļi
oswald	osvalds
mara	mara
bikini	bikini
ita	ita
mika	mika
lia	lia
hegel	hēgelis
maggie	megija
bua	bua
jürgen	jirgens
siết	izspiest
visa	vīzas
visa	vīzu
francois	francois
francois	françois
button	poga
button	pogu
duc	duc
köhler	köhler
alger	aļģes
alger	aļģu
rostrata	rostrata
gerd	gerds
qantas	qantas
pet	pet
pet	izlūkošanas
drum	bungas
drum	tvertne
daewoo	daewoo
pygmaeus	pygmaeus
merino	merino
martini	martini
clarkson	clarkson
manfred	manfred
varna	varna
amman	ammāna
nazi	fašistu
nazi	nacistu
schlesien	schlesien
tởm	pretīga
jiménez	jiménez
brazilian	brazīlijas
khabarovsk	habarovskas
creed	pārliecība
atra	atra
freiherr	freiherr
modestus	modestus
technologies	tehnoloģijas
ceres	ceres
malfoy	malfojs
trail	taka
trail	liecības
shore	krastā
shore	krasta
shore	krasts
shore	krastu
shore	piekraste
lipid	lipīdu
yamagata	jamagata
prentice	prentice
chaos	haoss
umbrella	lietussargu
umbrella	jumta
candida	candida
karaoke	karaoke
oskar	oskars
oskar	oskar
taman	tamaņas
takao	takao
ebert	ebert
textcolor	textcolor
zidane	zidāns
aziz	aziz
vargas	vargas
pomerania	pomerānijas
ping	ping
feat	varoņdarbu
rostock	rostoka
nazareth	nācaretes
plana	plana
abs	abs
keller	kellers
boyle	boila
spot	vietas
kuznetsov	kuzņecovs
dar	dar
crataegus	crataegus
matter	paklāji
herodotus	hērodots
schumann	šūmanis
kyu	kyu
jaya	jaya
melissa	melisa
tar	darvas
tar	darva
braunschweig	braunšveiga
riemann	rīmanis
tribune	tribīnes
erectus	erectus
uppsala	upsalas
juliet	džuljeta
elias	eliass
angus	angus
horus	hors
anfield	anfield
cas	cas
hamas	hamas
valeriana	valeriana
reinhard	reinhard
vfl	vfl
chevalier	chevalier
systematics	sistemātika
guillermo	guillermo
palmyra	palmiras
loc	loc
merriam	merriam
schubert	šūberts
ensemble	ansamblis
poincaré	puankarē
jamaicensis	jamaicensis
huron	huron
shawn	šons
juniperus	juniperus
vogue	vogue
berkshire	bērkšīrā
josephine	džozefīne
embraer	embraer
xíu	sīkā
xíu	sīkās
xíu	sīka
centenario	centenario
vitebsk	vitebskas
atlantis	atlantīda
dewey	djūija
capra	capra
barbuda	barbuda
akita	akita
zenit	zenit
canariensis	canariensis
margarita	margarita
soto	soto
dreamworks	dreamworks
charter	harta
charter	hartu
charter	hartas
oliveira	oliveira
neustadt	neustadt
polyommatus	zilenīši
pamplona	pamplonas
autobiography	autobiogrāfija
bark	mizu
bark	miza
bark	mizas
teleostei	teleostei
mêtan	metānu
mêtan	metāns
mêtan	metāna
mack	meka
abdominalis	abdominalis
guru	guru
sanders	sanders
aztec	acteku
potomac	potomakas
cor	rk
nikolay	nikolajs
bmp	bmp
bengalensis	bengalensis
stereo	stereo
murcia	mursijas
georgetown	džordžtaunas
fermi	fermi
mcgraw	mcgraw
falco	falco
pedersen	pedersen
lance	lens
parlophone	parlophone
perspective	perspektīvas
amd	amd
whois	whois
marmorata	marmorata
costata	costata
vida	vida
nora	nora
dubius	dubius
geum	geum
blogger	blogeris
blogger	blogus
stephanie	stefānija
bing	bings
aculeata	dzēlējlapsenes
shotgun	bises
kgb	vdk
chapel	kapelā
maison	maison
commentary	komentārs
confederations	konfederāciju
spice	garšvielu
spice	spice
radiohead	radiohead
filiformis	filiformis
guttata	guttata
octopus	astoņkāji
vasilevsky	vasiļevskis
reprint	reprint
sink	cinks
sink	cinka
saskatchewan	saskačevanas
hippolyte	ipolits
bohol	boholas
kaliningrad	kaļiņingradas
rhodesia	rodēzijā
makarov	makarovs
harmony	saskaņas
diaz	diaz
vầng	golden
vầng	zelta
tostring	tostring
gui	gui
odyssey	odisejā
ngo	nvo
sciuridae	sciuridae
tethys	tētija
kuiper	kuiper
kashima	kashima
progressive	progresīvi
progressive	progresīva
progressive	pakāpeniska
davidson	davidson
chernobyl	černobiļas
murakami	murakami
amazonica	amazonica
gaya	gaja
olsen	olsen
fairchild	fairchild
champaign	šampaņā
găm	dunci
ava	ava
riyadh	rijāda
booth	būts
demosthenes	dēmostens
plc	plc
rum	ruma
rum	rums
acuta	acuta
argus	argus
vasco	vasko
armée	armée
assimilis	assimilis
leibniz	leibniz
paralympic	paraolimpiskās
authorlink	authorlink
variegatus	variegatus
anthology	anthology
pia	pia
gorky	gorkijs
steam	tvaika
steam	tvaiku
phoenicia	feniķija
musume	musume
spa	spa
punta	punta
belowstyle	belowstyle
styles	stili
pool	pol
boyd	boids
tornado	tornado
tornado	viesuļvētra
vin	vin
dmt	dmt
keane	kīns
chorus	korī
maluku	moluku
brahms	brāmsa
aphrodite	afrodīte
lone	lone
dolly	dollija
char	palija
kramer	krāmers
rae	rae
genesis	ģenēzes
corinth	korints
nissan	nissan
mir	mir
gabrielle	gabriela
dagestan	dagestāna
vader	veiders
peterson	peterson
garrett	garets
vent	ventilācijas
reuters	reuters
nilsson	nilsson
rình	izseko
novorossiysk	novorosijska
officinalis	officinalis
nach	nach
aix	aix
gpl	gpl
hodgson	hodžsons
collina	collina
josep	josep
abruzzo	abruco
clifford	klifords
providence	providensa
psp	psp
clare	klēra
generic	vispārīgs
generic	vispārējs
ploceus	audējputns
carlton	carlton
malmö	malme
daniels	daniels
nymburk	nymburk
vitis	vitis
sha	sha
brady	breidijs
identity	personība
identity	identitāti
identity	identitāte
identity	identitātes
launch	palaist
telescope	teleskops
vfb	vfb
destroyer	iznīcinātāju
hradiště	hradište
rodgers	rodgers
dolphin	delfīnu
swing	sparā
inornata	inornata
aegean	egejas
pavlov	pavlovs
martins	martins
moritz	morics
hypericum	hypericum
buena	buena
aleksey	aleksejs
tvt	tvt
squad	squad
squad	vadu
nanus	nanus
coleman	coleman
baikal	baikāla
liszt	lists
oro	oro
khartoum	hartūmas
steiner	steiner
regan	rīgens
steroid	steroīdu
steroid	steroīdi
dakar	dakāras
ipod	ipod
atkinson	atkinson
abd	abd
packard	packard
arlington	ārlingtona
ascoli	askoli
exeter	ekseteras
nitidus	nitidus
biếc	nil
fax	fakss
fax	faksa
brotherhood	brālība
tampa	tampa
siegfried	zigfrīds
vat	pvn
vat	slapjas
vat	slapjš
vat	mitra
poseidon	poseidon
liberec	libereca
mateo	mateo
madame	kundze
sylvatica	sylvatica
niño	ninjo
dominic	dominiks
chelyabinsk	čeļabinskas
hague	hāgas
pskov	pleskavas
satan	sātana
arch	arkas
groupstyle	groupstyle
lübeck	lībekas
śląskie	slonske
liam	liam
sylvester	silvestrs
actinopterygii	starspures
braga	braga
horace	horācijs
plutarch	plūtarhs
mathias	matiass
hilary	hilarija
hilary	hilarija
mel	mel
nest	ligzda
nest	nest
dress	uzvalks
dress	uzvalku
aureus	aureus
guevara	gevara
savannah	savannu
laval	laval
uranium	urāna
uranium	urāns
saxicola	saxicola
rutenberg	rutenberg
pinto	pinto
claus	vecītis
claus	klauss
dnepr	piedņepras
universidad	universidad
beatrice	beatrise
daisy	dēzija
katie	keitija
navarra	navarra
léopold	leopolds
nucleotide	nukleotīdu
arabica	arabica
rubik	kubs
rubik	kuba
rubik	rubiks
entre	entre
proxima	proxima
matthias	matiass
sergipe	seržipi
freshwater	saldūdens
natasha	nataša
ribbon	lente
ribbon	lenta
ribbon	lentas
pali	pali
boer	boer
nhọ	neveiksme
nhọ	kvēpu
belgorod	belgoroda
owl	pūce
molly	moll
picea	picea
bieber	bībera
wen	wen
sassari	sardīnijas
siêng	rūpīga
siêng	rūpīgas
soprano	soprāns
goliath	goliāts
cdc	cdc
bory	bory
vát	galvas
sanskrit	sanskrits
yao	jao
crash	avāriju
crash	avārija
gaz	gaz
ulus	ulus
adsl	adsl
gaia	gaja
aki	aki
ganymede	ganimēds
pycnonotus	bulbuls
hanna	hanna
fragrans	fragrans
amelia	amēlija
cinerascens	cinerascens
challenger	challenger
zheng	džens
kanye	kanje
ribosome	ribosomu
balboa	balboa
laevigata	laevigata
cinereus	cinereus
helmuth	helmuts
cska	cska
bục	pjedestāla
stirling	stirlinga
abies	abies
opava	opava
duffy	duffy
terrier	terjers
esa	eks
esa	eka
esa	esa
seasons	sezonas
osman	osman
hasan	hasan
karabakh	karabaha
lte	lte
vẩn	muļķības
meshid	meshid
ppm	ppm
dejean	dejean
clan	klans
mangifera	mangifera
femoralis	femoralis
prado	prado
oecd	oecd
oecd	esao
fruticosa	čuža
freud	freids
emilio	emilio
suturalis	suturalis
