budějovice	budějovice
khalip	halifa
schalke	schalke
kyushu	kjušu
cremona	cremona
handel	händel
turing	turingova
piston	pistons
kyle	kyle
dale	dale
gloria	gloria
oder	odra
lange	lange
shannon	shannon
liti	litij
mehmed	mehmed
cayman	calgary
cayman	kajmanska
summit	samit
martinique	martinika
villiers	villiers
gotha	gotha
wanda	wanda
wilcox	wilcox
martino	martino
saxophone	saksofon
vanessa	vanessa
baghdad	bagdad
ryukyu	ryukyu
schwartz	schwartz
hohenzollern	hohenzollern
howell	howell
tolstoy	tolstoj
neptune	neptun
jupiter	jupiter
velvet	velvet
mia	mia
mia	mija
alfonso	alfons
alfonso	alfonsa
lara	lara
bromley	bromley
proxy	proxy
djibouti	džibutija
hattori	hattori
training	obuke
training	trening
training	obuka
training	treninga
training	obuku
musa	musa
acta	acta
akb	akb
californica	californica
marcello	marcello
kırıkkale	kırıkkale
gilles	gilles
norodom	norodom
funk	funk
robustus	robustus
shepard	šepard
zanzibar	zanzibar
lil	lil
dmitry	dimitrije
dmitry	dmitrij
dmitry	dmitry
apiaceae	apiaceae
cowan	cowan
randolph	randolph
oakland	oakland
toscana	toskana
ambrose	ambrose
aurelius	aurelije
sheikh	šejh
gear	tempo
gear	opremu
andorra	podgorica
olympique	olympique
benedict	benedikt
benedict	benedikta
palmer	palmer
irving	irving
trau	umoran
lat	lat
coruña	coruña
wigan	wigan
ôtô	automobile
ôtô	automobili
ôtô	automobila
clement	kliment
clement	klement
nobilis	nobilis
darren	darren
paulus	paulus
chopin	chopina
gerhard	gerhard
ariel	ariel
indie	indie
konrad	konrad
castillo	castillo
kung	kung
championships	prvenstava
beograd	beograd
martha	martha
marius	mariusa
espírito	espírito
helmut	helmut
avril	avril
mbar	mbar
khuya	kasni
khuya	kasno
suffolk	suffolk
liststyle	liststyle
kilis	kilis
niken	nikl
kimi	kimi
beaufort	beaufort
maui	maui
tone	ton
rue	rue
ferrari	ferrari
stan	stan
rebel	pobunjenika
regina	regina
laporte	laporte
cherry	višanja
scout	scout
coburg	coburg
pereira	pereira
interscope	interscope
orissa	orissa
bruxelles	brisel
gaston	gaston
citation	citati
curie	curie
chuck	chuck
dora	dora
donau	dunav
donau	donau
romagna	romagna
bergen	bergen
laevis	laevis
scottish	škotski
turkish	turski
antigonos	antigon
shop	radnja
shop	shop
shop	prodavnice
roche	roche
lamiaceae	lamiaceae
parva	parva
gallo	galo
kafka	kafka
sonora	sonora
leiden	leiden
meteor	meteorski
hubert	hubert
schumacher	schumacher
bertrand	bertrand
turin	torino
tibialis	tibialis
sylvia	sylvia
wikitext	wikitext
valentin	valentin
thriller	triler
holly	holly
sensu	sensu
fidel	fidel
ash	pepeo
ash	ash
brittany	bretanje
benoist	benoist
gentry	gentry
pohl	pohl
giặt	opran
middlesbrough	middlesbrough
barker	barker
spitfire	spitfire
philipp	philipp
andre	andre
andre	andré
barton	barton
pierce	pierce
rfc	rfc
catania	catania
canary	kanarska
karst	kraške
santana	santana
logroño	logroño
hilton	hilton
smithii	smithii
spotted	uočena
sexy	sexy
cược	opklada
cược	ulog
cược	opkladu
lars	lars
jia	jia
krasnodar	krasnodar
wikimapia	wikimapia
chẻ	rupa
rainer	rainer
vilnius	vilnius
trieste	trst
pharaon	faraona
phineas	phineas
sirius	sirius
arafat	arafat
leonid	leonid
kino	kino
phoebe	feba
concorde	concorde
benevento	benevento
boleslav	boleslav
natalie	natalie
barca	barka
barca	barca
cassini	cassini
midland	midland
nottingham	nottingham
boson	bozon
angelica	angelica
labrador	labrador
mono	mono
charlton	charlton
rót	ulivaju
sites	sajtova
sites	sajtovi
skin	koža
doyle	doyle
saturn	saturn
thom	thom
jihlava	jihlava
gamespot	gamespot
tít	čuti
tít	čujem
tít	hear
tít	čuju
nitrat	nitrat
hilbert	hilbert
rising	rastuće
eight	osam
cobain	cobain
leigh	leigh
hogg	hogg
mitra	mitra
massa	massa
shiva	shiva
merlin	merlin
officiel	officiel
ascii	ascii
vice	potpredsednik
vice	potpredsjednik
vice	vice
phillip	phillip
surrey	suri
barset	barset
bolzano	bolzano
martinez	martinez
hilaire	hilaire
globe	globus
edison	edison
djokovic	đoković
chằng	ligamenata
sẹo	ožiljaka
bravo	bravo
tahiti	tahiti
bauer	bauer
eurovision	euroviziji
wolfsburg	wolfsburg
kalinin	kalinin
lateralis	lateralis
goa	goa
nicholson	nicholson
dhabi	dhabi
guderian	guderian
tigris	tigris
mladá	mladá
soft	meka
soft	meku
laguna	laguna
theodosius	theodosius
coca	coke
coca	kolu
coca	koka
coca	coca
králové	králové
estadio	stadion
pixel	piksel
jörg	jörg
brevis	brevis
cronquist	cronquist
philippi	philippi
titlestyle	titlestyle
lcd	lcd
sphinx	sfinga
anemone	anemona
rogue	zli
crimea	krim
breslau	breslau
factbook	factbook
bonus	bonus
điốt	dioda
abkhazia	abhazija
gardenia	gardenia
mồm	usta
burma	burmi
pepper	biber
hrsg	hrsg
jammu	jammu
hsiu	hsiu
koh	koh
dome	kupola
ramsey	ramsey
infinity	beskonačnost
hayes	hayes
waterhouse	waterhouse
bịp	trik
molina	molina
forrest	forrest
chòi	kabine
chòi	kolibe
composite	složeni
andrés	andrés
medieval	srednjovjekovna
medieval	srednjevjekovna
tonumber	tonumber
cornelius	kornelije
robbie	robbie
sally	sali
pardubice	pardubički
zurich	cirih
zurich	zürich
jaén	jaén
mứt	jam
mứt	marmelada
patton	patton
bernhard	bernhard
hpa	hpa
benny	beni
hindenburg	hindenburg
smile	smile
smile	osmijeh
attila	atila
leverkusen	leverkusen
tbilisi	tbilisi
plutoni	plutonij
rochester	rochester
rugby	ragbi
rugby	rugby
kira	kiri
kaoru	wada
navbox	navbox
laden	laden
benito	benito
aka	zvani
ramesses	ramses
ngứa	čeljusti
aeroflot	aeroflot
rebecca	rebeka
satoshi	satoshi
stones	kamenova
stones	kamenje
panorama	panorama
schultz	schultz
prop	prop
trumpet	truba
desc	desc
pot	pot
patterson	patterson
patterson	paterson
obi	obi
alma	alma
bốt	boots
gsm	gsm
hwan	hwan
pomorskie	pomorskie
homer	homer
weasley	weasley
ligue	ligue
fourier	fourier
allegheny	allegheny
hub	čvorište
tivi	televizija
prinz	prinz
gifford	gifford
argentine	argentinac
benin	benin
sar	sar
intercontinental	interkontinentalni
aquino	aquino
tina	tina
saddam	sadam
mystery	misterija
ruth	ruth
carolyn	carolyn
psv	psv
monde	monde
lehr	lehr
bien	vidljiv
bien	vidljiva
bien	vidljivi
bien	vidljivo
bien	bien
bien	nebo
bien	skies
hinton	hinton
heather	heather
geo	geo
sussex	sussex
joey	joey
nuremberg	nirnberški
silicon	silicij
silicon	silikon
isabel	isabel
damascus	damask
batista	batista
highland	highland
olt	olt
avenue	avenue
alegre	alegre
paradoxa	paradoxa
aspx	aspx
anemia	anemija
schwarzenegger	schwarzenegger
chatham	chatham
una	una
niels	niels
fountain	fontana
fountain	česme
imp	imp
bandai	bandai
kalimantan	kalimantan
sinai	sinaju
shirak	širak
huelva	huelva
albus	albus
pmid	pmid
beckham	beckham
xuyến	torus
reyes	reyes
gin	džin
camille	camille
camille	kamil
wendy	wendy
medicago	medicago
blackwell	blackwell
phoiac	phoiac
oxit	oksidi
eteeq	eteeq
echo	jeka
sever	sever
tbs	tbs
holiday	praznik
chocolate	čokolada
transistor	tranzistor
supermarine	supermarine
timur	timur
hemingway	hemingway
táp	bite
táp	zalogaj
capcom	capcom
viz	viz
hybrid	hibridni
hybrid	hybrid
bittorrent	bittorrent
gibbs	gibbs
canis	canis
battlefield	ratište
battlefield	bojnom
pushkin	puškin
neutrino	neutrino
elton	elton
griswold	griswold
fiat	fiat
circus	cirkus
subspecies	podvrsta
montpellier	montpellier
atatürk	atatürk
ivoire	ivoire
stress	stres
sei	sei
tak	tak
aet	aet
pattern	šema
pattern	obrazac
greece	grčka
oliva	oliva
brain	mozak
landmark	obilježje
levant	levant
vila	vila
sapporo	sapporo
manduca	manduca
buchanan	buchanan
alive	živa
rodriguez	rodriguez
cent	cent
sandy	sandy
fra	fra
ftp	ftp
desmond	desmond
paranaense	paranaense
bvt	bvt
terra	terra
tudor	tudor
wikisource	wikisource
neville	nevil
neville	neville
novara	novara
pal	pal
charmed	čarobnice
ceylon	ceylon
menu	menu
menu	menus
kelvin	kelvin
klug	klug
poltava	poltava
sergio	sergio
hawking	hawking
pitt	pitt
trier	trier
quezon	quezon
nihon	nihon
medium	medium
medium	srednji
medium	srednjim
medium	srednje
medium	srednja
jakob	jakob
somali	somalija
somali	somalijski
shane	shane
cal	cal
cool	kul
cool	cool
hardcore	hardcore
sizedefault	sizedefault
waltz	valcer
moreno	moreno
telegraph	telegraph
milk	mlijeko
daphne	daphne
jackie	džeki
jackie	jackie
livingston	livingston
eos	eja
wollaston	wollaston
thierry	thierry
serena	serena
graz	graz
fiorentina	fiorentina
malus	malus
flo	flo
mons	mons
angolensis	angolensis
across	širom
quest	potraga
kangaroo	kengur
kangaroo	kenguri
chrome	hrom
sakleshpur	hanbel
douglass	douglass
ismail	ismail
saratoga	saratoga
irkutsk	irkutsk
liếm	lick
isla	ostrvo
intermedius	intermedius
alejandro	alejandro
friuli	furlanija
lancashire	lancashire
albedo	albedo
infinite	beskonačno
castello	castello
buri	buri
saab	saab
zhao	zao
draco	draco
hale	hale
gloucester	gloucester
puget	puget
sarajevo	sarajeva
sarajevo	sarajevo
sarajevo	sarajevu
marvin	marvin
lift	lift
lift	podići
lift	podigne
sonny	sonny
neill	neill
esp	esp
encyclopædia	encyclopædia
aguilar	aguilar
hayashi	hayashi
fuscus	fuscus
sega	sega
donna	dona
donna	donna
yai	yai
halle	halle
basalis	basalis
ulrich	ulrich
checkuser	checkuser
alston	alston
gap	jaz
tirana	tirana
beaumont	beaumont
#the	#na
erie	eri
mourinho	mourinho
ogg	ogg
ulsan	ulsan
frances	frances
adriatic	jadransko
adriatic	jadrana
adriatic	jadran
adriatic	jadranska
viva	viva
conmebol	conmebol
cafe	kahva
cafe	cafe
assassin	ubica
farm	farma
kwang	kwang
vanilla	grom
vanilla	vanilla
société	société
extreme	ekstremni
extreme	krajnjem
extreme	ekstremne
extreme	ekstremnim
bilbao	bilbao
bun	bugarski
bun	booleova
bun	bun
auschwitz	auschwitz
wiedemann	wiedemann
newark	newark
isidro	isidro
armour	oklop
fat	masti
fat	fat
fat	debela
fat	masnoća
fat	masnoće
andrey	andrey
corleone	corleone
mẹo	savjeta
mẹo	vrh
pegasus	pegaz
seymour	seymour
haw	haw
browne	browne
monogatari	monogatari
wilde	wilde
glycine	glicin
plato	platon
olympus	olympus
tashkent	taškent
hcl	hci
lex	lex
episodes	epizode
episodes	epizoda
muñoz	muñoz
herb	herb
ringo	ringo
burgundy	bordo
renault	renault
mew	mew
minami	minami
bleach	bleach
rousseau	rousseau
mecca	mekka
jongno	jongno
augsburg	augsburg
fide	fide
dickinson	dickinson
melanie	melanie
holloway	holloway
hume	hume
kar	kar
muse	muza
chamberlain	chamberlain
bruch	bruch
gala	gala
bye	baj
bye	bye
cằm	brada
pioneer	pioneer
pioneer	pionir
paula	paula
imdb	imdb
toulon	toulon
romano	romano
wizard	čarobnjak
wizard	čarobnjaka
zander	zander
selim	selim
yom	jom
damian	damian
haifa	haifa
bor	bor
cash	novac
lugo	lugo
teo	teo
villanueva	villanueva
twilight	sumrak
kenji	kenji
hispaniola	hispaniola
entropy	entropija
sardegna	sardegna
nur	nur
voltaire	voltaire
nhăn	bora
robson	robson
mask	maska
merton	merton
coa	coa
sinclair	sinclair
asparagus	šparoga
rojas	rojas
dahl	dahl
nhả	puštanje
nhả	oslobađanje
thùa	agave
heathrow	heathrow
jenkins	jenkins
minneapolis	minneapolis
pack	pakovanje
pack	pack
tbd	tbd
machado	machado
modena	modena
lions	lavovi
kitty	kiti
schneid	schneid
omer	omer
petersen	petersen
mona	mona
elsa	elsa
maritima	maritima
madeleine	madeleine
baba	baba
ost	ost
backstreet	backstreet
campagne	campagne
nagano	nagano
spielberg	spielberg
kana	kana
alagoas	alagoas
coventry	coventry
pbs	pbs
pau	pau
taub	taub
ararat	ararat
ito	itō
calvert	calvert
polymer	polimera
nolan	nolan
fitzgerald	fitzgerald
treviso	treviso
mama	mama
romeo	romeo
didier	didier
liguria	ligurija
joyce	joyce
wai	wai
meet	ispuniti
alexis	alexis
radiata	radiata
greenwich	greenwich
caserta	caserta
kinabalu	kinabalu
usaf	usaf
revue	revue
titus	tit
hayek	hayek
messenger	messenger
por	por
lagos	lagos
stream	potok
petra	petra
palmas	palmas
gatwick	gatwick
oldenburg	oldenburg
reims	reims
ensign	zastavnik
carlsen	karlsen
carlsen	carlsen
ericsson	ericsson
achilles	ahilej
achilles	achille
phalanx	falanga
gerard	gérard
gerard	gerrard
gerard	gerard
bergman	bergman
oran	oran
ortiz	ortiz
guiana	gvajana
nếm	okus
ski	ski
guetta	guetta
simoni	simoni
dhaka	dhaka
framework	framework
framework	okvir
seem	sem
amour	amour
amor	amor
theresia	theresia
zara	zara
richelieu	richelieu
snape	snape
cappadocia	kapadokija
swansea	swansea
guadalupe	guadalupe
mendoza	mendoza
judo	džudo
lampard	lampard
myung	myung
tunis	tunis
nigel	nigel
sue	tužiti
garfield	garfield
tula	tula
texte	texte
aff	aff
hermes	hermes
alicia	alicia
registry	registar
seinen	seinen
archipelago	arhipelag
gogh	gogh
iglesias	iglesias
nirvana	nirvana
wanted	tražen
wanted	želio
survivor	survivor
nháp	nacrtu
nháp	nacrt
lagrange	lagrange
roque	roque
chát	chat
lahore	lahore
melody	melodija
beretta	beretta
comte	comte
chambers	komora
chambers	komore
mari	mari
sikh	sikh
sikh	turban
humbert	humbert
ivy	ivy
northampton	northampton
penaltyscore	penaltyscore
shirley	shirley
michelangelo	michelangelo
nairobi	nairobi
cate	cate
lou	lu
lou	lou
advance	plasirao
boulogne	boulogne
pulitzer	pulitzerova
pocket	džepu
pocket	džepa
akbar	akbar
sandra	sandra
krasnoyarsk	krasnojarsk
buch	buch
elite	elita
interwiki	interwiki
angry	gnjevni
lisboa	lisabon
cotton	pamuk
stamford	stamford
faust	faust
shevchenko	ševčenko
klm	klm
oval	ovalna
marca	marca
mannheim	mannheim
mannheim	manheim
everest	everest
nationale	nationale
mpeg	mpeg
ida	ida
berber	berber
atm	atm
cantor	cantor
dover	dover
tarsus	tarsusa
suleiman	sulejmana
suleiman	sulejman
suleiman	sulejmanova
bohr	bohrov
bohr	bohr
lamb	janje
noir	noir
brezhnev	brežnjev
bray	bray
giỏ	džepu
giỏ	džepa
giỏ	korpe
sap	sap
lauren	lauren
lauren	loren
marta	marta
ars	ars
iana	iana
hana	hana
scipio	scipio
cascade	cascade
saunders	saunders
wyatt	wyatt
silveira	silveira
katherine	katherine
manitoba	manitoba
ausf	ausf
caryophyllaceae	caryophyllaceae
almeida	almeida
eliot	eliot
tea	čaj
stern	stern
chrudim	chrudim
marek	marek
breaking	breaking
alien	alien
alien	vanzemaljski
schindler	schindler
raja	raja
lydia	lydia
fun	fun
fun	zabava
jungle	džungla
hillary	hillary
wolfram	volfram
clermont	clermont
dalton	dalton
gottfried	gottfried
stephens	stephens
noctua	noctua
mangan	mangan
bluetooth	bluetooth
compton	compton
mgm	mgm
brock	brock
conway	conway
msn	msn
schuster	schuster
fleming	fleming
rodrigues	rodrigues
topo	topo
eumenes	eumen
snyder	snyder
glucose	glukoza
credit	kredit
carrie	carrie
classics	klasike
axel	axel
punic	punski
molotov	molotov
vieux	vieux
novosibirsk	novosibirsk
galápagos	galapagoska
frost	mraz
bratislava	bratislava
utrecht	utrecht
herschel	herschel
wiltshire	wiltshire
endangered	ugrožena
endangered	ugrozili
lausanne	lausanne
jacqueline	jacqueline
café	cafe
café	cafe
norris	norris
freiburg	freiburg
amadeus	amadeus
nikita	nikita
giacomo	giacomo
dudley	dudley
pleasant	ugodno
davy	davy
magdalena	magdalena
magdalena	magdalena
arras	arras
tot	tot
subfamilia	subfamilia
xxi	xxi
concept	pojam
archimedes	arhimed
neu	neu
casino	kazino
sami	sami
marilyn	marilyn
vincennes	vincennes
hyde	hyde
cabin	kabine
cabin	kolibe
simone	simone
ulysses	ulysses
gifu	gifu
rệp	baje
tanganyika	tanganjika
sacramento	sacramento
genji	genji
wallis	wallis
thatcher	thatcher
byron	byron
vandal	vandal
khz	khz
faber	faber
ying	ying
bromwich	bromwich
arthropoda	arthropoda
toni	toni
moravia	moravia
nal	nal
fermat	fermat
raoul	raoul
wiener	wiener
colt	colt
watt	vat
yoko	yoko
livingstone	livingstone
caracas	caracas
ned	neda
bomb	bomba
sarkozy	sarkozy
sarkozy	sarkozyja
jerzy	jerzy
koi	koi
durand	durand
pole	pol
judy	judy
neue	neue
astronomy	astronomija
crassus	crassus
pom	pom
mầu	boja
mầu	boji
poker	poker
shaun	shaun
higgins	higgins
tal	tal
tal	talj
aya	aya
nevis	nevisa
vẫy	mahali
germania	germanija
mcmahon	mcmahon
hartley	hartley
epstein	epstein
jobs	jobs
jobs	poslovi
safari	safari
bonnie	boni
som	som
gnome	gnome
gutenberg	gutenberg
terre	ter
novo	novo
doubleday	doubleday
vita	vita
nantes	nantes
stay	ostala
stay	ostati
stay	ostanu
stay	boravka
panthera	panthera
worms	crvi
kamov	kamov
stefano	stefano
enrico	enrico
mei	mei
nháy	flash
nháy	blink
église	église
calhoun	calhoun
alfredo	alfredo
castilla	kastilje
dayton	dejtonski
dayton	dayton
thun	thun
superman	superman
corbett	corbett
champ	šampion
saints	svetaca
saints	saints
pall	pall
aves	aves
perez	perez
jerome	jerome
clemens	clemens
gupta	gupta
nomen	nomen
trọc	bjeloglavi
als	als
neal	neal
sạc	optužba
sạc	naboj
sạc	optuživši
sạc	optužujući
imax	imax
fossil	fosili
bart	bart
suvarnabhumi	suvarnabhumi
commonwealth	commonwealth
bourne	bourne
esther	ester
cdp	cdp
laurence	laurence
callas	callas
dinamo	dinamo
lester	lestera
lester	lester
carson	carson
ichi	ichi
mitterrand	mitterrand
doug	dag
amanita	amanita
arroyo	arroyo
oss	os
alpine	alpskom
alpine	alpsko
henrik	henrik
geoffroy	geoffroy
sicily	sicilija
sicily	sicilijanski
cream	krem
cream	krema
grimm	grimm
antony	antonije
zack	zacka
reeves	reeves
finn	finn
laplace	laplace
zlín	zlin
ufo	nlo
ufo	nlo
sioux	sioux
mendes	mendes
cristiano	cristiano
aberdeen	aberdeen
sprague	sprague
platinum	platina
kladno	kladno
arad	arad
wikitable	wikitable
gfdl	gfdl
savoy	savoy
deportivo	deportivo
kleist	kleist
bio	bio
kuban	kuban
electra	elektra
nervosa	nervosa
trip	trip
trip	putovanje
minimus	minimus
morocco	maroko
trois	trois
camden	camden
tara	tara
shia	šiita
guthrie	guthrie
eclipse	pomračenje
tap	takmičar
penalty	penala
penalty	kazna
pinyin	pinyin
brandon	brandon
hoover	hoover
borgo	borgo
rodney	rodni
foo	foo
sida	aids
sutton	sutton
flynn	flynn
gwangju	gwangju
frontalis	frontalis
lover	ljubavnik
lover	ljubavnici
lover	lover
honshu	honshū
thera	tere
kirov	kirov
tor	tor
tor	tor
capo	capo
orient	orient
romanov	romanov
cos	cos
eaton	eaton
lakes	jezera
aspera	aspera
natalia	natalija
natalia	natalia
salazar	salazar
gmbh	gmbh
annapolis	annapolis
abrams	abrams
giles	giles
magister	magister
warwick	warwicka
watford	watford
whole	cijela
whole	čitava
aid	aid
râm	hladu
râm	hlad
milwaukee	milwaukee
edith	edit
edith	edith
luga	luga
indianapolis	indianapolis
noah	nuh
caucasus	kavkaz
gillespie	gillespie
lynx	lynx
app	app
app	aplikacija
app	aplikaciju
presley	presley
brook	brook
fulltext	fulltext
vhs	vhs
troll	trol
osiris	oziris
achillea	hajdučka
cassius	cassius
sora	sora
ethernet	ethernet
peso	peso
fontainebleau	fontainebleau
perugia	perugia
isonzo	isonzo
carvalho	carvalho
muon	žele
shock	šok
bend	yarra
artiodactyla	artiodactyla
tchaikovsky	čajkovski
fusion	fusion
xoang	sinus
fyodor	fjodor
kat	kat
vitex	vitex
coffee	kahva
task	zadatak
bak	bak
sulfat	sulfat
tobias	tobias
pla	pla
iroquois	iroquois
rivers	rijekama
flemish	flamanski
legion	legija
legion	legiji
legion	legije
ala	ala
cctld	cctld
itf	itf
isis	isis
trek	trek
hikari	hikari
shikoku	šikoku
cobra	cobra
cobra	kobra
mindoro	mindoro
unicef	unicef
lumia	lumia
kissinger	kissinger
dee	dee
rsa	rsa
hockey	hokej
xỉn	napije
bow	sedžde
bow	luk
sars	sars
nico	nico
fed	fed
antoinette	antoaneta
kuril	kurilska
pzl	pzl
jardin	jardin
ramsay	ramsay
nizhny	njižni
trevor	trevor
limburg	limburg
sherlock	sherlock
dolby	dolby
avatar	avatar
sinatra	sinatra
ivanov	ivanov
briggs	briggs
julio	julio
emile	emile
reader	reader
harald	harald
fortune	bogatstvo
domodedovo	domodedovo
doo	doo
faraday	faraday
faraday	faradaya
rand	rand
baird	baird
rubin	rubin
cana	cana
wiktionary	wiktionary
erebus	erebus
pteropus	pteropus
rowling	rowling
potosí	potosí
kiribati	kiribati
karlsruhe	karlsruhe
shb	shb
cowboy	kauboj
samantha	samantha
analog	analogni
kei	kei
takashi	takashi
shih	shih
kerry	kerry
muller	müller
muller	muller
ramón	ramon
horst	horst
chirac	chirac
pagan	paganskih
mendelssohn	mendelssohn
perseus	perzej
ria	ria
olivia	olivia
mem	mem
houghton	houghton
matsumoto	matsumoto
aruba	aruba
hawkins	hawkinsa
burt	burt
avignon	avignonu
communis	communis
monarch	monarh
sala	sala
olive	maslina
soares	soares
femme	femme
tuva	tuva
bowman	bowman
sqft	sqft
kitts	kristofora
magellan	magellanov
magellan	magellan
equus	equus
agnes	agnes
calgary	calgary
jena	jena
thessaloniki	solun
gol	gol
tetra	tetra
sumner	sumner
bock	bock
dalmatia	dalmacija
haydn	haydn
murad	murad
murad	murat
malik	malik
escape	bijeg
escape	pobjegne
salon	salon
salon	salonu
durban	durban
lama	lama
squamata	ljuskaši
campanulaceae	campanulaceae
mara	mara
ita	ita
mika	mika
lia	lia
hegel	hegel
maggie	maggie
bua	bua
jürgen	jürgen
siết	hug
siết	squeeze
visa	vize
visa	viza
francois	francois
francois	françois
button	dugme
duc	duc
köhler	köhler
alger	alge
gong	gong
pompey	pompej
gerd	gerd
qantas	qantas
pet	pet
pet	inteligencija
drum	bubanj
daewoo	daewoo
pygmaeus	pygmaeus
merino	merino
martini	martini
clarkson	clarkson
manfred	manfred
amman	amman
nazi	fašističke
nazi	nacističke
nazi	nacista
nazi	nacistička
nazi	nacistički
spartan	spartan
mohr	mohr
brazilian	brazilski
khabarovsk	habarovsk
creed	vjere
freiherr	freiherr
ceres	cerera
malfoy	malfoy
trail	trag
bosco	bosco
shore	obalu
shore	shore
shore	obala
lipid	lipid
prentice	prentice
zahn	zahn
billie	bili
chaos	haos
umbrella	krovna
umbrella	kišobranom
candida	candida
karaoke	karaoke
oskar	oskar
macon	macon
ebert	ebert
textcolor	textcolor
zidane	zidan
aziz	aziz
mairie	mairie
cramer	cramer
vargas	vargas
pomerania	pomerania
ping	ping
feat	feat
rostock	rostock
marin	marin
nazareth	nazaret
montbéliard	montbéliard
abs	abs
keller	keller
boyle	boyle
spot	tačka
cctv	cctv
rocca	rocca
martial	borilačkih
martial	borilačke
herodotus	herodot
schumann	schumann
geun	keun
geun	geun
vidal	vidal
jaya	jaya
melissa	melissa
tar	tar
casas	casas
roux	roux
braunschweig	braunschweig
riemann	riemann
tribune	tribune
aden	aden
erectus	erectus
uppsala	uppsala
juliet	julija
elias	elias
angus	angus
anfield	anfield
cas	cas
cas	cass
hamas	hamas
reinhard	reinhard
vfl	vfl
koblenz	koblenz
idf	idf
chevalier	chevalier
systematics	biosistematika
guillermo	guillermo
palmyra	atol
rutherford	rutherford
loc	loc
merriam	merriam
jansen	jansen
schubert	schubert
ensemble	ansambl
gorham	gorham
ishikawa	ishikawa
frozen	zamrznuti
bihor	bihor
poincaré	poincaré
huron	huron
cunningham	cunningham
dyer	dyer
shawn	shawn
vogue	vogue
josephine	josephine
ilyich	iljič
decatur	decatur
centenario	centenario
vitebsk	vitebska
atlantis	atlantida
dewey	dewey
westmoreland	westmoreland
capra	capra
barbuda	barbuda
akita	akita
zenit	zenit
margarita	margarita
soto	soto
dreamworks	dreamworks
charter	povelja
oliveira	oliveira
neustadt	neustadt
geoff	geoff
pamplona	pamplona
autobiography	autobiografija
bark	kora
mêtan	metan
mack	mack
guru	guru
sanders	sanders
aztec	asteci
cor	kor
nikolay	nikolay
bmp	bmp
murcia	murcia
fermi	fermi
mcgraw	mcgraw
falco	falco
pedersen	pedersen
lance	lens
lance	koplje
jatropha	jatropha
mohd	mohd
gettysburg	gettysburga
parlophone	parlophone
perspective	perspektive
dal	dal
amd	amd
whois	whois
buren	buren
vladivostok	vladivostok
vida	vida
giulia	krajina
nora	nora
blogger	bloger
blogger	blogs
stephanie	stephanie
bing	bing
kgb	kgb
chapel	kapela
marais	marais
maison	maison
commentary	commentary
spice	začin
pires	pires
radiohead	radiohead
acb	acb
reprint	reprint
severin	severin
khít	pakovanje
kreis	kreis
sink	cink
gee	gee
abbeville	abbeville
saskatchewan	saskatchewan
hippolyte	hippolyte
nubia	nubija
antioch	antioch
kaliningrad	kalinjingrad
rhodesia	rhodesia
bullock	bullock
bert	bert
westinghouse	westinghouse
harmony	harmoniju
harmony	harmonije
harmony	harmonija
diaz	diaz
vầng	zlatna
tostring	tostring
gui	gui
odyssey	odiseja
ngo	nvo
tethys	tetija
kuiper	kuiperov
malvaceae	malvaceae
kashima	kashima
progressive	progresivni
davidson	davidson
ndt	ndt
chernobyl	černobilu
murakami	murakami
hammond	hammond
hastings	hastings
patagonia	patagonija
larson	larson
olsen	olsen
fairfield	fairfield
fairchild	fairchild
champaign	champaign
superfamilia	superfamilia
consolidated	consolidated
boyer	boyer
găm	bodež
ava	ava
riyadh	rijad
booth	booth
cristina	cristina
demosthenes	demosten
plc	plc
gerrard	gerrard
rum	rum
acuta	acuta
argus	argus
vasco	vasco
leibniz	leibniz
futsal	futsal
paralympic	paraolimpijske
authorlink	authorlink
mahmoud	mahmud
mahmoud	mahmoud
anthology	antologija
pia	pia
amenhotep	amenhotep
steam	parni
steam	parna
phoenicia	fenicija
spa	banja
spa	spas
punta	punta
addis	adis
huntington	huntington
belowstyle	belowstyle
styles	stilova
pool	pol
pool	poi
boyd	boyd
tornado	tornado
vin	vin
dmt	dmt
montagne	montagne
keane	keane
chorus	hor
maluku	molučka
brahms	brahms
aphrodite	afrodita
lone	lone
lone	usamljeni
paso	pasu
dolly	dolly
paxton	paxton
char	char
kramer	kramer
rae	rae
genesis	geneza
frosinone	frosinone
nissan	nissan
namur	namur
mir	mir
agglomération	agglomération
gabrielle	gabrielle
dagestan	dagestan
