goose	ห่าน
septimius	septimius
breviceps	breviceps
lavender	ลาเวนเดอร์
khùng	บ้า
khùng	เพี้ยน
seenplatte	vorpommern
pergamon	pergamon
carrollton	carrollton
taking	การพา
ing	ing
rudis	rudis
nghiến	บด
nouvelles	nouvelles
huntingdon	huntingdon
lap	ตัก
retz	retz
vientiane	เวียงจันทน์
yayoi	yayoi
combo	คอมโบ
arctica	arctica
nak	นาก
slide	สไลด์
slide	เลื่อน
slide	สไลด์
kampot	kampot
undulatus	undulatus
elsevier	elsevier
agilis	agilis
butch	บุช
olbia	olbia
livre	livre
bild	bild
gatsby	gatsby
stauffenberg	stauffenberg
akane	akane
rafale	rafale
rockwell	ร็อคเวลล์
silvia	silvia
crivelli	crivelli
mak	หมาก
phễu	กรวย
slogan	สโลแกน
slogan	slogan
worm	หนอน
cincta	cincta
adv	adv
skype	ไกส์
skype	skype
vevo	vevo
laptop	แล็ปท็อป
phung	phung
atom	อะตอม
constricta	constricta
roe	roe
roe	โร
ems	เอ็ม
ems	ems
regalis	regalis
macao	มาเก๊า
macao	มาเก๊า
macao	macau
ins	อิน
brahma	พรหม
ruhr	ruhr
finger	นิ้ว
cfa	cfa
cavite	cavite
tübingen	tübingen
safavid	safavid
tiny	จิ๋ว
kurgan	kurgan
amphibia	amphibia
martina	martina
eintracht	eintracht
belowclass	belowclass
aeronautical	aeronautical
gareth	gareth
mikan	mikan
arp	arp
sil	sil
peres	peres
saud	saud
murat	murat
blanca	blanca
rec	rec
rec	สันทนาการ
warplanes	warplanes
illiger	illiger
hendrik	hendrik
grayi	grayi
steyr	steyr
théâtre	théâtre
dipodomys	จิงโจ้
sbd	sbd
tomoe	tomoe
enfield	enfield
samba	samba
dota	dota
fanclub	fanclub
truncatus	truncatus
senshi	senshi
nst	nst
taiwanensis	taiwanensis
excel	excel
plicata	plicata
mafic	mafic
vaccine	วัคซีน
miroku	miroku
mubarak	mubarak
pac	pac
mongolica	mongolica
combinedfleet	combinedfleet
cultivar	cultivar
afp	afp
lew	ลูว์
undef	undef
higurashi	higurashi
pier	ท่าเรือ
vologda	vologda
mannii	mannii
hamata	hamata
scorpions	แมงป่อง
cats	แมว
fractions	เศษส่วน
ubon	อุบล
dau	คางคก
girlfriend	แฟน
guerra	guerra
kadavoor	kadavoor
integra	integra
pumilio	pumilio
seitz	seitz
activision	activision
bru	บรู
bru	บรูก
clio	clio
rossini	rossini
kotoko	kotoko
mazama	mazama
caucasica	caucasica
blainville	blainville
wilsonii	wilsonii
dragonfly	แมลงปอ
mort	มอร์ท
crinita	crinita
générale	générale
atropurpurea	atropurpurea
ness	เนส
mound	เนิน
jude	จู๊ด
roh	roh
vulpes	vulpes
stick	ติด
neckar	neckar
cyrenaica	cyrenaica
terminalis	terminalis
conferta	conferta
ramsar	ramsar
audi	audi
tvn	tvn
nussbaum	nussbaum
curcuma	ขมิ้น
osteichthyes	osteichthyes
sumo	ซูโม่
pavilion	ศาลา
saba	สะ
fluminense	fluminense
finch	ฟินช์
finch	ฟินซ์
helicopter	เฮลิคอปเตอร์
athletics	กรีฑา
catedral	catedral
beech	บีช
lumière	lumière
salaam	ซาลาม
salaam	ซาลาม
exile	เนรเทศ
wheel	ล้อ
yusuke	yusuke
abyss	เหว
rüppell	rüppell
laurel	ลอเรล
mpa	mpa
magie	แมกนีเซียม
forbesii	forbesii
lachaise	lachaise
chō	chō
uni	uni
hina	hina
adriano	adriano
sac	sac
wordpress	wordpress
stadio	stadio
virgil	เฝอ
ostrava	ostrava
susa	susa
petro	petro
nen	nen
nen	พระจันทร์
nen	มูน
nen	เพ็ญ
spiral	เกลียว
mki	mki
heinemann	heinemann
osnabrück	osnabrück
bello	เบลโล
dich	dich
wrocław	wrocław
jerkins	jerkins
rafinesque	rafinesque
sig	sig
cites	cites
crenulata	crenulata
franken	franken
cnc	cnc
chiyoda	chiyoda
götaland	götaland
raynor	raynor
segunda	segunda
tời	ตอบ
kurita	kurita
doan	doan
ses	ses
bueng	บึง
haworth	haworth
phobos	phobos
dumoulin	dumoulin
alligator	จระเข้
cgi	cgi
poznań	poznań
leander	leander
pycnonotidae	pycnonotidae
hoyo	hoyo
unique	เอกลักษณ์
phylogenetics	phylogenetics
özil	özil
kaluga	kaluga
apis	api
okuni	okuni
notableworks	notableworks
samuelson	samuelson
sigismund	sigismund
vir	vir
nec	nec
schwarzschild	schwarzschild
nani	nani
tigrina	tigrina
amt	amt
mister	มิสเตอร์
oxide	ออกไซด์
yaroslavl	yaroslavl
františek	františek
billbergia	billbergia
azuma	azuma
skip	ข้าม
bud	บัด
bud	แย้ม
rosaceae	rosaceae
germanicus	germanicus
shiga	ชิง
longmans	longmans
newell	newell
nate	เนต
nate	เน็ต
nate	เน็ท
nate	เนท
haeckel	haeckel
grandiflorum	grandiflorum
outlook	outlook
instagram	instagram
crush	crush
crush	ปิ๊ง
crush	ขยี้
hirst	hirst
militaire	militaire
sushi	ซูชิ
pliocene	pliocene
insigne	insigne
cuculidae	cuculidae
alcala	alcala
zeit	zeit
yekaterinburg	yekaterinburg
mendeleev	mendeleev
zemlya	zemlya
odoacer	odoacer
rương	ทรวงอก
rương	โลง
rương	ลำต้น
rương	หีบ
đít	ก้น
đít	ตูด
đít	ก้น
đít	ตูด
blossom	blossom
agassiz	agassiz
études	études
battista	battista
kondo	kondo
marques	marques
peach	ท้อ
peach	พีช
catwalk	catwalk
andrzej	andrzej
gerry	gerry
pallidum	pallidum
vyacheslav	vyacheslav
victoriae	victoriae
gotland	gotland
arkham	อาร์คัม
prato	prato
goto	goto
gymnothorax	gymnothorax
lippe	lippe
dscn	dscn
ind	ind
susquehanna	susquehanna
gprs	gprs
geki	geki
leonhard	leonhard
katana	katana
trance	ภวังค์
dubium	dubium
république	république
yul	yul
burgenland	burgenland
joanna	joanna
nrt	nrt
cours	cours
armani	armani
subheader	subheader
muay	muay
muay	มวย
salad	สลัด
alley	ซอย
alley	ตรอก
orkney	orkney
zvezda	zvezda
dunst	dunst
naja	งูเห่า
yankee	กระชาก
nệm	ที่นอน
nệm	ที่นอน
aru	aru
sco	sco
ota	ota
kashgar	kashgar
dầy	หนา
dầy	หนาๆ
ntfs	ntfs
evol	evol
mango	mango
mango	มะม่วง
tres	tres
imo	imo
orinoco	orinoco
vulgare	vulgare
pardo	pardo
lyle	lyle
lyle	ไลล์
lyle	ไลน์
eco	eco
snooker	สนุกเกอร์
tadeusz	tadeusz
libertadores	libertadores
sasa	sasa
neto	neto
phum	ภูมิ
longicollis	longicollis
bentham	bentham
aek	aek
pattani	ปัตตานี
henriette	henriette
fahrenheit	ฟาเรนไฮต์
polaris	polaris
punch	หมัด
punch	ชก
punch	ต่อย
arkive	arkive
adidas	adidas
grigory	grigory
ces	ces
phon	โพน
krebs	krebs
tachi	tachi
gbu	gbu
raytheon	raytheon
sheldon	sheldon
alia	ฉายา
papuensis	papuensis
tutsi	tutsi
lopes	lopes
curry	กะหรี่
curry	แกง
curry	curry
masashi	kishimoto
muslim	มุสลิม
pigeon	พิราบ
dara	ดารา
riff	riff
playboy	เพลย์บอย
nes	nes
mineiro	mineiro
adj	adj
protium	protium
mapsize	mapsize
shrewsbury	shrewsbury
nevsky	nevsky
sakon	สกล
palgrave	palgrave
ssn	ssn
scala	scala
ghim	pin
clone	โคลนนิ่ง
clone	โคลน
regis	regis
lenz	lenz
sartre	sartre
suetonius	suetonius
pda	pda
pda	pda
involucrata	involucrata
maung	หม่อง
ryazan	ryazan
punctatum	punctatum
mbps	mbps
paracetamol	paracetamol
btc	btc
familycolor	familycolor
reg	reg
lơn	ถูก
graphic	กราฟิก
wisdom	ปัญญา
wisdom	ภูมิปัญญา
choisy	choisy
biographie	biographie
kingii	kingii
cucumis	cucumis
thesis	thesis
thesis	วิทยานิพนธ์
taeyeon	taeyeon
västra	västra
rochefort	rochefort
ill	ป่วย
galilee	galilee
hatta	hatta
fuzzy	ฝอย
smrt	smrt
occidentale	occidentale
beatrix	beatrix
cruzeiro	cruzeiro
dag	dag
vasa	vasa
tatyana	tatyana
bastia	bastia
mani	มณี
ili	ili
orbicularis	orbicularis
finney	finney
ean	ean
celebrity	ดัง
dani	เดนี
gibbosa	gibbosa
dharma	ธรรมะ
sortable	sortable
widow	แม่หม้าย
widow	หม้าย
toshiba	ยักษ์
aoshi	aoshi
fluviatilis	fluviatilis
socket	เบ้าตา
pura	pura
lublin	lublin
immortal	อมตะ
ghats	ghats
quầng	รัศมี
ott	ott
upc	upc
trombone	ทรอมโบน
traub	traub
leonidas	leonidas
ngách	มุม
ogasawara	ogasawara
dock	อู่
dock	ท่าเรือ
uav	uav
kemerovo	kemerovo
deccan	deccan
mertens	mertens
basiliscus	basiliscus
umbria	umbria
bầm	ช้ำ
bầm	ช้ำ
palacio	palacio
doe	โด
doe	ใสๆ
charoen	เจริญ
husky	สดชื่น
forrestii	forrestii
bordj	bordj
collar	ปลอกคอ
fushimi	fushimi
paradoxus	paradoxus
caesarea	caesarea
dunam	dunam
nicolaus	nicolaus
sulphurea	sulphurea
thunberg	thunberg
stardust	stardust
kurstin	kurstin
cabral	cabral
noël	noël
afr	afr
exe	exe
cmos	cmos
garage	อู่
garage	โรงรถ
dijkstra	dijkstra
mur	mur
hsdpa	hsdpa
mri	mri
mri	mri
genetics	พันธุกรรม
genetics	กรรมพันธุ์
polylepis	polylepis
wittgenstein	wittgenstein
mehmet	mehmet
fuck	พัดลม
fuck	fan
fuck	แฟนๆ
fuck	แฟน
dove	พิราบ
licensor	licensor
bouvier	bouvier
gorge	หุบเขา
boucher	boucher
harpercollins	harpercollins
arbre	arbre
puente	puente
pamir	pamir
łódź	łódź
swat	สวาท
swat	swat
clube	clube
mayr	mayr
uma	uma
vga	vga
oxygen	ออกซิเจน
gwen	กวน
ics	ics
luo	หลัว
camino	camino
monk	บวช
lapland	lapland
fai	fai
basestyle	basestyle
cmc	cmc
dev	dev
uwe	uwe
thúng	ทุ่ง
pledis	pledis
methane	มีเทน
shao	จาว
fuscescens	fuscescens
aurelianus	aurelian
bsc	bsc
erlangen	erlangen
collagen	collagen
bataille	bataille
xperia	xperia
nectariniidae	nectariniidae
teres	teres
bcl	bcl
saarbrücken	saarbrücken
dlc	dlc
flamengo	flamengo
stricto	stricto
peel	เปลือก
peel	ปลอก
birthname	birthname
guerin	guerin
heng	เฮง
shuri	shuri
eros	eros
salomon	โซโลมอน
vojvodina	vojvodina
systema	systema
lanceolatus	lanceolatus
mundo	mundo
helmholtz	helmholtz
kềm	ถัง
kềm	คีม
taro	เผือก
dalziel	dalziel
georgian	จอร์เจีย
stansted	stansted
prés	prés
nieuport	nieuport
yami	yami
sapindaceae	sapindaceae
hamer	hamer
aso	aso
ribeiro	ribeiro
fairytale	เทพนิยาย
epa	epa
horta	horta
deutsches	deutsches
petrus	petrus
massage	นวด
massage	นวด
hof	hof
jepson	jepson
nfpa	nfpa
finet	finet
vendôme	vendôme
xẻng	พลั่ว
xẻng	พลั่ว
camel	อูฐ
baha	baha
oyama	oyama
getargs	getargs
shim	ชิม
jackman	jackman
pflanzen	pflanzen
kimberley	kimberley
enwiki	enwiki
cũi	บังเกอร์
cũi	เปล
umgebung	umgebung
setter	setter
colonia	colonia
annulatus	annulatus
belleville	belleville
pliny	pliny
aust	aust
merzifon	merzifon
nikon	nikon
izmit	izmit
percussion	percussion
carrera	carrera
koei	koei
sturnidae	sturnidae
ajaccio	ajaccio
prada	prada
centrale	centrale
klotz	klotz
addclass	addclass
tokyopop	tokyopop
serre	serre
knesset	knesset
kut	กุด
carleton	carleton
hildesheim	hildesheim
sith	ซิธ
sena	sena
bellona	bellona
tron	ตรอน
nebulosus	nebulosus
romaji	romaji
schmidti	schmidti
ymca	ymca
gangster	มาเฟีย
gangster	นักเลง
dap	dap
gaeta	gaeta
aes	aes
magnificus	magnificus
bed	นอน
bed	ที่นอน
bed	เตียง
waffen	waffen
sakharov	sakharov
oviedo	oviedo
vasil	vasil
piperaceae	piperaceae
pieris	pieris
deutschlands	deutschlands
daniela	daniela
barak	barak
roa	roa
orbis	orbis
tunku	tunku
oratorio	oratorio
utd	utd
degeneres	degeneres
nyu	nyu
inhg	inhg
seventeen	seventeen
soissons	soissons
nhác	เลอะเทอะ
nhác	ยุ่งเหยิง
stemma	stemma
tủi	นาก
saki	ซากิ
mbs	mbs
jacksoni	jacksoni
guise	guise
musique	musique
berlioz	berlioz
bauxite	bauxite
salmo	salmo
ushio	ushio
fedde	fedde
kaeng	แก่ง
moa	moa
dlr	dlr
kari	kari
foods	อาหาร
foods	ฟู้ด
calderon	calderon
precious	ล้ำค่า
stanislav	stanislav
iapetus	iapetus
boomerang	boomerang
okrug	okrug
oaks	โอ๊ต
oaks	โอ๊ค
dreamcast	dreamcast
sqmi	sqmi
kidman	kidman
plessis	plessis
nipponica	nipponica
milo	milo
milo	ไมโล
rip	ฉีก
rip	rip
metan	มีเทน
psy	psy
sourcebook	sourcebook
carling	carling
psg	psg
ostrobothnia	ostrobothnia
erj	erj
schmid	schmid
sourceforge	sourceforge
cfm	cfm
jing	จิง
bounty	ค่าหัว
paludosa	paludosa
boryspil	boryspil
pepe	เปเป
tenggara	tenggara
montparnasse	montparnasse
pcr	pcr
regularis	regularis
yoshimoto	yoshimoto
pune	pune
bey	bey
vasey	vasey
kleine	kleine
bhumibol	ภูมิพล
praeger	praeger
lom	หล่ม
lom	lom
chick	เจี๊ยบ
chick	ลูกไก่
grampus	grampus
copyleft	copyleft
cheonan	cheonan
kishida	fumio
fedor	fedor
srpska	srpska
quoy	quoy
nvidia	nvidia
lacépède	lacépède
lettres	lettres
oligocene	oligocene
göteborg	gothenburg
virginiana	virginiana
borg	borg
rene	เรเน่
calo	แคลอรี่
calo	แคลอรี่
urtica	urtica
buriram	บุรีรัมย์
simferopol	simferopol
sven	sven
corylus	corylus
convolvulus	convolvulus
raj	ราจ
morphine	มอร์ฟีน
pascual	pascual
krabi	กระบี่
thorn	หนาม
kyaw	kyaw
okamoto	okamoto
ngáy	กรน
ngáy	รน
geograph	geograph
alb	alb
versace	versace
sancti	sancti
wes	เวสส
wes	เวส
magyar	magyar
pharrell	pharrell
cookie	คุกกี้
cookie	คุกกี้
arista	arista
teil	teil
reine	reine
router	เตอร์
gnis	gnis
depressus	depressus
londres	londres
snapdragon	snapdragon
erhard	erhard
atmosphere	บรรยากาศ
ctx	ctx
mustela	mustela
popper	popper
brownii	brownii
leonardi	leonardi
pravda	pravda
alden	alden
ecm	ecm
bện	cups
bện	ถ้วย
flammarion	flammarion
beau	บัว
beau	beau
aps	aps
dancer	dancer
ferenc	ferenc
etihad	etihad
traoré	traoré
coban	โคบอลต์
siracusa	siracusa
bịch	สาระ
sabbath	บาธ
nrhp	nrhp
medaltemplates	medaltemplates
oops	อุ๊บ
oops	อุ๊ย
oops	อ๊ะ
gaimard	gaimard
cytokine	cytokine
urgell	urgell
pumilus	pumilus
kaup	kaup
iwate	iwate
ronaldinho	ronaldinho
bound	ผูกพัน
stara	stara
ari	อารีย์
ari	อารี
normale	normale
aeg	aeg
metropolis	เมโทรโปลิส
metropolis	มหานคร
std	std
paramore	paramore
karol	karol
virgen	virgen
mev	mev
merian	merian
zeitschrift	zeitschrift
gata	gata
luise	luise
esper	esper
opolskie	opolskie
laidlaw	laidlaw
situ	situ
angiosperm	angiosperm
totalcaps	totalcaps
orchard	สวน
meryl	meryl
mosaic	โมเสก
ear	หู
eines	eines
lounge	lounge
aniplex	aniplex
bioware	bioware
iec	iec
cima	cima
sepc	sepc
soekarno	soekarno
polytechnique	polytechnique
lycodon	lycodon
eriksson	eriksson
syrian	ซีเรีย
utf	utf
gút	เงื่อน
gút	ปม
yesno	yesno
unep	unep
jelly	jelly
pio	pio
kinki	kinki
bachelor	bachelor
sharma	sharma
toshio	toshio
totalgoals	totalgoals
palmeiras	palmeiras
transcript	transcript
trudeau	trudeau
viridescens	viridescens
cmyk	cmyk
impressa	impressa
yamaha	yamaha
fuerteventura	fuerteventura
puzzle	ปริศนา
inferiore	inferiore
acm	acm
staffordshire	staffordshire
evergreen	evergreen
cpi	cpi
kegg	kegg
edicions	edicions
podium	แท่น
westport	westport
hakusho	hakusho
kaiserin	kaiserin
austral	austral
oryx	oryx
ploceidae	ploceidae
modulo	modulo
titsingh	titsingh
jerez	jerez
vcd	vcd
ngầu	sassy
ngầu	เท่ห์
ngầu	เท่
ngầu	เจ๋ง
ngầu	เย็น
murinus	murinus
joaquín	joaquín
martí	martí
pmc	pmc
caspase	caspase
photoshop	photoshop
ghosts	ผี
mmorpg	mmorpg
mền	ผ้าห่ม
ochotona	pika
brassica	brassica
quimper	quimper
pog	pog
gaspard	gaspard
samtgemeinde	samtgemeinde
kozlov	kozlov
siècle	siècle
pauling	pauling
npc	npc
mcleod	mcleod
šiauliai	šiauliai
filmworks	filmworks
amr	amr
ivory	งาช้าง
partido	partido
lancer	lancer
henrique	henrique
ngam	งาม
naturae	naturae
wagneri	wagneri
cano	cano
algarve	algarve
inaba	inaba
shelter	ที่พัก
temp	ชั่วคราว
schiner	schiner
pahang	pahang
gook	กุ๊ก
stuff	สิ่งของ
maritimus	maritimus
abbaye	abbaye
grow	เติบโต
grow	ปลูก
paola	paola
ordre	ordre
asiaticus	asiaticus
chulalongkorn	จุฬาลงกรณ์
msg	msg
rozen	rozen
semaphore	semaphore
cathy	แคธี
yura	yura
duero	duero
voip	voip
cooh	cooh
soda	โค้ก
soda	โคเคน
soda	โซดา
ode	ode
nhoi	ทุกข์
nhoi	นาถ
eutheria	eutheria
afin	affine
bartolomé	bartolomé
charpentier	charpentier
iranica	iranica
tabasco	tabasco
csa	csa
apa	apa
aer	aer
liz	ลิส
liz	ลิซ
acc	acc
irn	irn
hok	hok
cốp	ลำต้น
cốp	หีบ
akon	akon
offenbach	offenbach
hussain	hussain
campeche	campeche
nxt	nxt
milleri	milleri
asahina	asahina
acipenser	acipenser
streak	วงๆ
fraseri	fraseri
christgau	christgau
lga	lga
mihai	mihai
lollipop	อมยิ้ม
minho	minho
blunt	ทื่อๆ
winslet	winslet
thylakoid	thylakoid
xtreme	xtreme
spell	สะกด
spell	คาถา
ict	ict
manor	คฤหาสน์
tambo	tambo
microdon	microdon
kabila	kabila
nagy	nagy
trườn	คลาน
niki	นิกิ
walpole	walpole
hollande	hollande
nuova	nuova
iaea	iaea
campanulata	campanulata
velox	velox
prospero	prospero
reiner	reiner
rosetta	rosetta
rear	หลัง
independiente	independiente
ether	ether
scripta	scripta
tana	tana
bate	bate
forsteri	forsteri
aethiopicus	aethiopicus
iva	iva
étude	étude
pad	ผัด
pad	pad
jewel	พลอย
mls	mls
kwk	kwk
meg	เมก
varennes	varennes
coerulea	coerulea
mura	mura
gamal	gamal
fancy	หรู
fancy	แฟนซี
cult	ลัทธิ
boise	บอยซี
ataxia	ataxia
mcfarland	mcfarland
brigitte	brigitte
tambov	tambov
tèo	หลังคา
tèo	ดาดฟ้า
kpop	kpop
getparent	getparent
caribê	แคริบเบียน
kostroma	kostroma
scotti	scotti
layout	แผนผัง
layout	layout
peregrina	peregrina
arabidopsis	arabidopsis
tripartita	tripartita
philippensis	philippensis
banshee	banshee
carpi	carpi
wmf	wmf
étoile	étoile
bartolomeo	bartolomeo
rhs	rhs
agata	agata
mulhouse	mulhouse
nocat	nocat
wikibooks	wikibooks
nist	nist
nyc	nyc
niu	niu
imaging	ภาพถ่าย
adu	adu
adolph	adolph
taxa	taxa
rowe	rowe
krieg	krieg
celta	celta
coerulescens	coerulescens
chemin	chemin
modul	โมดูล
gorizia	gorizia
cinctus	cinctus
chấy	ขยะ
faw	faw
allgemeine	allgemeine
pardalis	pardalis
foto	รูป
foto	ภาพถ่าย
foto	รูปภาพ
foto	foto
oreochromis	oreochromis
fleury	fleury
penza	penza
kage	kage
herat	herat
lez	lez
dua	พิราบ
insider	วงใน
mhc	mhc
pyroxen	olivine
champasak	champasak
pur	pur
medley	เมดเลย์
cyworld	cyworld
hansa	hansa
summers	ซัมเมอร์
cupid	กามเทพ
cms	cms
beaulieu	beaulieu
gazetteer	gazetteer
ornithischia	ornithischia
colombe	colombe
nuovo	nuovo
guitars	กีตาร์
thalia	thalia
exit	ทางออก
pokemon	pokemon
mst	mst
kwh	kwh
sauropsida	sauropsida
blason	blason
edmunds	edmunds
fab	fab
kal	คา
ansi	ansi
concat	concat
laye	laye
nhép	หัวใจ
reichstag	reichstag
rutheni	ruthenium
antoninus	antoninus
informix	informix
bantam	bantam
dish	จาน
khanty	khanty
werke	werke
lindley	lindley
pst	pst
africanum	africanum
dissertation	วิทยานิพนธ์
knoxville	knoxville
lết	steam
cùn	ทื่อๆ
isnotempty	isnotempty
salah	salah
zabaykalsky	zabaykalsky
yuu	yuu
skyteam	skyteam
chattanooga	chattanooga
guarulhos	guarulhos
calypso	calypso
lindberg	lindberg
wrap	ห่อ
pai	ปาย
garman	garman
serratus	serratus
ahli	ahli
ezio	ezio
boyfriend	แฟน
flor	flor
atk	atk
colon	ลำไส้
benedetto	benedetto
mazda	mazda
rtecs	rtecs
sctv	sctv
tannenberg	tannenberg
hawai	ฮาวาย
audax	audax
svenska	svenska
tetsuya	tetsuya
bully	รังแก
chestnut	เกาลัด
sais	sais
calcium	แคลเซียม
qajar	qajar
kst	kst
shropshire	shropshire
furukawa	furukawa
valeria	valeria
legendre	legendre
uca	uca
akm	akm
blitz	blitz
glantz	glantz
xyz	xyz
nei	nei
kronprinz	kronprinz
cale	cale
cale	เซล
whitei	whitei
goat	แพะ
crocodylus	crocodylus
rancho	rancho
tempora	tempora
sauvage	sauvage
chili	พริก
nahuatl	nahuatl
asuna	asuna
avi	avi
deb	เด็บ
microsd	microsd
jimi	jimi
ligo	ligo
rothschildi	rothschildi
gallica	gallica
oppositifolia	oppositifolia
jassim	jassim
reginae	reginae
coccothrinax	coccothrinax
microphone	ไมโครโฟน
cee	cee
luv	รัก
hla	hla
purpureus	purpureus
kazoku	kazoku
staples	staples
adp	adp
bard	กวี
mvp	mvp
tegel	tegel
usagi	usagi
ruslan	ruslan
whiskey	วิสกี้
whiskey	วิสกี้
rayleigh	rayleigh
yoshiaki	yoshiaki
zedd	zedd
lsp	lsp
seton	seton
primer	primer
acres	เอเคอร์
mrt	mrt
scrophulariaceae	scrophulariaceae
phat	ผัด
niloticus	niloticus
uhf	uhf
stejneger	stejneger
yaiba	yaiba
csstext	csstext
virut	ไวรัส
virut	ไวรัส
piacenza	piacenza
eno	eno
hem	hem
continuum	continuum
saurischia	saurischia
quotes	คำคม
honneur	honneur
jess	เจส
manley	manley
neck	คอร์
neck	คอ
neck	คอง
neck	ต้นคอ
maldonado	maldonado
nylon	nylon
nylon	ไนลอน
raiders	raiders
margrethe	margrethe
moc	moc
elaphus	elaphus
józef	józef
burj	burj
wah	ว้า
wah	วา
daum	daum
fsb	fsb
jeu	jeu
earle	earle
balls	ลูกบอล
eigenmann	eigenmann
gma	gma
peltata	peltata
priscus	priscus
transnistria	transnistria
vals	vals
armee	armee
kaguya	kaguya
nami	nami
michiru	michiru
piaggio	piaggio
moments	moments
italie	italie
iia	iia
mob	มาเฟีย
dafif	dafif
testudo	testudo
bubble	ฟอง
estado	estado
vitesse	vitesse
inferior	ด้อย
sip	จิบ
jenner	jenner
gamespy	gamespy
helicopters	เฮลิคอปเตอร์
bahram	bahram
jeune	jeune
jolly	jolly
jolly	ร่าเริง
jolly	รื่นเริง
symphonic	symphonic
gamerankings	gamerankings
yongin	yongin
taisen	taisen
maptitle	maptitle
labelstyle	labelstyle
saen	แสน
manu	มานู
manu	manu
giri	giri
ops	ops
ipo	ipo
carolus	carolus
chumphon	ชุมพร
lozano	lozano
vauban	vauban
alfa	อัลฟา
alfa	แอลฟ่า
alfa	อัลฟ่า
alfa	แอลฟา
wishart	wishart
proteus	proteus
desmarest	desmarest
britten	britten
alleni	alleni
tartu	tartu
haupt	haupt
knockout	น็อค
fank	fank
zoro	zoro
hyogo	hyogo
albomarginata	albomarginata
tee	tee
vickery	vickery
willi	willi
tft	tft
sisaket	ศรีสะเกษ
pino	pino
xian	เซียน
blum	blum
wikiproject	wikiproject
editpage	editpage
hinoue	itaru
uniform	ยูนิฟอร์ม
lampang	ลำปาง
titlebackground	titlebackground
umno	umno
sheamus	sheamus
geneon	geneon
deir	deir
ramanujan	ramanujan
helene	hélène
bamboo	bamboo
bamboo	ไผ่
bamboo	ไม้ไผ่
acp	acp
crest	crest
osce	osce
corte	corte
yoshihiro	yoshihiro
rên	คร่ำครวญ
vélez	vélez
schulze	schulze
fes	fes
jawaharlal	jawaharlal
swe	ส่วย
showbiz	บันเทิง
nazo	nazo
memento	อนุสรณ์
linnean	linnean
finale	finale
gauthier	gauthier
etude	etude
spur	กระตุ้น
flip	เลี้ยว
flip	หัน
flip	พลิก
flip	เปิด
afanasieff	afanasieff
souk	ศุข
weberi	weberi
arata	arata
ams	ams
zane	เซน
piotr	piotr
nok	nok
coligny	coligny
phơ	แคระ
ganga	ganga
hotcat	hotcat
benedictus	benedictus
sdk	sdk
imagawa	imagawa
scribner	scribner
surfactant	surfactant
đảnh	ปราบ
đảnh	ปราชัย
rhino	แรด
wilsoni	wilsoni
nationalism	ชาตินิยม
riot	จลาจล
pringle	pringle
liquid	ของเหลว
liquid	เหลว
gigi	gigi
trident	สามง่าม
guys	พวก
baht	บาท
dictionnaire	dictionnaire
novaehollandiae	novaehollandiae
brasilia	brasilia
olav	olav
barat	barat
mezzo	mezzo
vers	vers
psycho	จิต
psycho	โรคจิต
moonlight	แสงจันทร์
khaled	khaled
orta	orta
titleforeground	titleforeground
galton	galton
pinguis	pinguis
agustin	agustin
rucker	rucker
boulengeri	boulengeri
cdu	cdu
sumitomo	sumitomo
ríos	ríos
kiki	kiki
kiki	คิกิ
kiki	กิกิ
agrippa	agrippa
mtdna	mtdna
zach	แซบ
zach	แซ
zach	แซก
zach	แซค
clipper	clipper
harp	ฮาร์ป
harp	พิณ
sisowath	sisowath
himiko	himiko
sieboldii	sieboldii
thoreau	thoreau
adc	adc
sheets	ผ้าปูที่นอน
inflorescence	inflorescence
gaiden	gaiden
carotenoid	carotenoid
notatus	notatus
kojiki	kojiki
kirchner	kirchner
phetchabun	เพชรบูรณ์
fernand	fernand
masato	masato
kuni	kuni
nazionale	nazionale
kenway	kenway
ampère	ampère
holthuis	holthuis
persicus	persicus
wimax	wimax
akademie	akademie
fimbriatus	fimbriatus
melanoleuca	melanoleuca
tenue	tenue
trifoliata	trifoliata
btv	btv
coke	โค้ก
coke	โคเคน
kola	kola
oku	oku
cbn	cbn
boon	บุญ
excelsior	excelsior
jaroslav	jaroslav
cứt	อึ
woodstock	woodstock
sens	sens
oiseaux	oiseaux
orbigny	orbigny
amen	สาธุ
amen	อาเมน
amen	เมน
vittoria	vitoria
gail	เกิล
gail	เกล
tms	tms
koo	กู
bunny	กระต่าย
bunny	บัน
magny	magny
ulyanovsk	ulyanovsk
pws	pws
panasonic	panasonic
boulton	boulton
premiere	ปฐมทัศน์
piaf	piaf
amp	amp
amp	แอมป์
galloway	กัลโลเวย์
phrygia	phrygia
wiegmann	wiegmann
jinnah	jinnah
dhl	dhl
naver	naver
wikiquote	wikiquote
rib	ซี่โครง
mises	mises
neodymi	neodymium
jeonju	jeonju
popmatters	popmatters
doña	doña
blumenthal	blumenthal
salicaceae	salicaceae
weird	แปลกๆ
weird	แปลก
mentor	mentor
giraud	giraud
rua	rua
rambouillet	rambouillet
compagnie	compagnie
bodystyle	bodystyle
seminole	seminole
smtown	smtown
îles	îles
yam	แยม
yam	เทศน์
yam	มันเทศ
yam	เทศ
shuffle	สุ่ม
rainforest	ป่าดิบ
ciconia	ciconia
plantagenet	plantagenet
taoiseach	taoiseach
ardea	ardea
lanchester	lanchester
racer	racer
medius	medius
butt	ก้น
butt	ตูด
subst	subst
hoffenheim	hoffenheim
yatsura	yatsura
kub	kub
kub	คับ
vicepresident	vicepresident
armas	armas
cochin	cochin
grub	ของกิน
grub	เสบียง
fpga	fpga
shinobu	shinobu
jara	jara
lime	ปูน
lime	มะนาว
poulsen	poulsen
dekker	dekker
einecs	einecs
tsi	tsi
shimonoseki	shimonoseki
eudicots	eudicots
suppl	suppl
orthographic	orthographic
sinbad	sinbad
bam	แบม
bam	bam
powerpoint	powerpoint
golgi	golgi
cheongju	cheongju
nanum	nanum
arxiv	arxiv
gerlach	gerlach
amc	amc
jours	jours
npt	npt
aguascalientes	aguascalientes
nanda	nanda
aura	aura
babyface	babyface
avianca	avianca
joannes	joannes
nikolaevich	nikolaevich
spear	หอน
spear	หอก
pripyat	pripyat
lula	lula
caeruleus	caeruleus
república	república
cfc	cfc
andamanensis	andamanensis
passau	passau
bara	bara
upu	upu
syr	syr
tampere	tampere
bim	bim
mantle	อาภรณ์
nagant	nagant
coup	รัฐประหาร
caterina	caterina
duncker	duncker
serpens	serpens
env	env
otago	otago
nowak	nowak
mcmillan	mcmillan
intl	intl
pentax	pentax
raab	raab
kfc	kfc
yitzhak	yitzhak
ponta	ponta
mordovia	mordovia
occulta	occulta
hervé	hervé
balochistan	balochistan
