plains	平原
nusa	nusa
lotte	樂天
civic	公民
basil	basil
inger	inger
marxist	馬克思主義
curran	curran
oleg	oleg
maori	毛利
maori	荒原
albifrons	albifrons
fips	fips
maki	maki
shuttle	太空梭
shuttle	穿梭
serge	serge
stdinchikey	stdinchikey
xịt	帽
xịt	帽子
roc	roc
bunker	碉堡
bunker	地堡
bunker	掩體
froese	froese
selen	硒
còng	手銬
còng	銬
còng	袖口
còng	手銬
cliff	懸崖
cliff	崖
eagles	老鷹
eagles	鷹
cullen	庫倫
dfb	dfb
duỗi	延伸
duỗi	拉伸
duỗi	伸展
rhinolophus	rhinolophus
accipiter	accipiter
beer	啤酒
federico	federico
winehouse	winehouse
boss	boss
boss	老大
boss	老闆
casno	casno
indi	銦
groove	槽
tráo	安裝
xắt	切片
guido	guido
philips	philips
philips	飛利浦
avg	平均
savo	savo
bangs	劉海
bir	bir
timbaland	timbaland
gateway	門戶
steph	steph
anastasia	anastasia
đỉa	水蛭
đỉa	水蛭
anatomy	解剖
anatomy	解剖學
siam	暹羅
willard	willard
tomb	墳墓
tomb	墓
tomb	墓穴
andromeda	仙女座
fritsch	fritsch
allah	真主
allah	阿拉
megumi	惠
shine	閃耀
shine	發光
macro	宏觀
gel	膠
hbo	hbo
caterpillar	毛蟲
dietrich	dietrich
zola	zola
grayson	grayson
crc	crc
alphonse	alphonse
crop	莊稼
crop	農作物
crop	作物
nme	nme
myth	神話
elder	前輩
elder	長輩
elder	長老
vittorio	vittorio
frameless	frameless
sands	金沙
sands	金砂
sands	sands
observer	觀察員
rei	憐
rei	rei
atv	atv
dolls	娃娃
dolls	洋娃娃
dolls	玩偶
augustin	augustin
ncbi	ncbi
directx	directx
marks	標記
kennel	狗窩
claudio	claudio
burm	burm
tenor	男高音
naomi	naomi
laxa	laxa
shakhtar	shakhtar
pei	裴
callisto	callisto
marty	marty
anatoly	anatoly
amino	氨基
amino	氨基酸
scilla	scilla
daejeon	大田
protoss	protoss
sởi	麻疹
emery	emery
howden	howden
torch	火把
torch	火炬
manteuffel	manteuffel
fernandes	fernandes
panda	熊貓
trachea	氣管
tribal	部落
parque	parque
frederic	frederic
khalifa	khalifa
asteroids	小行星
coco	可可
sếp	sir
sếp	先生
sếp	首席
sếp	科長
sếp	boss
sếp	老大
sếp	老闆
giầy	皮鞋
giầy	鞋
giầy	鞋子
ntv	ntv
matthews	matthews
channing	channing
stephan	stephan
beccarii	beccarii
mimi	咪咪
mor	mor
plastic	塑料
plastic	塑膠
lies	謊言
sango	sango
apink	apink
blackberry	黑莓
blackberry	blackberry
travis	travis
halogen	鹵
halogen	鹵素
glacier	冰川
ecw	ecw
rúp	盧布
botanischer	botanischer
wise	明智
wise	英明
trochilidae	trochilidae
burger	漢堡
lise	lise
steindachner	steindachner
dustin	dustin
schaeffer	schaeffer
deck	甲板
arctostaphylos	arctostaphylos
serial	串列
beth	beth
fagus	fagus
mos	mos
nia	nia
burmeister	burmeister
prelude	前奏曲
prelude	前奏
prelude	序幕
falling	墜落
rayment	rayment
unity	統一
unity	團結
rodrigo	rodrigo
artemis	artemis
nhòm	望遠鏡
abbott	abbott
bra	巴西
ibiza	ibiza
elf	精靈
aberrans	aberrans
pendula	pendula
rupee	盧比
rupee	盧比
enzo	enzo
armand	armand
middleton	middleton
bale	bale
shen	沈
pci	pci
nebulosa	nebulosa
poore	poore
frankie	frankie
salisb	salisb
enter	輸入
bride	新娘
nikki	nikki
mutcd	mutcd
survival	存活
survival	求生
survival	生存
mio	mio
mio	美央
reptilia	reptilia
sept	九月
bernardino	bernardino
berks	berks
harmonica	口琴
emb	emb
peck	peck
trend	趨勢
trend	趨向
murina	murina
sos	sos
spiegel	spiegel
dane	dane
gpcm	gpcm
shepherd	shepherd
shepherd	牧羊人
bunko	文庫
rowland	rowland
moo	茂
mica	雲母
mica	mica
sale	銷售
sale	出售
sale	買賣
sale	馬鞍
sale	鞍
storia	storia
khay	托盤
anceps	anceps
lantan	鑭
abdel	abdel
oracle	oracle
oracle	先知
pieridae	pieridae
parnassius	parnassius
scan	掃描
scan	掃瞄
muỗng	匙
muỗng	勺
muỗng	勺子
muỗng	湯匙
fulvus	fulvus
skull	骷髏
skull	頭顱
skull	頭骨
clk	clk
sokolov	sokolov
macrantha	macrantha
hirsutus	hirsutus
odas	odas
comments	評論
comments	意見
dracaena	dracaena
annulata	annulata
bowie	bowie
karim	karim
hipposideros	hipposideros
boku	boku
canaan	迦南
alam	alam
lanata	lanata
vote	表決
vote	投票
boot	靴
boot	靴子
felis	felis
perciformes	perciformes
moor	荒原
chakri	chakri
phasianidae	phasianidae
salins	salins
oka	岡
jill	吉爾
rowan	rowan
espinosa	espinosa
trụy	強姦犯
courtney	courtney
maynard	maynard
deborah	deborah
lauraceae	lauraceae
bering	bering
dominican	多明尼加
graves	墳墓
graves	墓穴
texana	texana
nghêu	蛤蜊
nghêu	蛤
comet	彗星
underwood	underwood
loud	大聲
sage	sage
bilineata	bilineata
anpơ	阿爾卑斯山
wcw	wcw
mải	永遠
mải	永恆
menken	menken
closer	更近
crassa	crassa
hói	禿頭
hói	禿
trim	修剪
rebounds	籃板球
rebounds	籃板
sopwith	sopwith
cellpadding	cellpadding
heron	鷺
rữa	腐爛
rữa	腐
passeriformes	passeriformes
felicia	felicia
globalsecurity	globalsecurity
berryz	berryz
latifrons	latifrons
ramon	ramon
nhóc	小孩
lib	lib
sunny	晴
foch	foch
vái	dua
enigma	謎
vase	花瓶
corvus	烏鴉
carbine	卡賓槍
lit	點燃
lit	數
lit	計數
hormon	激素
hormon	荷爾蒙
hormon	激素
hormon	荷爾蒙
celsius	攝氏
patterns	格局
patterns	模式
rough	毛坯
rough	粗
rough	粗糙
cecilia	cecilia
mah	mah
boo	boo
pursh	pursh
stamp	蓋章
stamp	郵票
stamp	印章
malo	malo
persona	人格
viterbo	viterbo
coleoptera	coleoptera
cindy	cindy
barrier	屏障
poison	poisson
poison	毒藥
poison	毒
poison	毒物
scorpion	蠍子
hazard	危害
township	鄉
quây	周邊
pong	邦
grau	grau
atrata	atrata
panel	pavel
bagdad	巴格達
joplin	joplin
horizon	地平線
veron	veron
blast	爆炸
blast	爆
kedah	kedah
dekalb	dekalb
phết	逗號
eur	歐元
eur	eur
darkness	黑暗
mans	芒
sprint	衝刺
methyl	甲基
verne	verne
hou	侯
headerstyle	headerstyle
aol	aol
thrash	敲擊
domino	骨牌
bitcoin	bitcoin
ursus	ursus
parabellum	parabellum
dir	dir
cdo	cdo
rms	rms
hiragana	hiragana
poe	坡
gunn	gunn
villosus	villosus
lbs	磅
aquarium	水族
aquarium	水族館
okita	沖田
wifi	wifi
compacta	compacta
gregor	gregor
geh	geh
siem	siem
telecom	電訊
telecom	電信
silvestris	silvestris
yusuf	yusuf
quad	四方
plexippus	plexippus
aaa	aaa
supplement	補充
supplement	輔助
hijikata	土方
ruficeps	ruficeps
armando	armando
alexa	alexa
freddy	freddy
vivaldi	vivaldi
emanuel	emanuel
gonzalez	gonzalez
kemal	kemal
fix	修復
fix	修
dexter	dexter
nigricollis	nigricollis
theresa	theresa
rubescens	rubescens
mut	mut
sericeus	sericeus
insulin	胰島素
qubit	qubit
gesellschaft	gesellschaft
magnum	magnum
georgi	georgi
patch	修補
patch	補丁
tcp	tcp
khiêng	攜帶
cui	崔
barros	barros
astro	astro
nobelprize	nobelprize
inchikey	inchikey
airline	航空公司
airline	航空
pilosus	pilosus
sasha	沙沙
alison	alison
riva	riva
tite	tite
wilder	wilder
incisa	incisa
couple	夫妻
couple	情侶
couple	夫婦
hertz	赫茲
kimono	和服
bovidae	bovidae
tibet	西藏
ferrugineus	ferrugineus
vodka	伏特加
mie	mie
revival	復興
revival	復蘇
revival	振興
goo	goo
goo	咕
gượng	洪水
gượng	水災
gượng	尷尬
whisky	威士忌
gorilla	猩猩
pontarlier	pontarlier
christa	christa
twins	雙胞胎
ferrer	ferrer
anion	陰離子
marginalis	marginalis
integrated	整合
chrysanthemum	菊花
sagan	sagan
kata	kata
psi	psi
fans	粉絲
linder	linder
yeo	楊
yeo	yeo
mina	mina
push	推
push	推推
push	推動
wikia	wikia
mascara	睫毛膏
shun	順
ethan	ethan
fuliginosa	fuliginosa
concord	協和
tdp	tdp
véc	切片
fantasia	幻想曲
islamabad	伊斯蘭堡
persimilis	persimilis
kabuki	歌舞伎
saul	saul
kappa	kappa
cation	陽離子
sharif	sharif
macintosh	macintosh
adi	adi
clint	clint
poor	柏
quintana	quintana
kaval	kaval
godfrey	godfrey
kerrigan	kerrigan
laudon	laudon
cad	cad
toho	toho
jesús	jesús
freude	freude
korth	korth
enthusiast	愛好者
cinderella	灰姑娘
oshima	大島
oshima	渡島
edmond	edmond
shea	shea
anten	天線
sakamoto	阪本
gon	坤
incerta	incerta
carnival	狂歡節
debian	debian
levin	levin
nadia	nadia
siebold	siebold
minaj	minaj
ofc	大洋洲
bose	bose
anthene	anthene
chandra	chandra
astrid	astrid
eriksen	eriksen
deluxe	豪華
constant	常數
quote	報價
quote	引文
quote	引用
quote	引述
abba	abba
boxer	拳手
boxer	拳擊手
peña	peña
cynthia	cynthia
marcelo	marcelo
fps	fps
nấc	打嗝
foliosa	foliosa
juliette	juliette
diptera	diptera
lòi	棍子
humphrey	humphrey
nivalis	nivalis
megan	megan
strigidae	strigidae
ignacio	ignacio
swagger	swagger
dauphin	皇太子
wrightii	wrightii
angelina	angelina
sympetrum	sympetrum
lagerkvist	lagerkvist
rss	rss
nelly	nelly
emedicinesubj	emedicinesubj
salsola	salsola
kano	獨木舟
dns	dns
topic	題目
topic	話題
topic	專題
topic	主題
lithuania	立陶宛
null	無效
plug	插頭
convair	convair
doll	娃娃
doll	洋娃娃
doll	玩偶
riverside	河濱
lilium	百合
chon	十字架
chon	cross
chon	十字
chon	交叉
chon	chon
corona	日冕
corona	冕
corona	corona
longicauda	longicauda
buteo	buteo
terrestrial	陸地
nagato	長門
covers	封面
uhfffaoysa	uhfffaoysa
bios	bios
naked	裸
naked	赤裸
naked	裸體
supreme	最高
parabol	拋物線
mya	mya
strawberry	草莓
horner	horner
hamid	hamid
thirty	三十
thirty	thirty
streaming	流
massimo	massimo
ebay	ebay
eocene	eocene
planetary	行星
phốtpho	磷
herbst	herbst
infraordo	infraordo
torrent	torrent
orly	orly
kendrick	kendrick
yamazaki	山崎
hitomi	瞳
fff	fff
nikola	nikola
solaris	solaris
heroin	海洛因
mandarin	國語
gaertn	gaertn
brett	brett
gôn	高爾夫球
calderón	calderón
eli	eli
adaptation	適應
adaptation	適應性
irina	irina
punctulata	punctulata
share	共用
share	共享
share	分享
share	share
pothos	pothos
auflage	auflage
sas	sas
domenico	domenico
patrice	patrice
robbins	robbins
hidro	氫氣
hidro	氫
gage	gage
hind	doe
hind	hind
raptor	猛禽
raptor	猛禽
giỡn	亂
giỡn	爛攤子
jeans	牛仔褲
kirsch	kirsch
magnifier	放大鏡
caballero	caballero
stutsman	stutsman
bowling	保齡球
inst	inst
weinberg	weinberg
porsche	porsche
chow	周
chow	鄒
amateur	業餘
okayama	岡山
verdi	verdi
miyagi	宮城
ups	ups
gem	寶石
ginger	姜
serinus	金絲雀
rwd	rwd
premium	premium
premium	溢價
premium	保費
premium	保險費
ater	蜷
percival	percival
bch	bch
laberge	laberge
bum	傑
bum	jay
lepus	野兔
lepus	兔
speciosus	speciosus
volkswagen	大眾
lovato	lovato
rpm	rpm
rpm	轉速
nicki	nicki
ipv	ipv
xxxx	xxxx
icd	icd
coli	大腸桿菌
coli	coli
nsw	nsw
daisuke	大介
capture	獵物
allianz	allianz
vest	馬甲
vest	背心
dijk	dijk
bone	骨
bone	骨骼
bone	骨頭
kilo	千克
kilo	公斤
overture	序曲
passer	麻雀
posen	posen
altvar	altvar
siddeley	siddeley
qualcomm	qualcomm
caprimulgus	夜鷹
ras	ras
bridges	橋梁
bridges	橋
triumph	凱旋
triumph	勝利
syst	syst
gawl	gawl
dll	dll
ehrenberg	ehrenberg
eup	邑
lovers	戀人
lovers	愛人
lovers	情侶
lovers	情人
morrow	morrow
clarinet	單簧管
htc	htc
spectrum	光譜
spectrum	頻譜
huai	懷
burn	燒錄
burn	燃燒
burn	燒傷
burn	燒
burn	燒死
greer	greer
audition	試鏡
audition	試演
touchwiz	touchwiz
bst	bst
alcalá	alcalá
prima	prima
fujita	fujita
banana	香蕉
banana	蕉
irregularis	irregularis
atsushi	篤志
gestapo	蓋世太保
halo	光環
halo	暈
barbie	芭比
gum	膠
gum	口香糖
gecko	壁虎
otus	otus
nebula	星雲
thouars	thouars
bmi	學生
sik	植
semimajor	semimajor
flint	火石
electropop	electropop
rallidae	rallidae
asa	asa
robben	robben
bandar	bandar
aspirin	阿司匹林
dissimilis	dissimilis
rèm	窗簾
rèm	百葉窗
rèm	窗簾
rèm	簾幕
okada	岡田
chau	洲
temps	temps
hydrogen	氫氣
hydrogen	氫
siro	siro
mabille	mabille
sana	薩那
wikipe	wikipe
hazel	淡褐色
tomas	tomas
sho	翔
jstor	jstor
icc	icc
harriet	harriet
cure	治癒
aloeides	aloeides
vireo	vireo
cbc	cbc
sabha	sabha
funny	只是
funny	只要
juels	juels
hawthorne	hawthorne
ast	ast
torpedo	魚雷
bts	bts
kde	kde
clos	clos
pico	pico
angustifolium	angustifolium
crom	鉻
abovestyle	abovestyle
rift	rift
cyclops	獨眼龍
williston	williston
virgo	處女座
helm	舵
sachs	sachs
deutscher	deutscher
sệt	脆弱
sệt	易碎
dual	雙重
toru	toru
ulaanbaatar	烏蘭巴托
trimen	trimen
jared	jared
amir	amir
secunda	secunda
phosphate	磷酸鹽
phosphate	磷酸
mint	薄荷
bol	bol
mariano	mariano
hutton	hutton
slim	苗條
slim	瘦
aces	王牌
kale	甘藍
duo	duo
gibbons	gibbons
katakana	片假名
katakana	katakana
hyeon	hyeon
reilly	reilly
dubois	dubois
shibuya	shibuya
rye	黑麥
koppa	koppa
barrio	barrio
kok	kok
woodbury	woodbury
valery	valery
gamba	gamba
babcock	babcock
eri	eri
hewitson	hewitson
dominion	自治領
charadrius	鴴
jens	jens
walls	牆壁
walls	城牆
walls	牆
apartheid	種族隔離
josip	josip
giants	巨人
yugoslavia	南斯拉夫
dickson	dickson
bsd	bsd
iptv	iptv
bukit	bukit
sic	sic
initiative	倡議
krug	krug
fuga	fuga
fuga	風雅
lauderdale	lauderdale
blonde	金髮
faro	faro
leben	leben
ting	婷
ting	汀
mui	hood
bolero	bolero
cingulata	cingulata
kikuchi	菊池
lecomte	lecomte
reflexa	reflexa
brill	brill
schwaben	schwaben
maroon	栗色
maroon	maroon
cypraea	cypraea
dấm	醋
nicholls	nicholls
zac	zac
macropus	macropus
inaequalis	inaequalis
bonsai	盆景
sparks	火花
cacao	可可
isp	isp
dhc	dhc
pid	pid
rít	蜈蚣
yue	岳
faye	faye
twelve	十二
lite	lite
iupac	iupac
delphi	delphi
kyoko	杏子
espn	espn
karma	報應
karma	因果報應
tombelli	tombelli
mall	商場
ddg	ddg
nickel	鎳
pilar	pilar
pilar	bueno
fargo	fargo
lycoming	lycoming
cop	cop
ngời	光芒
ngời	螢光
ngời	發光
soundscan	soundscan
xốt	蛋黃醬
boxing	拳擊
crisp	脆
decora	decora
andrade	andrade
ifpi	ifpi
moves	動作
dat	dat
estrada	estrada
russo	russo
sylvain	sylvain
miso	miso
pil	藥片
pil	藥丸
pil	避孕藥
marcellus	marcellus
carcharhinus	鯊
carcharhinus	鯊魚
herpes	皰疹
openoffice	openoffice
viper	毒蛇
kam	錦
walters	walters
tma	tma
reuter	reuter
bunting	鵐
sid	sid
mba	mba
eastwood	eastwood
cod	鱈魚
txt	txt
ctenomys	ctenomys
supa	supa
scopoli	scopoli
intro	介紹
genius	天才
sabrina	sabrina
twist	扭
twist	扭曲
kita	北
carolinensis	carolinensis
poole	普爾
tigers	老虎
nicky	nicky
antonia	antonia
orsay	orsay
commando	突擊隊
gypsy	吉普賽人
gypsy	吉普賽
gypsy	吉卜賽人
wonderland	仙境
confessions	告白
confessions	供詞
confessions	口供
confessions	懺悔
lse	lse
wiens	wiens
panic	恐慌
klimov	klimov
codex	法典
spathulata	spathulata
phelsuma	phelsuma
matteo	matteo
danielle	danielle
dien	dien
obj	obj
lip	嘴唇
lip	lip
lip	唇
sciurus	sciurus
shellback	shellback
elm	榆樹
casting	鑄造
haddad	haddad
cáng	擔架
polydor	polydor
lunar	月球
antique	古董
françoise	françoise
cara	cara
shang	翔
goose	雁
goose	鵝
septimius	septimius
lavender	淡紫色
khùng	瘋狂
khùng	瘋
khùng	瘋了
ravi	ravi
ale	ale
melinda	melinda
jeep	吉普車
jeep	吉普
ing	ing
cheetah	獵豹
nghiến	磨
soma	soma
cambria	cambria
vientiane	萬象
combo	套餐
fontana	fontana
slide	幻燈片
slide	滑
slide	滑動
slide	幻燈片
rashid	rashid
agilis	agilis
auratus	auratus
oost	oost
oasis	綠洲
misaki	美咲
welch	welch
twice	兩次
macaca	獼猴
silvia	silvia
mak	麥
phễu	漏斗
slogan	口號
slogan	標語
helianthus	helianthus
weekend	週末
rubella	風疹
ernesto	ernesto
worm	蠕蟲
adv	adv
togoshi	magome
skype	skype
vevo	vevo
mancini	mancini
laptop	筆記本
atom	atom
atom	原子
ems	ems
consortium	財團
regalis	regalis
macao	澳門
macao	澳門
gunston	gunston
brahma	梵
brahma	梵天
smithi	smithi
finger	指頭
finger	手指
transformers	變壓器
cum	精液
châteauneuf	châteauneuf
xuan	宣
xuan	玄
clash	碰撞
clash	衝突
safavid	safavid
rockstar	rockstar
rapids	激流
rapids	急流
bentley	bentley
tiny	小小
tiny	小
tiny	微小
layla	layla
pusan	釜山
polymerase	聚合酶
iredale	iredale
eintracht	eintracht
belowclass	belowclass
gareth	gareth
telebasis	浮萍
arp	arp
arp	aarp
weston	weston
sil	篩
sil	sil
murat	murat
difficilis	difficilis
assault	攻擊
assault	毆打
assault	突擊
assault	侵
illiger	illiger
shingen	信玄
hendrik	hendrick
abigail	abigail
grayi	grayi
dipodomys	袋鼠
strip	脫衣
strip	脫
strip	脫衣舞
strip	地帶
sbd	sbd
brewster	brewster
gregg	gregg
origami	摺紙
strings	弦樂
samba	samba
granite	花崗岩
bogart	bogart
dota	dota
scouts	童軍
kẻo	否則
senshi	戰史
nst	nst
amara	amara
momo	momo
excel	excel
optimus	optimus
shenyang	瀋陽市
shenyang	瀋陽
vaccine	疫苗
ecstasy	狂喜
ecstasy	銷魂
pac	pac
aurivillius	aurivillius
ramosa	ramosa
combinedfleet	combinedfleet
priscilla	priscilla
hashimoto	橋本
eleven	十一
eleven	eleven
afp	法新社
vani	vani
vani	香草
joaquin	joaquin
higurashi	日暮
pier	碼頭
ashland	ashland
nordic	北歐
hamata	hamata
scorpions	蠍子
micrurus	micrurus
cats	貓
fractions	分數
romulus	romulus
dau	蟾蜍
aoyama	青山
bsi	bsi
torquatus	torquatus
girlfriend	女友
girlfriend	女朋友
fukui	福井
integra	integra
clio	clio
rossini	rossini
hubbard	hubbard
kotoko	kotoko
mazama	mazama
bỉm	尿布
caucasica	caucasica
lowry	lowry
nevadensis	nevadensis
dragonfly	蜻蜓
chitose	千歲
abbreviata	abbreviata
daly	daly
ingram	ingram
conductor	指揮
cretaceous	白堊紀
vulpes	vulpes
stick	棍子
cowley	cowley
kunming	昆明
cyrenaica	cyrenaica
boattini	boattini
gosling	gosling
tall	tal
daday	daday
giggs	giggs
grosse	grosse
tvn	tvn
porte	porte
sumo	相撲
pavilion	館
pavilion	pavilion
pavilion	pavillion
saba	saba
atriceps	atriceps
helicopter	直升機
helicopter	直升飛機
athletics	田徑
beech	beech
fleetwood	fleetwood
mastering	掌握
salaam	salaam
exile	流亡
exile	放逐
exile	流放
wheel	輪
wheel	車輪
gervais	gervais
leona	leona
immanuel	immanuel
weaver	weaver
abyss	深淵
proximus	proximus
perl	perl
laurel	月桂
laurel	laurel
mpa	mpa
magie	鎂
autumnalis	autumnalis
eto	eto
forbesii	forbesii
jai	jai
cobitis	鰍
hari	hari
uni	uni
grover	grover
thinh	然而
hina	hina
sac	sac
wordpress	wordpress
cowell	cowell
gibbon	長臂猿
virgil	崇德
nhậu	飲酒
bal	bal
nen	月球
nen	月亮
nen	月
spiral	螺旋
mki	mki
bello	bello
dich	dich
reinhardt	reinhardt
pvc	pvc
pvc	聚氯乙烯
symbian	symbian
jerkins	jerkins
edouard	edouard
rafinesque	rafinesque
acosta	acosta
sig	sig
angustata	angustata
matilda	matilda
lagopus	lagopus
midori	綠
hmong	苗族
cnc	cnc
benzen	苯
encore	encore
chiyoda	chiyoda
reginald	reginald
tời	回答
tời	答
tời	答案
amx	amx
pago	pago
recovery	回收
recovery	恢復
recovery	康復
recovery	復原
recovery	復蘇
indira	indira
carpinus	carpinus
castor	蓖麻
ses	ses
indra	indra
cgi	cgi
bazaine	bazaine
cosmic	宇宙
leander	leander
sturmgewehr	sturmgewehr
reunion	團聚
reunion	團圓
reunion	同學會
reunion	重逢
farra	法拉
sketch	素描
sketch	草圖
unique	獨特
unique	獨一無二
phylogenetics	phylogenetics
babel	babel
háng	褲襠
mistral	mistral
fender	fender
apis	api
notableworks	notableworks
lorde	lorde
ethanol	乙醇
nec	nec
vine	藤
bodrum	bodrum
gsh	gsh
iar	iar
amt	amt
risc	risc
hitachi	hitachi
conqueror	征服者
oxide	氧化
oxide	氧化物
františek	františek
skip	跳過
bud	芽
bud	bud
rosaceae	rosaceae
iaşi	iaşi
alvarez	alvarez
maarten	maarten
longmans	longmans
fonseca	fonseca
lateral	橫向
lateral	側
nate	nate
haeckel	haeckel
tac	tac
grandiflorum	grandiflorum
outlook	展望
tempest	暴風雨
petrie	petrie
instagram	instagram
ester	酯
lyons	里昂
ric	ric
lok	樂
carlson	carlson
thori	釷
crush	暗戀
hirst	hirst
osi	osi
flavida	flavida
denise	denise
motta	motta
sushi	壽司
bernadette	bernadette
cuculidae	cuculidae
zeit	zeit
arado	arado
radon	氡
rhapsody	狂想曲
martel	martel
pitch	投
pitch	投球
floridana	floridana
rương	棺材
rương	樹幹
đít	屁股
đít	屁股
carla	carla
anonymous	匿名
anonymous	無名氏
deco	deco
deco	裝飾
grupo	grupo
moneta	moneta
battista	battista
pap	pap
cameo	客串
saiga	saiga
lys	lys
peach	桃
peach	桃子
kadai	kadai
saleh	saleh
sunfat	硫酸
sunfat	硫酸鹽
baton	警棍
luitpold	luitpold
basu	basu
azarenka	azarenka
daryl	daryl
goto	goto
erfurt	erfurt
kellogg	kellogg
fedex	fedex
dumont	dumont
dscn	dscn
eth	ð
paine	paine
pacheco	pacheco
ama	ama
vanguard	先鋒
vanguard	前衛
vanguard	前鋒
gprs	gprs
coastline	海岸線
redwood	紅木
meyeri	扦
lutjanus	鯛魚
meyers	meyers
wal	wal
ando	安藤
bartsch	bartsch
cork	cork
trance	trance
trance	恍惚
netscape	netscape
yung	yung
seventh	第七
catfish	鯰魚
ina	ina
nrt	nrt
salad	沙拉
iwata	iwata
alley	小巷
alley	巷
alley	巷子
patent	專利權
patent	專利
shields	盾牌
crusade	討伐
crusade	十字軍
jets	噴氣機
meissner	meisner
arashi	嵐
dyson	dyson
zvezda	zvezda
ass	助手
ass	助理
uranus	天王星
nệm	床墊
nệm	床墊
fuchs	fuchs
hiu	曉
ota	太田
ota	大田
cervantes	cervantes
crowley	crowley
cortez	cortez
dầy	厚
dầy	厚厚
procopius	procopius
ntfs	ntfs
stug	stug
lala	lala
evol	evol
mango	芒果
tres	tres
trafalgar	trafalgar
persea	persea
microtus	田鼠
ryo	亮
meadows	草甸
meadows	meadows
brauer	brauer
finalist	入圍
neto	neto
brody	brody
jum	jum
aek	aek
henriette	henriette
izumi	泉
izumi	和泉
fahrenheit	華氏
assamensis	assamensis
polaris	北極星
melvin	melvin
higgs	higgs
arkive	arkive
adidas	adidas
wow	哇哇
wow	哇
ces	ces
gbu	gbu
sheldon	sheldon
scud	飛毛腿
rocchi	rocchi
raid	突襲
cisco	cisco
papuensis	papuensis
curry	咖哩
muslim	穆斯林
giselle	giselle
pigeon	鴿
pigeon	鴿子
dara	dara
riff	riff
playboy	花花公子
equity	股權
equity	股本
equity	公平
erika	erika
nes	nes
zoe	zoe
mineiro	mineiro
cove	灣
dicaprio	dicaprio
mapsize	mapsize
madre	madre
collin	colin
croce	croce
elaine	elaine
sakon	左近
palgrave	palgrave
ssn	ssn
boateng	boateng
dinan	dinan
ponce	ponce
ghim	別針
ghim	pin
vôn	伏
vôn	伏特
regis	regis
xing	興
amoni	銨
canadair	canadair
haneda	羽田
eta	eta
suetonius	suetonius
mauricio	mauricio
napalm	汽油彈
pda	pda
fenerbahçe	fenerbahçe
caesia	caesia
maung	maung
horizons	地平線
mbps	mbps
sistar	sistar
btc	btc
familycolor	familycolor
clements	clements
reg	reg
graphic	圖形
defender	後衛
wisdom	智慧
choisy	choisy
biographie	biographie
francesca	francesca
cucumis	cucumis
ouen	ouen
steinmetz	steinmetz
thesis	命題
thesis	論文
travers	travers
ill	病
ill	生病
empress	皇后
springsteen	springsteen
aida	aida
portia	portia
fuzzy	模糊
smrt	smrt
occidentale	occidentale
tatyana	tatyana
pilsbry	pilsbry
mani	mani
unter	unter
waldo	waldo
endless	無盡
endless	無止境
neujmin	neujmin
krone	krone
ean	ean
celebrity	名流
celebrity	名人
dani	dani
auge	auge
dharma	達摩
dharma	佛法
dharma	誓約
ohm	歐姆
sortable	sortable
widow	遺孀
widow	寡婦
monique	monique
toshiba	巨人
toshiba	巨
toshiba	巨型
daigo	醍醐
socket	插座
socket	socket
socket	插座
immortal	不朽
maritimequest	maritimequest
badger	獾
quầng	光環
quầng	暈
ott	ott
morphology	形態
vink	vink
nicrophorus	nicrophorus
glabrescens	glabrescens
cedric	cedric
ngách	角落
dock	船塢
dock	碼頭
juliana	juliana
mertens	mertens
lukas	lukas
diablo	diablo
xỉu	暈倒
xỉu	暈
xỉu	昏倒
xỉu	微弱
xỉu	暈倒
bầm	瘀傷
mic	麥克風
villas	別墅
mana	mana
doe	doe
flavicollis	flavicollis
kirin	麒麟
streep	streep
collar	領
collar	項圈
cnblue	cnblue
valerie	valerie
nut	堅果
marry	嫁
sulphurea	sulphurea
thunberg	thunberg
kurstin	kurstin
elisa	elisa
cabral	cabral
asch	asch
afr	afr
hatch	艙門
hatch	孵化
exe	exe
cmos	cmos
vladimirovich	vladimirovich
ruka	ruka
caecilia	caecilia
garage	車庫
taft	taft
komodo	komodo
marker	標記
volker	volker
wilhelmina	wilhelmina
gunnar	gunnar
udp	udp
namco	namco
hsdpa	hsdpa
mri	mrl
mri	mri
irrorata	irrorata
genetics	遺傳學
genetics	遺傳
kaori	香織
mehmet	mehmet
fuck	樊
fuck	粉絲
fuck	風扇
fuck	範
fuck	sls
dove	鳩
dove	鴿
dove	鴿子
nwa	nwa
bouvier	bouvier
gorge	峽谷
boucher	boucher
atletico	atletico
citrina	citrina
warhol	warhol
gamecube	gamecube
galactic	銀河
shinto	神道
swat	swat
swat	特種部隊
doping	興奮劑
doping	摻雜
chiaki	千秋
uma	uma
vga	vga
oxygen	氧氣
oxygen	氧
ics	ic
volt	伏
volt	伏特
luo	羅
carole	carole
allmovie	allmovie
acevedo	acevedo
monk	僧侶
monk	和尚
monk	僧
fai	輝
basestyle	basestyle
osceola	osceola
cmc	cmc
reconnaissance	偵查
reconnaissance	偵察
dev	dev
pledis	pledis
methane	甲烷
methane	沼氣
offline	下線
offline	離線
cern	cern
itv	itv
shao	邵
starfighter	starfighter
aurelianus	aurelian
bataille	bataille
xperia	xperia
celaenorrhinus	celaenorrhinus
azul	azul
goldberg	goldberg
blaine	blaine
bcl	bcl
locus	軌跡
blatt	blatt
dlc	dlc
peruvianus	peruvianus
chauhan	chauhan
crt	crt
monograph	專論
birthname	birthname
florua	氟化
florua	氟
heng	heng
heng	恆
eros	eros
lởm	織機
carya	carya
pwi	pwi
salomon	salomon
salomon	所羅門
bellamy	bellamy
edson	edson
lycium	lycium
bowen	bowen
cheryl	cheryl
hoe	鋤頭
lanceolatus	lanceolatus
jérôme	jérôme
beagle	beagle
têrêsa	teresa
superstar	巨星
festiva	festiva
antarctic	南極洲
antarctic	南極
kềm	唐
kềm	鉗
foreground	前景
parryi	parryi
jacket	夾克
jacket	外套
yami	yami
furtado	furtado
moto	摩托
moto	moto
missy	missy
sentinel	哨兵
epa	環保局
epa	環保署
highlands	高地
aizu	會津
maximinus	maximinus
dobson	dobson
gracie	gracie
molypden	鉬
deutsches	deutsches
brennan	brennan
goulding	goulding
ridley	ridley
guzmán	guzmán
ciel	ciel
georgios	georgios
massage	按摩
massage	按摩
hof	hof
