canescens	canescens
baghdad	bagdad
ryukyu	ryukyu
schwartz	schwartz
hohenzollern	hohenzollern
para	para
howell	howell
tolstoy	tolstoi
neptune	neptune
jupiter	jupiter
velvet	velvet
violacea	violacea
mia	mia
alfonso	alfonso
lara	lara
bromley	bromley
proxy	volmag
proxy	instaan
djibouti	djiboeti
training	oefening
musa	musa
acta	acta
marcello	marcello
gilles	gilles
norodom	norodom
funk	funk
robustus	robustus
jharkhand	jharkhand
shepard	shepard
microphylla	microphylla
zanzibar	zanzibar
lil	lil
dmitry	dmitri
apiaceae	apiaceae
cowan	cowan
randolph	randolph
oakland	oakland
toscana	tuscany
toscana	toskaanse
ambrose	ambrose
aurelius	aurelius
sheikh	sheikh
krai	krai
gear	toerusting
gear	gear
andorra	podgorica
olympique	olympique
benedict	benedictus
palmer	palmer
irving	irving
trau	moeg
lat	lui
coruña	coruña
wigan	wigan
crane	crane
ôtô	motors
ôtô	karre
ôtô	cars
clement	clemens
clement	clement
fulva	fulva
nobilis	nobilis
darren	darren
beaver	beaver
chopin	chopin
canterbury	canterbury
gerhard	gerhard
ariel	ariel
fujiwara	fujiwara
fasciatus	fasciatus
maxima	maxima
indie	indie
konrad	konrad
castillo	castillo
kung	kung
championships	championships
beograd	belgrado
martha	martha
bloom	bloom
marius	marius
espírito	espírito
helmut	helmut
avril	avril
mbar	mbar
kure	kure
khuya	laat
suffolk	suffolk
liststyle	liststyle
niken	nikkel
kimi	kimi
beaufort	beaufort
maui	maui
tone	skakering
tone	tone
ferrari	ferrari
sond	sond
stan	stan
rebel	rebel
loi	loi
regina	regina
laporte	laporte
cherry	cherry
cherry	kersies
scout	scout
scout	verkenner
coburg	koburg
lozère	lozère
pereira	pereira
interscope	interscope
agapetus	agapetus
bruxelles	bruxelles
bruxelles	brussels
bruxelles	brusselse
bruxelles	brussel
gaston	gaston
citation	aanhaling
sakai	sakai
curie	curie
chuck	chuck
dora	dora
benn	benn
punctatus	punctatus
romagna	romagna
bergen	bergen
laevis	laevis
vols	vols
turkish	turkse
turkish	turkish
trinity	trinity
antigonos	antigonus
shop	winkel
shop	winkels
shop	shops
roche	roche
lamiaceae	lamiaceae
kafka	kafka
sonora	sonora
leiden	leiden
meteor	meteor
hubert	hubert
schumacher	schumacher
bertrand	bertrand
turin	turyn
sylvia	sylvia
wikitext	wikitext
valentin	valentin
thriller	riller
holly	holly
sensu	sensu
fidel	fidel
ash	ash
brittany	brittany
ret	ret
gentry	landadel
pohl	pohl
giặt	wasgoed
middlesbrough	middlesbrough
barker	barker
spitfire	spitfire
gurevich	gurevich
philipp	philipp
andre	andre
andre	andré
hibiscus	hibiscus
barton	barton
pierce	pierce
rfc	rfc
catania	catania
canary	kanariese
canary	kanarie
santana	santana
hilton	hilton
smithii	smithii
spotted	spotted
spotted	gevlekte
paniculata	paniculata
sexy	sexy
cược	bie
cược	bet
lars	lars
krasnodar	krasnodar
wikimapia	wikimapia
chẻ	gat
rainer	rainer
vilnius	vilnius
trieste	trieste
phineas	phineas
sirius	sirius
arafat	arafat
leonid	leonid
fuller	fuller
kino	kino
phoebe	phoebe
concorde	concorde
micrantha	micrantha
benevento	benevento
cervus	cervus
boleslav	boleslav
brevipes	brevipes
sec	sekondes
sec	sek
natalie	natalie
barca	barca
cassini	cassini
halloween	halloween
midland	midland
narcissus	narsissus
nottingham	nottingham
boson	boson
angelica	angelica
labrador	labrador
mono	mono
charlton	charlton
rót	pour
sites	webwerwe
sites	tuistes
sites	werwe
sites	sites
sites	terreine
skin	vel
doyle	doyle
cedar	cedar
saturn	saturnus
container	houer
thom	thom
ocotea	ocotea
nitrat	nitrate
hilbert	hilbert
rising	toeneem
eight	agt
eight	agtste
eight	reguit
leigh	leigh
hogg	hogg
cody	cody
biếng	lui
shiva	shiva
shiva	siva
merlin	merlin
gmelin	gmelin
vesoul	vesoul
anchor	bladsy
anchor	anker
ascii	ascii
unidos	unidos
vice	vice
nymphalidae	nymphalidae
phillip	phillip
surrey	surrey
surrey	belvedere
barset	barset
bolzano	bolzano
martinez	martinez
gill	gill
hilaire	hilaire
globe	aardbol
globe	globe
edison	edison
orton	orton
oppenheimer	oppenheimer
cyanea	cyanea
bravo	bravo
tahiti	tahiti
bauer	bauer
bauer	bouwer
wolfsburg	wolfsburg
kalinin	kalinin
lateralis	lateralis
vittata	vittata
hopper	hopper
goa	goa
hyperolius	hyperolius
nicholson	nicholson
tigris	tigrisrivier
mladá	mladá
soft	sagte
soft	sag
laguna	laguna
coca	coke
coca	coca
estadio	estadio
pixel	pixel
pixel	pixels
jörg	jörg
brevis	brevis
philippi	philippi
titlestyle	titlestyle
lcd	lcd
sphinx	sfinks
anemone	anemone
rogue	rogue
crimea	krim
breslau	breslau
factbook	factbook
bonus	bonus
flavipes	flavipes
abkhazia	abchasië
gardenia	gardenia
mồm	mond
burma	burma
pepper	peper
baptist	baptist
hrsg	hrsg
jammu	jammu
koh	koh
castanea	castanea
eyed	eyed
dome	dome
ramsey	ramsey
infinity	infinity
hayes	hayes
waterhouse	waterhouse
lombard	lombard
bịp	strik
molina	molina
forrest	forrest
chòi	hut
chòi	kajuit
chòi	cabin
composite	saamgestelde
andrés	andres
tonumber	tonumber
cornelius	cornelius
brie	brie
robbie	robbie
sally	sally
zurich	zurich
mứt	marmelade
patton	patton
drew	drew
bernhard	bernhard
dentata	dentata
hpa	hpa
benny	benny
cherokee	cherokee
hindenburg	hindenburg
smile	smile
smile	glimlag
attila	attila
leverkusen	leverkusen
tbilisi	tbilisi
plutoni	plutonium
rochester	rochester
oxalis	oxalis
kaoru	wada
marguerite	marguerite
navbox	navbox
laden	laden
benito	benito
ramesses	ramses
ngứa	juk
aeroflot	aeroflot
rebecca	rebecca
satoshi	satoshi
stones	klippe
panorama	panorama
chilensis	chilensis
schultz	schultz
trumpet	trompet
acanthaceae	acanthaceae
martens	martens
pot	pot
striatus	striatus
heian	heian
patterson	patterson
alma	alma
bốt	stewels
gsm	gsm
hwan	hwan
pomorskie	pomorskie
homer	homer
weasley	weasley
myers	myers
ligue	ligue
parvula	parvula
hmas	hmas
fourier	fourier
allegheny	allegheny
hub	spil
tivi	televisie
prinz	prinz
gifford	gifford
argentine	argentynse
benin	benin
sar	sar
intercontinental	intercontinental
aquino	aquino
tina	tina
saddam	saddam
mystery	mystery
mystery	geheimsinnig
ruth	ruth
carolyn	carolyn
psv	psv
stall	stalletjie
beetle	beetle
picasso	picasso
bien	sigbare
bien	sigbaar
bien	bien
bien	skies
hoffmann	hoffmann
heather	heather
geo	geo
sussex	sussex
joey	joey
nuremberg	neurenberg
silicon	silikon
isabel	isabel
damascus	damaskus
batista	batista
highland	highland
olt	olt
alegre	alegre
cordata	cordata
aspx	aspx
anemia	anemie
schwarzenegger	schwarzenegger
chatham	chatham
una	una
niels	niels
fountain	fontein
imp	imp
vaucluse	vaucluse
kalimantan	kalimantan
albus	albus
pmid	pmid
beckham	beckham
xuyến	torus
reyes	reyes
gin	gin
camille	camille
wendy	wendy
blackwell	blackwell
phoiac	phoiac
oxit	oxide
eteeq	eteeq
echo	ego
echo	echo
holiday	vakansie
ribera	ribera
dornier	dornier
chocolate	sjokolade
transistor	transistor
supermarine	supermarine
timur	timoer
hemingway	hemingway
táp	byt
psoe	psoe
hybrid	hybrid
collaris	collaris
gibbs	gibbs
canis	canis
pushkin	pushkin
neutrino	neutrino
elton	elton
fiat	fiat
circus	sirkus
circus	circus
subspecies	subspesie
montpellier	montpellier
atatürk	atatürk
dawson	dawson
ivoire	ivoire
stress	stres
stress	stress
pattern	patroon
greece	griekeland
oliva	oliva
ferb	ferb
landmark	landmerk
landmark	baken
levant	levant
vila	vila
sapporo	sapporo
davao	davao
buchanan	buchanan
alive	lewendig
rodriguez	rodriguez
cent	cent
leste	leste
lẻn	sluip
sandy	sandy
fra	fra
ftp	ftp
desmond	desmond
terra	terra
tudor	tudor
nigripes	nigripes
wikisource	wikisource
javanica	javanica
neville	neville
novara	novara
pal	kuier
pal	pal
champs	champs
charmed	charmed
ceylon	ceylon
menu	spyskaart
menu	kieslys
menu	kieslyste
menu	spyskaarte
kelvin	kelvin
sergio	sergio
hawking	hawking
pitt	pitt
trier	trier
quezon	quezon
mazowieckie	mazowieckie
nihon	nihon
medium	medium
somali	somalia
somali	somaliese
shane	shane
cal	cal
cool	koel
cool	afkoel
cool	cool
hardcore	hardcore
moreno	moreno
telegraph	telegraph
milk	melk
leucas	leucas
daphne	daphne
jackie	jackie
livingston	livingston
eos	eos
undulata	undulata
wollaston	wollaston
thierry	thierry
rupestris	rupestris
serena	serena
graz	graz
fiorentina	fiorentina
malus	malus
flo	flo
mons	mons
cessna	cessna
angolensis	angolensis
across	regoor
across	oorkant
quest	quest
kangaroo	kangaroo
chrome	chrome
chrome	chroom
lucida	lucida
ismail	ismail
saratoga	saratoga
irkutsk	irkoetsk
liếm	lick
isla	isla
intermedius	intermedius
debilis	debilis
alejandro	alejandro
friuli	friuli
lancashire	lancashire
muscicapidae	muscicapidae
albedo	albedo
infinite	oneindige
castello	castello
myspace	myspace
draco	draco
hale	hale
gloucester	gloucester
puget	puget
hamburger	hamburger
hamburger	hamburgers
sarajevo	sarajevo
breda	breda
macrocarpa	macrocarpa
marvin	marvin
lift	lift
inn	inn
inn	herberg
sonny	sonny
neill	neill
esp	esp
encyclopædia	encyclopædia
aguilar	aguilar
gore	gore
hayashi	hayashi
fuscus	fuscus
phuket	phuket
donna	donna
kauai	kauai
halle	halle
ulrich	ulrich
nitens	nitens
gap	gap
tirana	tirana
karelia	karelië
beaumont	beaumont
hàu	oesters
hàu	oester
#the	#die
erie	erie
thulin	thulin
ogg	ogg
ulsan	ulsan
frances	frances
rigida	rigida
adriatic	adriatiese
viva	viva
conmebol	conmebol
cafe	koffie
cafe	cafe
cafe	kafee
assassin	assassin
farm	plaas
vanilla	donderweer
vanilla	vanielje
société	société
extreme	uiters
extreme	extreme
bilbao	bilbao
bun	bulgaars
bun	bun
auschwitz	auschwitz
multi	multi
woody	woody
fat	platter
fat	vet
fat	fat
myrtaceae	myrtaceae
andrey	andrei
corleone	corleone
mẹo	wenke
mẹo	leidrade
mẹo	wenk
metropolitana	metropolitana
pegasus	pegasus
seymour	seymour
haw	haw
browne	browne
racemosa	racemosa
plato	plato
olympus	olympus
tashkent	tasjkent
lex	lex
magnifica	magnifica
fukushima	fukushima
episodes	episodes
muñoz	muñoz
herb	krui
herb	kruie
ringo	ringo
burgundy	boergondië
renault	renault
mew	mew
minami	minami
avengers	avengers
weiss	weiss
rousseau	rousseau
mecca	mekka
mecca	mecca
kamakura	kamakura
augsburg	augsburg
switch	skakelaar
switch	wissel
herald	herald
fide	fide
dickinson	dickinson
holloway	holloway
hume	hume
muse	muse
chamberlain	chamberlain
bruch	bruch
gala	gala
kazakh	kasakse
cằm	chin
pioneer	pioneer
pioneer	pionier
paula	paula
imdb	imdb
toulon	toulon
romano	romano
wizard	towenaar
wizard	assistent
zander	zander
selim	selim
elliptica	elliptica
damian	damian
bedford	bedford
haifa	haifa
bor	bor
cash	kontant
sorbonne	sorbonne
lugo	lugo
runner	naaswenner
runner	runner
villanueva	villanueva
twilight	skemer
kenji	kenji
hispaniola	hispaniola
entropy	entropie
nur	nur
voltaire	voltaire
robson	robson
mask	masker
merton	merton
coa	coa
sinclair	sinclair
asparagus	aspersie
rojas	rojas
salmon	salmon
salmon	salm
nhả	vrylaat
nhả	vrystelling
charlemagne	charlemagne
thùa	agave
heathrow	heathrow
jenkins	jenkins
minneapolis	minneapolis
pack	verpak
pack	pakket
machado	machado
purpurascens	purpurascens
modena	modena
lions	lions
buckingham	buckingham
kitty	katjie
samara	samara
petersen	petersen
mona	mona
elsa	elsa
estados	estados
madeleine	madeleine
ost	ost
tulagi	tulagi
campagne	campagne
nagano	nagano
spielberg	spielberg
kana	kana
alagoas	alagoas
coventry	coventry
pbs	pbs
lhasa	lhasa
ito	ito
calvert	calvert
polymer	polimeer
nolan	nolan
fitzgerald	fitzgerald
treviso	treviso
mama	mama
romeo	romeo
didier	didier
liguria	ligurië
joyce	joyce
coccinea	coccinea
wai	wai
meet	ontmoet
alexis	alexis
radiata	radiata
greenwich	greenwich
kinabalu	kinabalu
usaf	usaf
nigriceps	nigriceps
revue	revue
asen	asen
titus	titus
hayek	hayek
messenger	messenger
lagos	lagos
stream	stroom
petra	petra
palmas	palmas
gatwick	gatwick
oldenburg	oldenburg
jacobs	jacobs
sikorsky	sikorsky
reims	reims
ensign	vaandel
sio	sio
niigata	niigata
carlsen	carlsen
ericsson	ericsson
achilles	achilles
achilles	achille
gerard	gérard
gerard	gerrard
gerard	gerard
yerevan	jerewan
bergman	bergman
oran	oran
ortiz	ortiz
bogotá	bogotá
focke	focke
constance	constance
guiana	guiana
boca	boca
roem	roem
nếm	smaak
pusillus	pusillus
dhaka	dhaka
seem	sem
amour	amour
amor	amor
theresia	theresia
zara	zara
richelieu	richelieu
cappadocia	kappadosië
michele	michele
swansea	swansea
guadalupe	guadalupe
españa	españa
virgata	virgata
mendoza	mendoza
judo	judo
myung	myung
tunis	tunis
allard	allard
nigel	nigel
sue	sue
garfield	garfield
tula	toela
texte	texte
hermes	hermes
alicia	alicia
eindhoven	eindhoven
archipelago	argipel
gogh	gogh
iglesias	iglesias
nirvana	nirvana
harley	harley
wanted	gesoek
wanted	wou
survivor	survivor
gauge	gauge
reno	strand
suu	suu
nháp	konsep
lagrange	lagrange
roque	roque
chát	kras
chát	klets
chát	gesels
lahore	lahore
sande	sande
melody	melody
melody	melodie
beretta	beretta
comte	comte
sterling	sterling
chambers	chambers
sikh	sikh
humbert	humbert
corsair	corsair
ivy	ivy
northampton	northampton
judith	judith
constantius	constantius
shirley	shirley
michelangelo	michelangelo
nairobi	nairobi
cate	cate
cate	caitlin
lou	lou
advance	vorder
boulogne	boulogne
pulitzer	pulitzer
pocket	pocket
pocket	broeksak
akbar	akbar
sandra	sandra
klatt	klatt
krasnoyarsk	krasnojarsk
buch	buch
elite	elite
interwiki	interwiki
angry	kwaai
cotton	katoen
dispar	dispar
stamford	stamford
faust	faust
klm	klm
kansai	kansai
oval	oval
oval	ovaal
marca	marca
lineatus	lineatus
mannheim	mannheim
everest	everest
ida	ida
berber	berber
atm	otm
deutsch	deutsch
cantor	cantor
dorset	dorset
dover	dover
suleiman	suleiman
bohr	bohr
lamb	lamb
noir	noir
brezhnev	brezjnef
bray	bray
giỏ	pocket
giỏ	broeksak
sap	sap
lauren	lauren
marta	marta
ruficollis	ruficollis
tạt	mosterd
ars	ars
iana	iana
scipio	scipio
tristan	tristan
saunders	saunders
wyatt	wyatt
katherine	katherine
manitoba	manitoba
almeida	almeida
eliot	eliot
tea	tee
stern	stern
teddy	teddy
marek	marek
alien	alien
alien	uitheemse
schindler	schindler
raja	raja
lydia	lydia
fun	pret
kumamoto	kumamoto
jungle	jungle
lorenz	lorenz
bouches	bouches
hillary	hillary
wolfram	wolfram
clermont	clermont
dalton	dalton
gottfried	gottfried
stephens	stephens
genie	genie
mangan	mangaan
byrne	byrne
bluetooth	bloutand
bluetooth	bluetooth
compton	compton
mgm	mgm
triangularis	triangularis
brock	brock
conway	conway
msn	msn
schuster	schuster
fleming	fleming
rodrigues	rodrigues
eumenes	eumenes
snyder	snyder
glucose	glukose
credit	krediet
carrie	carrie
classics	classics
axel	axel
corp	corp
vieux	vieux
novosibirsk	nowosibirsk
galápagos	galápagos
frost	frost
bratislava	bratislava
utrecht	utrecht
herschel	herschel
obovata	obovata
wiltshire	wiltshire
munro	munro
endangered	bedreigde
lausanne	lausanne
jacqueline	jacqueline
café	cafe
café	kafee
café	café
alata	alata
freiburg	freiburg
sui	sui
amadeus	amadeus
nikita	nikita
giacomo	giacomo
reprinted	reprinted
dudley	dudley
pleasant	aangenaam
davy	davy
magdalena	magdalene
magdalena	magdalena
magdalena	río
arras	arras
điếc	doof
lupus	lupus
subfamilia	subfamilia
xxi	xxi
occidental	occidental
archimedes	archimedes
neu	neu
casino	casino
sami	sami
marilyn	marilyn
vincennes	vincennes
hyde	hyde
lugubris	lugubris
cabin	hut
cabin	kajuit
cabin	cabin
simone	simone
ulysses	ulysses
rệp	goggas
rệp	bugs
rệp	creep
sina	sina
bourg	bourg
virescens	virescens
tanganyika	tanganjika
sacramento	sacramento
genji	genji
podocarpus	podocarpus
hoét	lyster
jericho	jericho
thatcher	thatcher
byron	byron
khz	khz
faber	faber
ying	ying
zip	poskode
zip	zip
arthropoda	arthropoda
heterophylla	pendoring
kharkiv	charkif
toni	toni
moravia	morawië
alexios	alexios
raoul	raoul
wiener	wiener
colt	colt
danzig	danzig
clarence	clarence
watt	watt
watt	watts
senegalensis	senegalensis
yoko	yoko
livingstone	livingstone
caracas	caracas
ned	ned
bomb	bomb
bomb	bom
sarkozy	sarkozy
jerzy	jerzy
koi	koi
durand	durand
pole	pool
judy	judy
neue	neue
astronomy	sterrekunde
crassus	crassus
pom	pom
mầu	deursigtigheid
poker	poker
shaun	shaun
higgins	higgins
humeralis	humeralis
tal	tal
aya	aya
nevis	nevis
maytenus	maytenus
inermis	inermis
internazionale	internazionale
germania	germania
meade	meade
dorothy	dorothy
floribunda	floribunda
mcmahon	mcmahon
hartley	hartley
epstein	epstein
jobs	jobs
jobs	werksgeleenthede
jobs	werke
jobs	betrekkings
jobs	poste
safari	safari
bonnie	bonnie
zamboanga	zamboanga
pictus	pictus
gnome	gnome
gutenberg	gutenberg
terre	terre
guild	guild
rumble	rumble
novo	novo
gloster	gloster
doubleday	doubleday
vita	vita
nantes	nantes
stay	bly
panthera	panthera
psyche	psyche
worms	worms
stefano	stefano
tripura	tripoera
enrico	enrico
nháy	flits
nháy	flash
nháy	flikker
nháy	blink
église	église
venusta	venusta
alfredo	alfredo
castilla	kastilië
dayton	dayton
angulata	angulata
takeo	takeo
bougainville	bougainville
superman	superman
corbett	corbett
champ	champ
saints	saints
kochi	kochi
aves	aves
perez	perez
jerome	jerome
yucca	yucca
gupta	gupta
nomen	nomen
trọc	bald
meiji	meiji
neal	neal
sạc	hef
sạc	lading
sạc	heffing
sạc	charge
imax	imax
fossil	fossiel
bart	bart
suvarnabhumi	suvarnabhumi
commonwealth	commonwealth
cactus	kaktus
bourne	bourne
esther	esther
leroy	leroy
cdp	cdp
callas	callas
dinamo	dinamo
lester	lester
prostějov	prostějov
cuspidata	cuspidata
carson	carson
mitterrand	mitterrand
doug	doug
arroyo	arroyo
oss	oss
alpine	alpine
henrik	henrik
geoffroy	geoffroy
mclachlan	mclachlan
sicily	sisilië
cream	room
cream	cream
grimm	grimm
antony	antony
zack	zack
reeves	reeves
finn	finn
cassette	cassette
argentea	argentea
ufo	ufo
sioux	sioux
mendes	mendes
aberdeen	aberdeen
sprague	sprague
platinum	platinum
wikitable	wikitable
castelnau	castelnau
gfdl	gfdl
savoy	savoje
deportivo	deportivo
kleist	kleist
cyprus	cypress
bio	bio
bio	biografie
kuban	koeban
fig	fig
electra	electra
neglecta	neglecta
nervosa	nervosa
trip	uitstappie
morocco	morocco
morocco	marokko
vít	skroewedraaier
garde	garde
trois	trois
camden	camden
tara	tara
shia	shia
airplay	airplay
kwazulu	kwazulu
guthrie	guthrie
eclipse	eclipse
accipitridae	accipitridae
penalty	penalty
penalty	strafskop
sts	sts
pinyin	pinyin
brandon	brandon
hoover	hoover
borgo	borgo
rodney	rodney
alnus	alnus
foo	foo
sida	vigs
littoralis	littoralis
sutton	sutton
zoom	zoem
hance	hance
flynn	flynn
gwangju	gwangju
negros	negros
frontalis	frontalis
lover	lover
honshu	honsjoe
thera	thera
tor	tor
tor	thor
capo	capo
rụi	vermorsel
blyth	blyth
orient	orient
hebrides	hebride
romanov	romanof
eaton	eaton
lakes	mere
natalia	natalia
capitata	capitata
salazar	salazar
diocletianus	diocletianus
gmbh	gmbh
annapolis	annapolis
giles	giles
magister	magister
warwick	warwick
watford	watford
olivacea	olivacea
whole	hele
whole	geheel
râm	skadu
râm	shade
aiton	aiton
milwaukee	milwaukee
edith	edith
indianapolis	indianapolis
noah	noag
noah	noah
chev	chev
gillespie	gillespie
app	toepassing
presley	presley
brook	brook
vhs	vhs
troll	trol
troll	trolle
osiris	osiris
cassius	dio
ethernet	ethernet
peso	pesos
peso	peso
hime	hime
fontainebleau	fontainebleau
perugia	perugia
carvalho	carvalho
muon	wil
myeon	myeon
shock	shock
shock	skok
tutu	tutu
bend	bend
artiodactyla	artiodactyla
tchaikovsky	tchaikovsky
caldwell	caldwell
fusion	fusie
obtusa	obtusa
königsberg	koningsberg
vitex	vitex
coffee	koffie
task	taak
excelsa	excelsa
ger	ger
bak	bak
troia	troia
sulfat	sulfate
tobias	tobias
rivers	riviere
kew	kew
flemish	vlaams
legion	legioen
ala	ala
itf	itf
dash	koppelteken
isis	isis
lowe	lowe
pizza	pizza
shikoku	sjikokoe
cobra	cobra
unicef	unicef
lumia	lumia
kissinger	kissinger
dee	dee
rsa	rsa
hockey	hokkie
spicata	spicata
xỉn	dronk
sars	sars
rémy	rémy
cristatus	cristatus
vic	vic
nico	nico
fed	fed
antoinette	antoinette
jardin	jardin
ramsay	ramsay
nizhny	nizjni
trevor	trevor
limburg	limburg
sherlock	sherlock
dolby	dolby
avatar	avatar
sinatra	sinatra
sumatrana	sumatrana
ivanov	iwanof
chhattisgarh	chhattisgarh
briggs	briggs
julio	julio
emile	emile
ricky	ricky
harald	harald
fortune	fortuin
domodedovo	moskouse
doo	doo
faraday	faraday
tate	tate
rand	rand
rand	randse
baird	baird
arborea	arborea
cristóbal	cristóbal
cana	cana
lucanus	lucanus
wiktionary	wiktionary
erebus	erebos
rowling	rowling
rapid	rapid
potosí	potosí
rhamnus	rhamnus
campestris	campestris
kiribati	kiribati
karlsruhe	karlsruhe
beverly	beverly
goodman	goodman
cowboy	cowboy
samantha	samantha
analog	analoog
kei	kei
memoirs	memoirs
takashi	takashi
shih	shih
kerry	kerry
muller	müller
muller	muller
ramón	ramón
ramón	ramon
horst	horst
merry	geseënde
chirac	chirac
pagan	pagan
mendelssohn	mendelssohn
perseus	perseus
ria	ria
olivia	olivia
speg	speg
dodge	dodge
spike	piek
spike	spike
augustine	augustine
celebensis	celebensis
houghton	houghton
chloris	chloris
horizonte	horizonte
cdma	cdma
aruba	aruba
hawkins	hawkins
burt	burt
avignon	avignon
communis	communis
monarch	monarch
monarch	monargie
olive	olive
olive	olyf
soares	soares
femme	femme
tuva	tiwa
bowman	bowman
marginatus	marginatus
albescens	albescens
kitts	kitts
magellan	magellan
equus	equus
voyage	vaart
calgary	calgary
jena	jena
thessaloniki	thessaloniki
gol	gol
juno	juno
sumner	sumner
bock	bock
haydn	haydn
murad	murat
malik	malik
escape	ontsnap
salon	salon
durban	durban
lama	lama
oswald	oswald
mara	mara
bikini	bikini
ita	ita
mika	mika
ocimum	ocimum
hegel	hegel
maggie	maggie
jürgen	jürgen
jürgen	jurgens
siết	drukkie
visa	visa
francois	francois
francois	françois
button	knoppie
tsushima	tsushima
duc	duc
köhler	köhler
alger	alg
gong	gong
gerd	gerd
qantas	qantas
pet	troeteldier
pet	intelligensie
drum	drum
drum	drom
daewoo	daewoo
merino	merino
martini	martini
clarkson	clarkson
manfred	manfred
varna	warna
amman	amman
nazi	nazi
spartan	spartan
mohr	mohr
tul	tul
jiménez	jiménez
brazilian	brasiliaanse
khabarovsk	chabarofsk
creed	creed
freiherr	freiherr
modestus	modestus
technologies	tegnologieë
ceres	ceres
malfoy	malfoy
trail	trail
trail	spoor
bosco	bosco
shore	shore
lipid	lipied
prentice	prentice
zahn	zahn
chaos	chaos
umbrella	sambreel
candida	candida
karaoke	karaoke
oskar	oskar
taman	taman
ebert	ebert
textcolor	textcolor
zidane	zidane
aziz	aziz
mairie	mairie
cramer	cramer
vargas	vargas
pomerania	pommere
ping	ping
feat	feat
rostock	rostock
marin	marin
ovalis	ovalis
nazareth	nasaret
montbéliard	montbéliard
abs	abs
keller	keller
boyle	boyle
nod	distress
empordà	empordà
spot	vlek
spot	spot
kuznetsov	kuznetsov
dar	dar
matter	mats
rocca	rocca
martial	martial
herodotus	herodotos
schumann	schumann
geun	geun
vidal	vidal
jaya	jaya
melissa	melissa
americanus	americanus
tar	tar
casas	casas
kommun	kommun
roux	roux
braunschweig	brunswyk
riemann	riemann
tribune	tribune
aden	aden
erectus	erectus
uppsala	uppsala
juliet	juliet
elias	elias
angus	angus
horus	horus
cas	cas
cas	cass
hamas	hamas
vfl	vfl
koblenz	koblenz
idf	idf
chevalier	chevalier
systematics	systematics
guillermo	guillermo
palmyra	palmyra
rutherford	rutherford
loc	loc
loc	sl
merriam	merriam
jansen	jansen
schubert	schubert
ensemble	ensemble
ishikawa	ishikawa
frozen	frozen
frozen	bevrore
frozen	gevries
millettia	millettia
poincaré	poincaré
huron	huron
wadi	wadi
cunningham	cunningham
dyer	dyer
shawn	shawn
hesperiidae	hesperiidae
cauca	cauca
vogue	vogue
nouméa	nouméa
josephine	josephine
embraer	embraer
xíu	klein
xíu	tiny
ilyich	ilyich
decatur	decatur
aubin	aubin
centenario	centenario
atlantis	atlantis
dewey	dewey
westmoreland	westmoreland
capra	capra
sepia	sepia
akita	akita
zenit	zenit
canariensis	canariensis
margarita	margarita
soto	soto
dreamworks	dreamworks
oliveira	oliveira
neustadt	neustadt
pamplona	pamplona
kyiv	kyiv
autobiography	outobiografie
bark	bark
bark	bas
bark	blaf
teleostei	teleostei
mêtan	metaan
mack	mack
guru	guru
sanders	sanders
aztec	asteekse
potomac	potomac
cor	cor
nikolay	nikolay
bmp	bmp
bengalensis	bengalensis
garten	garten
stereo	stereo
georgetown	georgetown
fermi	fermi
pedersen	pedersen
lance	lance
gettysburg	gettysburg
perspective	perspektiewe
amd	amd
whois	whois
buren	buren
marmorata	marmorata
vladivostok	wladiwostok
vida	vida
giulia	giulia
nora	nora
dubius	dubius
blogger	blogger
blogger	blogs
stephanie	stephanie
bing	bing
kgb	kgb
kaga	kaga
chapel	kapel
chapel	chapel
marais	marais
maison	maison
ionia	ionië
commentary	commentary
confederations	confederations
spice	spesery
spice	spice
radiohead	radiohead
guttata	guttata
octopus	seekat
reprint	herdruk
severin	severin
zanthoxylum	zanthoxylum
khít	packing
kreis	kreis
sink	sink
yamashita	jamasjita
saskatchewan	saskatchewan
hippolyte	hippolyte
cinnyris	suikerbekkies
antioch	antiogië
bohol	bohol
kaliningrad	kaliningrad
rhodesia	rhodesia
bullock	bullock
bert	bert
