shepard	shepard
zanzibar	zanzibár
lil	lil
dmitry	dmitry
cowan	cowan
randolph	randolph
#tôi	#én
oakland	oakland
toscana	toszkána
ambrose	ambrose
aurelius	aurelius
antioquia	antioquia
sheikh	sejk
gear	tempó
gear	felszerelés
gear	gear
benedict	benedict
benedict	benedek
palmer	palmer
irving	irving
trau	elfáradt
trau	fáradt
bison	bison
bison	bölény
lat	lat
lat	lusta
wigan	wigan
crane	crane
crane	daru
ôtô	autókat
ôtô	autók
ôtô	kocsik
nobilis	nobilis
darren	darren
duméril	duméril
beaver	hód
chopin	chopin
canterbury	canterbury
gerhard	gerhard
ariel	ariel
maxima	maxima
indie	indie
castillo	castillo
kung	kung
beograd	belgrád
martha	martha
bloom	bloom
bloom	virágzik
marius	marius
espírito	espírito
helmut	helmut
avril	avril
khuya	későn
khuya	késő
khuya	késve
suffolk	suffolk
niken	nikkel
beaufort	beaufort
maui	maui
tone	tone
tone	hangnem
rue	rue
ferrari	ferrari
stan	stan
rebel	felkelő
rebel	lázadók
rebel	lázadó
regina	regina
cherry	cherry
cherry	cseresznyés
cherry	cseresznye
cherry	cseresznye
scout	cserkész
scout	felderítő
lozère	lozère
pereira	pereira
bruxelles	brüsszelben
bruxelles	brüsszeli
bruxelles	brüsszel
gaston	gaston
citation	idézés
sakai	sakai
curie	curie
chuck	chuck
dora	dora
aerospace	aerospace
donau	duna
donau	donau
punctatus	punctatus
romagna	romagna
bergen	bergen
hora	hora
vols	vols
scottish	skót
turkish	török
trinity	trinity
shop	műhely
shop	üzlet
shop	bolt
shop	vásárlás
shop	boltok
shop	boltokban
shop	üzletek
roche	roche
gallo	gallo
kafka	kafka
sonora	sonora
leiden	leiden
truncata	truncata
meteor	meteor
hubert	hubert
schumacher	schumacher
bertrand	bertrand
turin	torinói
sylvia	sylvia
valentin	valentin
thriller	thriller
holly	holly
fidel	fidel
ash	hamu
ash	ash
brittany	brittany
gentry	gentry
pohl	pohl
giặt	szennyes
giặt	mosoda
giặt	mosás
giặt	mosott
middlesbrough	middlesbrough
barker	barker
spitfire	spitfire
philipp	philipp
andre	andre
andre	andré
andre	andre
andre	andré
hibiscus	hibiszkusz
barton	barton
pierce	pierce
rfc	rfc
catania	catania
canary	kanári
santana	santana
logroño	logroño
hilton	hilton
spotted	foltos
sexy	szexi
sexy	sexy
vinyl	vinil
cược	fogadás
cược	fogadás
cược	tét
lars	lars
jia	jia
krasnodar	krasznodar
chẻ	lyuk
chẻ	gödör
rainer	rainer
vilnius	vilnius
trieste	trieszt
pharaon	fáraók
phineas	phineas
sirius	sirius
arafat	arafat
bèo	béna
bèo	sánta
leonid	leonyid
fuller	fuller
kino	kino
phoebe	phoebe
concorde	concorde
sec	sec
natalie	natalie
barca	barca
cassini	cassini
halloween	halloween
midland	midland
narcissus	narcissus
nottingham	nottingham
boson	bozon
angelica	angelica
labrador	labrador
mono	mono
charlton	charlton
rót	tölts
sites	helyszínek
sites	oldalak
skin	bőre
skin	bőr
doyle	doyle
cedar	cedar
saturn	szaturnusz
container	tároló
container	tartály
container	konténer
thom	thom
jihlava	jihlava
tít	hallani
nitrat	nitrát
rising	emelkedő
rising	emelkedik
eight	nyolc
cobain	cobain
leigh	leigh
hogg	hogg
cody	cody
mitra	mitra
biếng	lusta
massa	massa
shiva	shiva
shiva	siva
merlin	merlin
anchor	horgony
ascii	ascii
phillip	phillip
surrey	surrey
bolzano	bolzano
martinez	martinez
teaser	kedvcsináló
gill	gill
hilaire	hilaire
globe	globe
edison	edison
orton	orton
nógrád	nógrád
oppenheimer	oppenheimer
sẹo	hegek
sẹo	sebek
sẹo	sebhely
sẹo	sebhely
sẹo	sebzett
sẹo	heg
bravo	bravo
tahiti	tahiti
bauer	bauer
eurovision	eurovíziós
eurovision	eurovision
vittata	vittata
hopper	hopper
goa	goa
nicholson	nicholson
dhabi	dhabi
soft	puha
soft	lágy
laguna	laguna
theodosius	theodosius
coca	kóla
coca	kokó
coca	coca
králové	králové
estadio	estadio
pixel	képpont
pixel	képpontok
pixel	képpont
jörg	jörg
brevis	brevis
breed	fajta
lcd	lcd
sphinx	szfinx
anemone	szellőrózsa
rogue	gazember
crimea	krím
breslau	breslau
bonus	prémium
bonus	bónusz
điốt	dióda
abkhazia	abházia
mồm	szád
mồm	száj
burma	burma
burma	burmai
pepper	pepper
pepper	bors
pepper	paprika
baptist	baptista
griff	griff
koh	koh
dome	búra
ramsey	ramsey
infinity	végtelen
hayes	hayes
lombard	lombard
bịp	trick
bịp	trükk
molina	molina
forrest	forrest
chòi	kunyhó
chòi	kabin
composite	kompozit
composite	összetett
andrés	andrés
medieval	középkori
cornelius	cornelius
tvxq	tvxq
brie	brie
robbie	robbie
sally	sally
tolna	tolna
pardubice	pardubice
zurich	zürich
choáng	döbbenve
choáng	szétzúzza
choáng	kábító
mứt	jam
mứt	lekvár
mứt	lekvár
patton	patton
drew	rajzolt
drew	drew
drew	rajzolta
bernhard	bernhard
hpa	hpa
benny	benny
cherokee	cherokee
hindenburg	hindenburg
smile	mosoly
attila	attila
leverkusen	leverkusen
tbilisi	tbiliszi
plutoni	plutónium
rochester	rochester
rugby	rögbi
kira	kira
kaoru	wada
marguerite	marguerite
laden	terhelt
laden	laden
benito	benito
aka	alias
ramesses	ramszesz
ngứa	viszketés
ngứa	karmai
ngứa	karmok
aeroflot	aeroflot
rebecca	rebecca
satoshi	satoshi
stones	stones
stones	kövek
panorama	panorama
schultz	schultz
prop	kellék
trumpet	trombita
martens	martens
pot	fű
pot	füvet
pot	füves
patterson	patterson
obi	obi
alma	alma
bốt	bakancs
bốt	csizma
gsm	gsm
homer	homer
weasley	weasley
myers	myers
kombat	kombat
allegheny	allegheny
hub	hub
tivi	tv
tivi	televízió
prinz	prinz
gifford	gifford
argentine	argentína
argentine	argentin
benin	benin
sar	sar
intercontinental	intercontinental
aquino	aquino
tina	tina
saddam	szaddám
mystery	titokzatos
mystery	rejtély
mystery	rejtélyes
ruth	ruth
carolyn	carolyn
monde	monde
beetle	bogár
picasso	picasso
bien	látható
bien	bien
bien	égbolt
bien	ég
hoffmann	hoffmann
hinton	hinton
heather	heather
geo	geo
sussex	sussex
joey	joey
nuremberg	nürnberg
silicon	szilícium
silicon	szilikon
silicon	szilikon
isabel	isabel
damascus	damaszkusz
highland	highland
avenue	avenue
avenue	sugárút
alegre	alegre
anemia	vérszegénység
schwarzenegger	schwarzenegger
chatham	chatham
una	una
niels	niels
fountain	szökőkút
fountain	kút
havlíčkův	havlíčkův
vaucluse	vaucluse
smackdown	összecsapás
smackdown	smackdown
smackdown	leszámolás
sinai	sinai
huelva	huelva
albus	albus
beckham	beckham
reyes	reyes
gin	gin
gin	gint
camille	camille
wendy	wendy
blackwell	blackwell
oxit	oxid
echo	visszhang
echo	echo
sever	sever
tbs	tbs
holiday	vakáció
holiday	ünnep
holiday	ünnepi
holiday	nyaralás
dornier	dornier
chocolate	csoki
chocolate	csokoládé
transistor	tranzisztor
timur	timur
hemingway	hemingway
táp	harapás
spl	spl
hybrid	hibrid
bittorrent	bittorrent
gibbs	gibbs
canis	canis
battlefield	csatatéren
pushkin	puskin
neutrino	neutrínó
elton	elton
griswold	griswold
fiat	fiat
circus	cirkusz
circus	cirkuszban
subspecies	alfaj
montpellier	montpellier
atatürk	atatürk
dawson	dawson
stress	stressz
sei	zay
tak	tak
pattern	minta
greece	görögország
oliva	oliva
brain	agy
ferb	ferb
landmark	nevezetesség
benešov	benešov
levant	levant
vila	vila
sapporo	sapporo
bazan	bazan
buchanan	buchanan
alive	élve
alive	életben
alive	él
rodriguez	rodriguez
cent	centes
cent	cent
sandy	homokos
sandy	sandy
fra	fra
cuốc	random
cuốc	véletlenszerű
cuốc	véletlen
cuốc	kapa
ftp	ftp
desmond	desmond
terra	tera
terra	terra
tudor	tudor
neville	neville
pal	pal
champs	champs
champs	bajnokok
charmed	bűbájos
ceylon	ceylon
menu	menü
menu	menük
kelvin	kelvin
klug	klug
poltava	poltava
sergio	sergio
hawking	hawking
pitt	pitt
trier	trier
sistema	sistema
medium	közepes
jakob	jakob
somali	szomália
somali	szomáliai
somali	szomália
somali	szomáliai
shane	shane
cal	cal
cool	király
cool	menő
hardcore	kőkemény
hardcore	hardcore
waltz	keringő
moreno	moreno
telegraph	telegraph
milk	tejjel
milk	tej
milk	tejet
stadion	stadion
daphne	daphne
jackie	jackie
livingston	livingston
wollaston	wollaston
thierry	thierry
serena	serena
graz	graz
malus	malus
flo	flo
mons	mons
cessna	cessna
quest	küldetés
kangaroo	kenguru
kangaroo	kenguru
kangaroo	kenguruk
chrome	króm
ismail	ismail
saratoga	saratoga
irkutsk	irkutszk
isla	isla
alejandro	alejandro
friuli	friuli
lancashire	lancashire
infinite	végtelen
castello	castello
myspace	myspace
saab	saab
zhao	zao
draco	draco
gloucester	gloucester
bács	bács
puget	puget
hamburger	hamburger
hamburger	hamburger
sarajevo	szarajevó
breda	breda
marvin	marvin
lift	emelés
inn	fogadó
inn	inn
inn	szálló
sonny	sonny
neill	neill
esp	esp
aguilar	aguilar
gore	gore
sega	sega
kiskun	kiskun
phuket	phuket
donna	donna
kauai	kauai
halle	halle
blansko	blansko
ulrich	ulrich
gap	hézag
gap	szakadék
gap	rés
beaumont	beaumont
hàu	osztriga
hàu	osztrigát
hàu	osztriga
hàu	osztrigát
#the	#az
#the	#a
erie	erie
ogg	ogg
ulsan	ulszan
frances	frances
adriatic	adriai
adriatic	adria
viva	viva
cafe	kávét
cafe	kávé
cafe	café
cafe	cafe
cafe	kávézó
assassin	orgyilkos
assassin	bérgyilkos
assassin	merénylő
farm	farm
farm	gazdaság
kwang	kwang
vanilla	villám
vanilla	mennydörgés
vanilla	vanília
vanilla	vaníliás
société	société
extreme	szélsőséges
extreme	extrém
bilbao	bilbao
bun	bolgár
bun	logikai
auschwitz	auschwitz
multi	multi
wiedemann	wiedemann
newark	newark
armour	páncélos
armour	páncél
woody	woody
fat	zsír
fat	zsírok
fat	fat
fat	kövér
andrey	andrej
corleone	corleone
mẹo	tipp
mẹo	tanácsok
mẹo	tippek
mẹo	tipp
mẹo	füles
pegasus	pegasus
seymour	seymour
haw	haw
browne	browne
wilde	wilde
glycine	glicin
plato	platón
olympus	olympus
tashkent	taskent
lex	lex
fukushima	fukusima
episodes	epizódjainak
episodes	epizódok
episodes	epizód
muñoz	muñoz
herb	gyógynövény
herb	herb
ringo	ringo
nicola	nicola
burgundy	burgundy
renault	renault
mew	mew
minami	minami
stub	szelvény
avengers	angyalok
weiss	weiss
rousseau	rousseau
augsburg	augsburg
switch	váltás
switch	kapcsoló
switch	kapcsolót
herald	herald
fide	fide
dickinson	dickinson
melanie	melanie
holloway	holloway
hume	hume
muse	múzsa
chamberlain	chamberlain
bruch	bruch
gala	gála
kazakh	kazah
bye	szia
cằm	chin
cằm	csin
pioneer	úttörő
paula	paula
toulon	toulon
romano	romano
wizard	mágus
wizard	varázsló
zander	zander
selim	selim
damian	damian
bedford	bedford
haifa	haifa
cash	készpénz
cash	készpénzben
cash	pénzt
sorbonne	sorbonne
lugo	lugo
runner	futó
teo	teo
villanueva	villanueva
twilight	hajnal
twilight	alkonyat
twilight	alkony
kenji	kenji
entropy	entrópia
nur	nur
voltaire	voltaire
robson	robson
mask	maszk
mask	maszkot
cluj	kolozsvári
sinclair	sinclair
asparagus	spárga
rojas	rojas
salmon	lazac
dahl	dahl
charlemagne	charlemagne
heathrow	heathrow
jenkins	jenkins
minneapolis	minneapolis
pack	falka
pack	csomagolás
pack	csomag
pack	pack
tbd	tbd
machado	machado
modena	modena
lions	oroszlán
lions	oroszlánok
buckingham	buckingham
kitty	kitty
kitty	cica
samara	samara
petersen	petersen
mona	mona
elsa	elsa
madeleine	madeleine
baba	baba
saunier	saunier
campagne	campagne
nagano	nagano
spielberg	spielberg
kana	kana
coventry	coventry
pbs	pbs
pau	pau
taub	taub
svitavy	svitavy
lhasa	lhasa
ito	ito
calvert	calvert
bethune	béthune
polymer	polimer
nolan	nolan
fitzgerald	fitzgerald
treviso	treviso
mama	mama
romeo	romeo
romeo	rómeó
didier	didier
liguria	liguria
joyce	joyce
wai	wai
meet	találkozni
meet	találkozó
alexis	alexis
kin	kin
avenger	bosszúálló
greenwich	greenwich
caserta	caserta
kinabalu	kinabalu
revue	revü
titus	titus
messenger	futár
messenger	hírnök
messenger	messenger
lagos	lagos
stream	patak
petra	petra
palmas	palmas
gatwick	gatwick
oldenburg	oldenburg
jacobs	jacobs
ngẫm	rágja
ngẫm	rágni
reims	reims
ensign	zászlós
nưa	többé
sio	sio
ericsson	ericsson
achilles	achilles
achilles	achille
phalanx	phalanx
gerard	gérard
gerard	gerrard
gerard	gerard
bergman	bergman
cast	öntött
cast	gipsz
ortiz	ortiz
constance	constance
boca	boca
nếm	íze
ski	síelés
ski	sí
guetta	guetta
dhaka	dhaka
framework	keretében
framework	keretrendszer
framework	keret
amour	amour
amor	amor
zara	zara
richelieu	richelieu
snape	piton
cappadocia	kappadókia
michele	michele
swansea	swansea
guadalupe	guadalupe
españa	españa
mendoza	mendoza
judo	judo
sira	sira
myung	myung
tunis	tunisz
nigel	nigel
sue	sue
garfield	garfield
aff	aff
hermes	hermes
alicia	alicia
eindhoven	eindhoven
archipelago	szigetcsoport
gogh	gogh
jedi	jedi
jedi	jedik
iglesias	iglesias
nirvana	nirvana
harley	harley
wanted	akartam
wanted	körözött
survivor	túlélő
reno	reno
nháp	vázlat
nháp	tervezetét
nháp	huzat
nháp	tervezet
roque	roque
chát	kíméletlen
chát	durva
chát	társalgás
chát	beszélgetés
chát	chat
chát	csevegés
lahore	lahore
melody	dallam
melody	melody
beretta	beretta
sterling	sterling
chambers	chambers
mari	mari
sikh	szikh
humbert	humbert
corsair	corsair
vaux	vaux
ivy	borostyán
ivy	ivy
northampton	northampton
judith	judit
shirley	shirley
michelangelo	michelangelo
nairobi	nairobi
cate	cate
cate	caitlin
xui	szerencsétlen
lou	lou
advance	előleg
advance	előre
boulogne	boulogne
pulitzer	pulitzer
pocket	zseb
pocket	zsebében
akbar	akbar
sandra	sandra
buch	buch
elite	elit
acad	acad
mesnil	mesnil
angry	dühös
angry	mérges
lisboa	lisszabon
lisboa	lisszaboni
lisboa	lisbon
cotton	gyapot
cotton	pamut
stamford	stamford
faust	faust
klm	klm
kansai	kansai
oval	ovális
marca	marca
mannheim	mannheim
mannheim	manheim
everest	everest
nationale	nationale
ida	ida
berber	berber
atm	atm
deutsch	deutsch
cantor	cantor
dorset	dorset
dover	dover
avia	avia
tarsus	tarsus
bohr	bohr
lamb	lamb
lamb	bárány
noir	noir
brezhnev	brezsnyev
bray	bray
giỏ	zseb
giỏ	zsebében
giỏ	kosár
giỏ	kosár
giỏ	kosarak
sap	sap
lauren	lauren
marta	marta
tạt	mustár
ars	ars
iana	iana
hana	hana
scipio	scipio
tristan	tristan
cascade	cascade
howe	howe
saunders	saunders
wyatt	wyatt
katherine	katherine
manitoba	manitoba
cật	vese
almeida	almeida
eliot	eliot
tea	tea
tea	teát
stern	szigorú
stern	stern
chrudim	chrudim
teddy	teddy
marek	marek
alien	idegen
alien	űrlény
schindler	schindler
lydia	lydia
fun	móka
fun	szórakozás
kumamoto	kumamoto
jungle	dzsungel
jungle	dzsungelben
lorenz	lorenz
hillary	hillary
wolfram	volfrám
clermont	clermont
dalton	dalton
gottfried	gottfried
stephens	stephens
genie	dzsinn
mangan	mangán
byrne	byrne
lesser	kisebb
suceava	suceava
bluetooth	bluetooth
compton	compton
mgm	mgm
brock	brock
conway	conway
msn	msn
schuster	schuster
fleming	fleming
rodrigues	rodrigues
topo	topo
snyder	snyder
glucose	glükóz
credit	hitel
credit	kredit
carrie	carrie
classics	klasszikusokat
axel	axel
corp	corp
punic	pun
molotov	molotov
vieux	vieux
novosibirsk	novoszibirszk
frost	frost
frost	fagy
bratislava	pozsony
utrecht	utrecht
herschel	herschel
munro	munro
endangered	veszélyeztetett
lausanne	lausanne
jacqueline	jacqueline
café	café
café	cafe
café	kávézó
café	kávézó
café	café
norris	norris
freiburg	freiburg
sui	sui
litoměřice	litoměřice
amadeus	amadeus
gekko	gekko
nikita	nikita
giacomo	giacomo
dudley	dudley
pleasant	kellemes
davy	davy
magdalena	magdolna
magdalena	magdalena
arras	arras
điếc	süket
điếc	süketek
điếc	siket
lupus	lupus
xxi	xxi
occidental	occidental
concept	elképzelés
concept	koncepció
concept	fogalom
archimedes	arkhimédész
neu	neu
casino	kaszinóban
casino	casino
casino	kaszinó
marilyn	marilyn
vincennes	vincennes
hyde	hyde
fejér	fejér
cabin	kunyhó
cabin	kabin
simone	simone
ulysses	ulysses
gifu	gifu
rệp	poloskák
rệp	rovarok
rệp	bogarak
rệp	görény
sina	sina
bourg	bourg
sacramento	sacramento
genji	genji
lecco	lecco
wallis	wallis
hoét	rigó
jericho	jericho
thatcher	thatcher
byron	byron
vandal	vandál
khz	khz
faber	faber
ying	ying
zip	irányítószám
zip	zip
kharkiv	harkov
toni	toni
moravia	morvaországi
fermat	fermat
raoul	raoul
wiener	virsli
wiener	wiener
colt	colt
danzig	danzig
clarence	clarence
pitbull	pitbull
watt	watt
watt	watts
yoko	yoko
livingstone	livingstone
caracas	caracas
ned	ned
bomb	bomba
sarkozy	sarkozy
jerzy	jerzy
koi	koi
durand	durand
pole	rúd
judy	judy
astronomy	csillagászat
astronomy	csillagászati
crassus	crassus
pom	pom
mầu	színek
mầu	színes
mầu	színe
mầu	szín
poker	póker
shaun	shaun
higgins	higgins
tal	tal
aya	aya
vẫy	integet
vẫy	risza
meade	meade
dorothy	dorothy
mcmahon	mcmahon
hartley	hartley
epstein	epstein
jobs	állás
jobs	állások
jobs	munkahelyek
safari	szafari
atr	atr
bonnie	bonnie
campobasso	campobasso
gnome	gnome
terre	terre
guild	céh
rumble	rumble
novo	novo
vita	vita
nantes	nantes
stay	maradj
psyche	psziché
worms	férgek
stefano	stefano
enrico	enrico
mei	mei
nháy	villanás
nháy	flash
nháy	villám
nháy	ütő
calhoun	calhoun
alfredo	alfredo
castilla	kasztília
dayton	dayton
bougainville	bougainville
thun	thun
vulcan	vulkán
superman	superman
corbett	corbett
champ	bajnok
saints	szentek
pall	pall
aves	aves
perez	perez
jerome	jerome
rapunzel	rapunzel
yucca	yucca
clemens	clemens
gupta	gupta
trọc	kopasz
trọc	skinhead
als	als
neal	neal
sạc	töltő
sạc	töltés
sạc	töltés
fossil	fosszilis
bart	bart
karachi	karacsi
cactus	kaktusz
bourne	bourne
esther	eszter
esther	esther
leroy	leroy
cdp	cdp
laurence	laurence
dinamo	dinamo
lester	lester
carson	carson
ichi	ichi
doug	doug
scinax	scinax
aoi	aoi
arroyo	arroyo
alpine	alpesi
henrik	henrik
sicily	szicília
sicily	szicíliai
sicily	szicíliai
cream	tejszín
cream	krém
cream	krémet
grimm	grimm
antony	antonius
zack	zack
reeves	reeves
finn	finn
cassette	kazettát
cassette	kazetta
zlín	zlín
ufo	ufó
ufo	ufo
sioux	sziúk
mendes	mendes
cristiano	cristiano
aberdeen	aberdeen
sprague	sprague
platinum	platina
kladno	kladno
arad	arad
savoy	savoy
kleist	kleist
cyprus	cypress
bio	bio
fig	füge
electra	electra
trip	kirándulás
trip	utazás
trip	trip
trip	kiruccanás
trip	tripp
morocco	marokkóban
morocco	marokkó
garde	garde
trois	trois
camden	camden
tara	tara
shia	shia
guthrie	guthrie
eclipse	napfogyatkozás
tap	versenyző
penalty	szankció
penalty	büntető
penalty	büntetés
sts	sts
brandon	brandon
ozu	ozu
hoover	hoover
borgo	borgo
foo	foo
sida	aids
sutton	sutton
zoom	zoom
flynn	flynn
gwangju	gwangju
lover	szerető
kirov	kirov
tor	tor
tor	thor
capo	capo
rụi	zúzott
rụi	összetört
orient	orient
hebrides	hebridák
romanov	romanov
eaton	eaton
lakes	tavak
natalia	natalia
salazar	salazar
gmbh	gmbh
annapolis	annapolis
abrams	abrams
giles	giles
magister	tanácsos
warwick	warwick
watford	watford
whole	egészben
whole	egész
aid	támogatás
aid	segély
aid	támogatások
râm	árnyék
milwaukee	milwaukee
edith	edith
indianapolis	indianapolis
noah	noé
noah	noah
chev	chev
caucasus	kaukázusi
gillespie	gillespie
lynx	hiúz
app	app
app	alkalmazás
presley	presley
brook	brook
vhs	vhs
troll	troll
troll	trollok
osiris	ozirisz
cassius	cassius
ethernet	ethernet
peso	peso
peso	peso
hime	hime
fontainebleau	fontainebleau
perugia	perugia
carvalho	carvalho
muon	akarsz
muon	akar
muon	akarod
muon	akarom
shock	sokk
tutu	tutu
bend	kanyar
tchaikovsky	csajkovszkij
caldwell	caldwell
fusion	fúzió
fusion	fúziós
xoang	sinus
fyodor	fjodor
kat	kat
coffee	kávét
coffee	kávé
task	feladat
ger	ger
sulfat	szulfát
tobias	tobias
pla	pla
iroquois	irokézek
rivers	folyók
rivers	rivers
kew	kew
flemish	flamand
sorex	cickány
legion	légió
ala	ala
itf	itf
dash	dash
isis	isis
trek	trek
lowe	lowe
pizza	pizzát
pizza	pizza
cobra	kobra
naraku	naraku
unicef	unicef
kissinger	kissinger
dee	dee
rsa	rsa
argeș	argeș
hockey	jégkorong
hockey	hoki
xỉn	ittas
xỉn	részegen
xỉn	részeg
bow	íj
sars	sars
rémy	remy
rémy	rémy
vic	vic
nico	nico
fed	fed
fed	táplált
antoinette	antoinette
pzl	pzl
jardin	jardin
ramsay	ramsay
trevor	trevor
limburg	limburg
sherlock	sherlock
avatar	avatár
sinatra	sinatra
ivanov	ivanov
briggs	briggs
julio	julio
emile	emile
ricky	ricky
reader	olvasó
harald	harald
fortune	vagyon
fortune	szerencse
fortune	vagyont
doo	doo
faraday	faraday
tate	tate
rand	rand
baird	baird
arborea	arborea
rubin	rubin
cana	cana
erebus	erebus
rowling	rowling
rapid	rapid
clyde	clyde
campestris	campestris
kiribati	kiribati
karlsruhe	karlsruhe
beverly	beverly
goodman	goodman
cowboy	cowboy
samantha	samantha
analog	analóg
kei	kei
memoirs	emlékiratait
ourense	ourense
takashi	takashi
shih	shih
kerry	kerry
muller	müller
muller	müller
ramón	ramón
ramón	ramón
ramón	ramon
horst	horst
merry	víg
pagan	pogány
pagan	hitetlen
pagan	hitetlenek
mendelssohn	mendelssohn
perseus	perszeusz
ria	ria
olivia	olivia
dodge	dodge
spike	tüskés
spike	spike
augustine	augustine
houghton	houghton
matsumoto	matsumoto
gangnam	gangnam
cdma	cdma
aruba	aruba
hawkins	hawkins
burt	burt
avignon	avignon
communis	communis
monarch	uralkodó
sala	sala
olive	olive
olive	olajbogyó
femme	femme
tuva	tuva
bowman	bowman
kitts	készletek
kitts	készlet
kitts	kitts
magellan	magellán
klatovy	klatovy
equus	equus
agnes	agnes
agnes	ágnes
dốt	tudatlan
dốt	tudatlanság
calgary	calgary
thessaloniki	thesszaloniki
tetra	tetra
juno	juno
sumner	sumner
bock	bock
dalmatia	dalmácia
haydn	haydn
malik	malik
escape	szökés
escape	menekülés
escape	megszökni
salon	szalonok
salon	szalon
salon	szalonban
durban	durban
lama	láma
oswald	oswald
mara	mara
bikini	bikini
ita	ita
mika	mika
lia	lia
hegel	hegel
maggie	maggie
jürgen	jürgen
siết	ölelés
visa	vízum
francois	francois
francois	françois
francois	francois
francois	françois
button	gombot
button	gomb
duc	duc
alger	alga
gong	gong
natsu	natsu
rostrata	rostrata
pompey	pompeius
gerd	gerd
qantas	qantas
pet	pet
pet	háziállat
pet	kisállat
pet	értelem
pet	hírszerzés
pet	intelligencia
drum	dob
daewoo	daewoo
martini	martini
clarkson	clarkson
manfred	manfred
amman	amman
nazi	fasiszta
nazi	nácik
nazi	náci
spartan	spártai
mohr	mohr
tởm	gusztustalan
tởm	undorító
jiménez	jiménez
brazilian	brazil
brazilian	brazília
khabarovsk	habarovszk
creed	creed
technologies	technológiák
ceres	ceres
malfoy	malfoy
trail	ösvény
bosco	bosco
shore	partra
shore	part
shore	shore
lipid	lipid
yamagata	jamagata
kaze	kaze
prentice	prentice
zahn	zahn
billie	billie
chaos	káosz
umbrella	esernyő
candida	candida
karaoke	karaoke
oskar	oskar
macon	macon
zidane	zidane
aziz	aziz
cramer	cramer
vargas	vargas
pomerania	pomeránia
ping	ping
rostock	rostock
marin	marin
nazareth	názáreti
plana	plana
montbéliard	montbéliard
abs	abs
keller	keller
boyle	boyle
nod	segélykérő
empordà	empordà
spot	folt
spot	foltos
kuznetsov	kuznyecov
cctv	cctv
dar	dar
crataegus	crataegus
matter	mats
rocca	rocca
martial	martial
herodotus	hérodotosz
schumann	schumann
kyu	kyu
vidal	vidal
jaya	jaya
melissa	melissa
tar	kátrány
mureș	mureș
casas	casas
roux	roux
braunschweig	braunschweig
tribune	tribune
aden	aden
uppsala	uppsala
juliet	juliet
juliet	júlia
elias	elias
angus	angus
horus	hórusz
cas	cas
cas	cas
cas	cass
hamas	hamász
reinhard	reinhard
vfl	vfl
koblenz	koblenz
chevalier	chevalier
guillermo	guillermo
rutherford	rutherford
loc	loc
merriam	merriam
jansen	jansen
schubert	schubert
ensemble	együttes
frozen	fagyasztva
frozen	fagyott
frozen	fagyasztott
poincaré	poincaré
huron	huron
cunningham	cunningham
dyer	dyer
shawn	shawn
cauca	cauca
vogue	vogue
josephine	josephine
xíu	kicsi
xíu	pici
xíu	apró
ilyich	iljics
decatur	decatur
aubin	aubin
vitebsk	vicebszk
atlantis	atlantisz
dewey	dewey
westmoreland	westmoreland
sulu	sulu
capra	capra
barbuda	barbuda
akita	akita
zenit	zenit
margarita	margarita
soto	soto
dreamworks	dreamworks
charter	charta
oliveira	oliveira
neustadt	neustadt
geoff	geoff
pamplona	pamplona
autobiography	önéletrajzát
bark	kéreg
mêtan	metán
mack	mack
guru	guru
sanders	sanders
aztec	azték
potomac	potomac
cor	rb
spy	hányás
clem	clem
bmp	bmp
garten	garten
stereo	sztereó
murcia	murcia
georgetown	georgetown
fermi	fermi
mcgraw	mcgraw
falco	falco
pedersen	pedersen
lance	lance
lance	lándzsa
gettysburg	gettysburg
dal	dal
buren	buren
pulcher	pulcher
vladivostok	vlagyivosztok
vida	vida
giulia	giulia
nora	nora
geum	geum
blogger	blogger
blogger	blogok
stephanie	stephanie
bing	bing
shotgun	puska
shotgun	puskát
kgb	kgb
kaga	kaga
chapel	kápolna
marais	marais
maison	maison
commentary	kommentár
spice	fűszerek
spice	fűszer
radiohead	radiohead
octopus	polip
severin	severin
khít	csomagolás
khít	csomagoló
sink	cink
saskatchewan	saskatchewan
hippolyte	hippolyte
nubia	núbia
rhodesia	rodézia
bullock	bullock
bert	bert
makarov	makarov
harmony	harmónia
harmony	harmony
diaz	diaz
vầng	golden
vầng	arany
gui	gui
odyssey	odüsszeia
ngo	ngo
tethys	tethys
kuiper	kuiper
progressive	fokozatos
progressive	haladó
progressive	progresszív
davidson	davidson
murakami	murakami
hammond	hammond
hastings	hastings
patagonia	patagonia
larson	larson
gaya	gaya
gaya	gaia
olsen	olsen
fairfield	fairfield
fairchild	fairchild
biella	biella
consolidated	összevont
consolidated	konszolidált
boyer	boyer
găm	tőr
ava	ava
riyadh	rijád
booth	fülke
booth	booth
cristina	cristina
plc	plc
gerrard	gerrard
negro	néger
rum	rumot
rum	rum
argus	argus
vasco	vasco
leibniz	leibniz
mandalay	mandalay
mahmoud	mahmoud
anthology	anthology
ishida	ishida
pia	pia
gorky	gorkij
steam	gőz
steam	gőzzel
helgoland	helgoland
spa	fürdő
spa	spa
spa	gyógyfürdő
spa	wellness
punta	punta
huntington	huntington
styles	styles
pool	pol
boyd	boyd
tornado	tornádó
vin	vin
dmt	dmt
montagne	montagne
keane	keane
chorus	kórus
maluku	maluku
brahms	brahms
aphrodite	aphrodité
lone	lone
paso	paso
dolly	dolly
paxton	paxton
char	char
kramer	kramer
wushu	wushu
genesis	genesis
corinth	corinth
frosinone	frosinone
nissan	nissan
namur	namur
mir	mir
gabrielle	gabrielle
dagestan	dagesztán
mogul	mogul
fernandez	fernandez
vader	vader
władysław	władysław
gustaf	gustaf
peterson	peterson
garrett	garrett
vent	szellőző
reuters	reuters
nilsson	nilsson
rình	zaklatás
rình	zaklató
aladdin	aladdin
officinalis	officinalis
gpl	gpl
piccolo	piccolo
josep	josep
abruzzo	abruzzo
clifford	clifford
worlds	vb
worlds	világok
providence	providence
psp	psp
clare	clare
generic	általános
generic	generikus
emberiza	sármány
ploceus	weaver
carlton	carlton
malmö	malmö
sampson	sampson
daniels	daniels
nymburk	nymburk
papa	papa
vitis	vitis
sha	sha
brady	brady
identity	személyazonosság
identity	személyazonosságát
identity	identitás
launch	kilövés
launch	indítás
telescope	teleszkóp
destroyer	pusztító
destroyer	romboló
rodgers	rodgers
dolphin	delfin
dolphin	delfinek
swing	swing
kern	kern
pavlov	pavlov
syracuse	syracuse
martins	martins
moritz	moritz
frederik	frederik
buena	buena
aleksey	alekszej
squad	brigád
squad	osztag
kuroda	kuroda
coleman	coleman
wilhelmshaven	wilhelmshaven
baikal	bajkál
liszt	liszt
oro	oro
steiner	steiner
mackenzie	mackenzie
regan	regan
steroid	szteroidok
steroid	szteroid
steroid	szteroidok
steroid	szteroid
scene	uml
dakar	dakar
ipod	ipod
atkinson	atkinson
abd	abd
packard	packard
arlington	arlington
kessler	kessler
exeter	exeter
sedgwick	sedgwick
fax	fax
fax	faxon
brotherhood	testvériség
flavius	flavius
tampa	tampa
stevie	stevie
siegfried	siegfried
vat	áfa
vat	vizes
vat	nedves
poseidon	poszeidón
liberec	liberec
buzău	buzău
mateo	matteo
mateo	mateo
