kwazulu	kwazulu
eclipse	கிரகணம்
accipitridae	accipitridae
penalty	வேதனை
penalty	தண்டனை
sts	sts
brandon	பிராண்டன்
hoover	ஹூவர்
rodney	ரோட்னி
sida	எய்ட்ஸ்
zoom	பெரிதா
zoom	பெரிதாக
lover	காதலர்
lover	காதலன்
honshu	ஒன்சூ
thera	thera
tor	tor
tor	தோர்
capo	capo
rụi	நசுக்கி
blyth	blyth
orient	கிழக்கு
hebrides	hebrides
lakes	ஏரிகள்
warwick	வார்விக்
râm	நிழலில்
râm	நிழலும்
râm	நிழல்
râm	சாயல்
milwaukee	மில்வாகி
edith	எடித்
noah	நோவா
lynx	lynx
ayuntamiento	ayuntamiento
app	பயன்பாட்டை
app	பயன்பாடு
app	பயன்பாட்டைப்
app	செயலி
brook	புரூக்
vhs	விஎச்எஸ்
sora	சோரா
ethernet	ஈதர்நெட்
peso	பெசோ
keng	கெங்
muon	வேணும்
muon	விரும்புகிறேன்
muon	வேண்டுமா
muon	விரும்பும்
muon	வேண்டும்
shock	அதிர்ச்சி
tutu	tutu
serviceyears	serviceyears
bend	வளைத்து
caldwell	கால்டுவெல்
xoang	சைனஸ்
fyodor	பியோதர்
kat	கேட்
vitex	கருநொச்சி
coffee	காபி
coffee	காப்பி
coffee	காஃபி
task	பணி
excelsa	excelsa
bak	bak
sulfat	சல்பேட்டு
tobias	டோபியாஸ்
pla	pla
rivers	நதிகள்
rivers	ஆறுகள்
kew	kew
sorex	மூஞ்சூறு
ala	ஆலா
cctld	cctld
dash	dash
isis	isis
trek	ட்ரெக்
lowe	லோவ்
pizza	பீசா
pizza	பீட்சா
cobra	நாகம்
cobra	கோப்ரா
unicef	unicef
lumia	லூமியா
dee	டீ
rsa	rsa
hockey	ஹாக்கி
xỉn	குடித்து
xỉn	குடித்துவிட்டு
cristatus	cristatus
vic	விக்
nico	நிகோ
kuril	கூரில்
ramsay	ramsay
nizhny	nizhny
trevor	டிரெவர்
sherlock	sherlock
avatar	அவதாரம்
avatar	அவதார்
chhattisgarh	சத்தீஸ்கர்
julio	ஜூலியோ
ricky	ரிக்கி
reader	வாசகர்
fortune	அதிர்ஷ்ட
doo	டூ
rand	rand
rand	குறிப்பிலா
baird	பைர்டு
arborea	arborea
cana	கனா
lesnar	லெஸ்னர்
pteropus	pteropus
rowling	ரௌலிங்
kiribati	கிரிபட்டி
karlsruhe	karlsruhe
beverly	பெவர்லி
goodman	குட்மேன்
samantha	சமந்தா
kei	கெய்
memoirs	memoirs
kerry	கெர்ரி
muller	முல்லர்
muller	முல்லர்
ramón	ரமோன்
pagan	பேகன்
perseus	பெர்சியஸ்
olivia	ஒலிவியா
spike	ஸ்பைக்
gangnam	கங்னம்
horizonte	அரிசாஞ்ச்
cdma	cdma
aruba	அரூபா
hawkins	ஹாக்கின்ஸ்
avignon	avignon
communis	communis
monarch	அரசன்
sala	சாலா
olive	ஆலிவ்
beo	beo
soares	சோர்ஸ்
femme	femme
kitts	kits
kitts	கிட்ஸ்
magellan	மகலன்
equus	equus
calgary	கால்கரி
tetra	டெட்ரா
juno	ஜூனோ
murad	முராத்
malik	மலிக்
malik	மாலிக்
escape	எஸ்கேப்
salon	நிலையங்கள்
salon	சலூன்
durban	டர்பன்
lama	லாமா
oswald	ஒஸ்வால்ட்
mara	மாரா
bikini	பிகினி
ita	ita
lia	லியா
hegel	hegel
maggie	மேகி
bua	bua
siết	அரவணைப்பு
siết	அணைப்பு
visa	விசா
francois	பிரான்சுவா
francois	பிரான்சுவா
button	பொத்தான்
button	பட்டன்
saline	saline
alger	பாசி
gong	gong
subtemplates	subtemplates
qantas	குவாண்டாஸ்
pet	உளவுத்துறை
pet	புலனாய்வு
pet	நுண்ணறிவு
drum	ட்ரம்
pygmaeus	pygmaeus
martini	மார்டினி
manfred	manfred
amman	அம்மன்
nazi	பாசிச
nazi	நாசி
brazilian	பிரேசிலிய
technologies	தொழில்நுட்பங்கள்
ceres	சிரிஸ்
lag	lag
trail	வழி
bosco	போஸ்கோ
chaos	குழப்பம்
chaos	குழப்பமான
umbrella	குடை
taman	தாமான்
ebert	ebert
textcolor	textcolor
aziz	அசிஸ்
ping	பிங்
ping	ping
marin	மரின்
nazareth	நாசரேத்து
abs	abs
keller	கெல்லர்
nod	துன்பத்தை
spot	ஸ்பாட்
spot	நீக்கம்
garrulax	laughingthrush
martial	தற்காப்புக்
herodotus	எரோடோட்டசு
schumann	சூமான்
jaya	ஜெயா
jaya	ஜயா
melissa	மெலிசா
tar	டார்
tar	தார்
erectus	erectus
#ông	#திரு
uppsala	உப்சாலா
juliet	ஜூலியட்
elias	எலியாஸ்
cas	cas
cas	காஸ்
hamas	ஹமாஸ்
chevalier	செவாலியே
guillermo	கில்லர்மோ
palmyra	பனம்
loc	loc
frozen	உறைந்த
wadi	வாடி
megapixel	மெகாபிக்சல்
biston	biston
dyer	டையர்
hesperiidae	hesperiidae
vogue	வோக்
josephine	josephine
xíu	மிகச்சிறிய
ilyich	இலீச்
atlantis	அட்லாண்டிஸ்
dewey	தூவி
sulu	சுலு
capra	காப்ரா
madman	பைத்தியக்காரன்
charter	பட்டயம்
charter	சாசனம்
kyiv	கிவ்
mêtan	மீத்தேன்
guru	குரு
sanders	சாண்டர்ஸ்
aztec	அசுட்டெக்
bengalensis	bengalensis
stereo	ஸ்டீரியோ
georgetown	ஜார்ஜ்டவுன்
falco	falco
pedersen	pedersen
lance	லான்ஸ்
mohd	முகமட்
perspective	கண்ணோட்டங்கள்
dal	தால்
amd	amd
buren	பியூரன்
nora	நோரா
blogger	வலைப்பதிவர்
blogger	வலைப்பூக்கள்
bing	பிங்
kaga	காகா
chapel	சிற்றாலயம்
commentary	வர்ணனை
betta	பெட்டா
confederations	confederations
spice	ஸ்பைஸ்
octopus	ஆக்டோபஸ்
acb	acb
khít	பேக்கிங்
sink	துத்தநாக
gee	கீ
saskatchewan	சஸ்காச்சுவான்
antioch	antioch
rhodesia	rhodesia
bert	பெர்ட்
westinghouse	வெஸ்டிங்ஹவுஸ்
harmony	நல்லிணக்கம்
diaz	டியாஸ்
vầng	கோல்டன்
vầng	பொன்
tostring	tostring
gui	gui
odyssey	ஒடிஸி
ngo	ngo
sciuridae	sciuridae
tethys	தெதைஸ்
progressive	முற்போக்கு
davidson	டேவிட்சன்
ndt	ndt
chernobyl	செர்னோபில்
murakami	முரகாமி
hastings	ஹேஸ்டிங்ஸ்
patagonia	படகோனியா
gaya	கயா
fairfield	fairfield
verrucosa	verrucosa
superfamilia	superfamilia
găm	கத்தி
ava	அவா
riyadh	ரியாத்
booth	பூத்
booth	பூத்து
cristina	கிறிஸ்டினா
plc	plc
gerrard	ஜெரார்ட்
negro	நீக்ரோ
rum	ரம்
vasco	vasco
leibniz	லைப்னிட்ஸ்
authorlink	authorlink
mahmoud	மஹ்மூத்
anthology	anthology
pia	பியா
steam	நீராவி
spa	ஸ்பா
spa	ஸ்பாக்கள்
punta	பூண்ட
belowstyle	belowstyle
vijaya	விஜயா
vijaya	விஜய
styles	பாணிகள்
pool	pol
boyd	boyd
vin	வின்
vin	vin
chorus	கோரஸ்
aphrodite	அப்ரடைட்டி
lone	லோன்
dolly	டோலி
char	char
nissan	நிஸ்ஸான்
mir	மிர்
ogv	ogv
fernandez	பெர்னாண்டஸ்
gustaf	gustaf
peterson	பீட்டர்சன்
garrett	காரெட்
vent	ஜன்னல்கள்
reuters	ராய்ட்டர்ஸ்
aix	aix
gpl	gpl
hodgson	ஹாஜ்சன்
clifford	கிளிஃபோர்ட்
worlds	உலகின்
worlds	உலகங்கள்
psp	psp
generic	பிறப்பு
ploceus	நெசவாளர்கள்
carlton	கார்ல்டன்
daniels	டேனியல்ஸ்
papa	அப்பா
vitis	vitis
sha	ஷா
brady	ப்ராடி
identity	அடையாளம்
telescope	தொலைநோக்கி
collapsible	collapsible
dolphin	டால்பின்
swing	ஊஞ்சல்
swing	மூச்சில்
inornata	inornata
pavlov	pavlov
martins	மார்டின்ஸ்
moritz	moritz
aleksey	அலெக்சி
squad	ஸ்குவாட்
coleman	கோல்மன்
oro	oro
khartoum	கார்ட்டூம்
steiner	ஸ்டெயினர்
scene	uml
atkinson	அட்கின்சன்
abd	abd
packard	பேக்கர்ட்
biếc	nil
fax	தொலைநகல்
stevie	ஸ்டீவி
siegfried	சிக்ஃபிரைட்
banda	பந்தா
vat	vat
vat	ஈரமான
vat	ஈர
vat	ஈரம்
vat	ஈரமாக
dominic	டோமினிக்
sook	சோக்
pskov	pskov
richie	ரிச்சி
satan	சாத்தான்
groupstyle	groupstyle
liam	லியாம்
sylvester	சில்வெஸ்டர்
horace	ஹொரேஸ்
plutarch	புளூட்டாக்
hilary	ஹில்லாரி
hilary	ஹிலாரி
mel	மெல்
dress	சூட்
guevara	குவேரா
savannah	சவன்னா
uranium	யுரேனியம்
saxicola	saxicola
avec	avec
universidad	universidad
daisy	டெய்சி
nucleotide	nucleotide
pleistocene	pleistocene
rubik	கியூப்
rubik	ரூபிக்
osborne	ஆஸ்போர்ன்
madhuca	madhuca
proxima	புரோக்சிமா
activeusers	activeusers
reese	ரீஸ்
natasha	நடாஷா
ribbon	ரிப்பன்
pali	pali
pali	பாலி
boer	போயர்
primeminister	பிரதமர்கள்
owl	ஆந்தை
numberofpages	numberofpages
numberofactiveusers	numberofactiveusers
numberofadmins	numberofadmins
molly	மோலி
numberofarticles	numberofarticles
numberoffiles	numberoffiles
wen	வென்
numberofusers	numberofusers
numberofedits	numberofedits
vát	தலைகள்
sanskrit	சமஸ்கிருதம்
sanskrit	சமஸ்கிருதத்தில்
sanskrit	சமஸ்கிருத
yao	யாவ்
crash	செயலிழப்பு
crash	விபத்தில்
ulus	ulus
adsl	adsl
gaia	கையா
aki	அகி
hanna	ஹன்னா
amelia	அமெலியா
hardcover	hardcover
challenger	மீட்டரில்
ribosome	இரைபோசோம்
cinereus	cinereus
bục	மேடையில்
stirling	ஸ்டேர்லிங்
ula	உலா
wook	வூக்
krupp	க்ரூப்
sulfuric	சல்பூரிக்
rết	பூரான்
seasons	பருவங்கள்
osman	ஒஸ்மான்
hasan	ஹசன்
lte	lte
vẩn	புரிந்தான்
meshid	meshid
ppm	ppm
patel	படேல்
patel	பட்டேல்
clan	குலம்
neymar	நெய்மார்
oecd	oecd
freud	பிராய்ட்
emilio	எமிலியோ
asiatica	asiatica
distrito	distrito
demi	டெமி
taiga	தைகா
loop	சுழற்சி
loop	கண்ணி
loop	மடக்கு
loop	லூப்
mayo	மாயோ
crimson	கிரிம்சன்
nasser	நாசர்
rfa	nrc
sulla	sulla
vip	விஐபி
naga	நாக
naga	நாகா
noaa	noaa
garland	கார்லேண்ட்
maple	மேப்பிள்
rizal	ரிசால்
tau	டாவ்
miocene	miocene
bmg	bmg
booker	புக்கர்
raphael	ரபேல்
ipairs	ipairs
designations	வகித்த
gurion	குரியன்
payne	பெய்ன்
ami	அமி
colonial	காலனித்துவ
daun	ஆனபோது
morley	மார்லே
mucronata	mucronata
pub	பப்
platon	பிளேட்டோ
sal	ஸல்
sal	சல்
sal	சால்
fin	துடுப்பு
daimler	டைம்லர்
pyrenees	pyrenees
cyril	சிரில்
griffith	கிரிஃபித்
everett	எவெரெட்
naturelle	naturelle
shu	ஷு
mercy	கருணை
mercy	ரஹ்மத்
scarlet	scarlet
jaguar	ஜாகுவார்
biol	biol
rận	பேன்
rolf	ரோல்ஃப்
luiz	லூயி
himachal	இமாச்சலப்
sverdlovsk	sverdlovsk
inchi	inchi
calcutta	கல்கத்தா
spence	ஸ்பென்ஸ்
hystrix	முள்ளம்பன்றி
hystrix	hystrix
ozawa	ஒசாவா
ipad	ipad
fifth	ஐந்தாம்
fifth	ஐந்தாவது
isa	ஈஸா
gpu	gpu
elle	எல்லே
alamos	alamos
lodge	லாட்ஜ்
bac	bac
anita	அனிதா
nietzsche	நீட்சே
blitzkrieg	blitzkrieg
evan	இவான்
stafford	ஸ்டாஃபோர்ட்
cocktail	காக்டெயில்
hiro	ஹிரோ
pamela	பமீலா
badami	பாதமி
minerva	மினெர்வா
diffusa	சாரை
audrey	ஆட்ரி
luanda	லுவாண்டா
kumar	குமார்
loki	லோகி
wta	wta
thin	மெல்லிய
sql	sql
brooke	புரூக்
hammer	ஹாமர்
riparia	riparia
rubens	ரூபென்ஸ்
anguilla	அங்கியுலா
toby	டோபி
auriculata	auriculata
chennai	சென்னை
jfk	jfk
byzantium	byzantium
surat	சூரத்
gale	கேல்
eddy	எடி
dinar	தினார்
damon	டாமன்
expo	எக்ஸ்போ
tráp	பொறி
tráp	பொறிகள்
barber	பார்பர்
bos	bos
danish	டேனிஷ்
danish	டானிஷ்
sylvestris	sylvestris
omaha	ஒமஹா
corinthians	கொரிந்தியர்
cologne	கொலோன்
meson	மேசான்கள்
stevenson	ஸ்டீவன்சன்
stdinchi	stdinchi
pulchellus	pulchellus
hutchinson	ஹட்சின்சன்
sqm	sqm
samson	சாம்சன்
mergedtoprow	mergedtoprow
gmail	கிரெடிட்
gmail	கடன்
gmail	ஜிமெயில்
xyanua	சயனைடு
gradient	சாய்வு
cellspacing	cellspacing
plains	சமவெளி
enceladus	enceladus
lotte	லோட்டி
civic	சிவிக்
nudum	nudum
basil	துளசி
marxist	மார்க்சிஸ்ட்
willy	வில்லி
maori	மூர்
fips	fips
pygmy	பிக்மி
furious	பியூரியஸ்
maki	மக்கி
shuttle	ஷட்டில்
serge	செர்கி
stdinchikey	stdinchikey
xịt	தொப்பி
okb	okb
duff	டஃப்
roc	roc
bunker	பதுங்கு
froese	froese
selen	செலினியம்
nicobar	நிக்கோபார்
cliff	கிளிஃப்
eagles	கழுகுகள்
hedge	ஹெட்ஜ்
varanus	varanus
emerald	மரகதம்
emerald	மரகத
duỗi	நீட்சி
cory	கோரி
rhinolophus	rhinolophus
accipiter	accipiter
beer	பியர்
beer	பீர்
boss	முதலாளி
boss	பாஸ்
boss	தலைவா
tacitus	tacitus
casno	casno
indi	இண்டியம்
groove	பள்ளம்
freddie	பிரட்டி
tráo	நிறுவுகிறது
brenda	பிரெண்டா
xắt	வெட்டிய
xắt	துண்டைக்
philips	பிலிப்ஸ்
philips	ஃபிலிப்ஸ்
cranmer	கிரான்மர்
bir	பிர்
lodi	லோடி
needham	needham
gateway	நுழைவாயில்
lutheran	லுத்தரன்
maastricht	மாஸ்ட்ரிக்ட்
novak	நோவாக்
đỉa	அட்டை
rudolph	ருடால்ப்
anatomy	உடற்கூறு
avon	ஏவான்
siam	சியாம்
tomb	கல்லறை
allah	அல்லாஹ்
sousa	sousa
condor	condor
macro	மேக்ரோ
gel	ஜெல்
tedder	டெட்டர்
clive	கிளைவ்
colossus	colossus
hbo	எச்பிஓ
copernicus	கோப்பர்னிக்கஸ்
dietrich	டீட்ரிக்
zola	zola
grayson	கிரேசன்
hin	hin
jeddah	ஜித்தா
mira	மிரா
crop	வெட்டு
crop	பயிர்
crop	செதுக்கு
nme	nme
pirates	கொள்ளையர்களை
pirates	கொள்ளையர்கள்
doris	டோரிஸ்
factsheet	factsheet
myth	கட்டுக்கதை
frameless	frameless
moody	மூடி
simmons	சிம்மன்ஸ்
rei	rei
atv	atv
dolls	பொம்மைகள்
augustin	அகஸ்டீன்
ncbi	ncbi
mitch	மிட்ச்
shetland	shetland
marks	மார்க்ஸ்
verticillata	verticillata
levine	லெவின்
sinica	sinica
claudio	கிளாடியோ
burm	burm
naomi	நவோமி
carinatus	carinatus
galilei	கலிலி
pei	பெய்யும்
pei	பெய்
visayas	விசயாசு
volgograd	வோல்கோகிராட்
siena	கத்ரீன்
franck	பிராங்க்
marty	மார்டி
triton	டிரைட்டன்
amino	அமினோ
omsk	ஒம்ஸ்க்
evelyn	ஈவிலின்
edmonton	எட்மன்டன்
tuvalu	துவாலு
sởi	தட்டம்மை
emery	எமெரி
torch	டார்ச்
torch	பந்தம்
fernandes	பெர்னாண்டஸ்
panda	பாண்டா
tribal	பழங்குடி
tribal	பழங்குடிகள்
parque	parque
brighton	பிரைட்டன்
frederic	ஃபிரெடெரிக்
coco	கோகோ
sếp	ஐயா
sếp	சார்
sếp	அய்யா
sếp	சர்
sếp	தலைவன்
sếp	தலைமை
sếp	முதலாளி
sếp	பாஸ்
sếp	தலைவா
giầy	காலணி
giầy	காலணிகள்
moe	மோ
tobruk	துப்ருக்
mifflin	mifflin
mimi	மிமி
compostela	கோம்போசுதேலா
plastic	பிளாஸ்டிக்
messiah	மெசியா
lies	பொய்கள்
sango	சாங்கோ
ababa	அபாபா
blackberry	பிளாக்பெர்ரி
gallus	gallus
travis	டிராவிஸ்
mahmud	கசினி
halogen	அலசன்
glacier	பனியாறு
gomes	கோம்ஸ்
ecw	ecw
imam	இமாம்
imam	இமாம்கள்
dio	டியோ
cathay	கதே
kathy	கேத்தி
ella	எல்ல
ella	ella
hathaway	ஹாதவே
burger	பர்கர்
chôm	திருடப்பட்டது
gondwana	கோண்டுவானா
dustin	டஸ்டின்
deck	டெட்
deck	ஏடு
deck	எடு
cooke	cooke
zum	zum
pius	பயஸ்
serial	சீரியல்
serial	வரிசை
serial	தொடர்
beth	பெத்
dms	dms
pelé	பெலே
mos	mos
nia	நியா
falling	விழுவது
unity	ஒற்றுமையே
unity	ஒற்றுமை
rodrigo	ரோட்ரிகோ
artemis	ஆர்ட்டெமிஸ்
bra	பிரேசில்
pts	pts
buk	புக்
pictogram	pictogram
yalta	யால்ட்டா
cagayan	ககயான்
rupee	ரூபாய்
rupee	ரூபாய்
nộm	போலி
nộm	ஒப்பு
unplugged	மதிப்பிடு
unplugged	பிரித்தெடுத்து
markus	மார்க்கஸ்
bora	போரா
entomology	பூச்சியியல்
taurus	ரிஷபம்
middleton	மிடில்டன்
bale	பேல்
stokes	ஸ்டோக்ஸ்
shen	shen
pci	பிசிஐ
enter	நுழை
enter	உள்ளிடு
enter	நுழைந்து
enter	உள்ளிடவும்
bride	மணமகள்
bride	மணப்பெண்
nikki	நிக்கி
survival	பிழைப்பு
mio	மியோ
indien	indien
sept	செப்
harmonica	ஹார்மோனிகா
sandwich	சாண்ட்விச்
fabio	ஃபேபியோ
peck	peck
trend	trend
murina	murina
sos	sos
dane	டேன்
gpcm	gpcm
longirostris	longirostris
hera	ஹீரா
forks	பிரிகின்றன
views	பார்வைகள்
rosenberg	ரோசன்பெர்க்
rowland	ரோலண்ட்
moo	மூ
mica	மைக்கா
sale	விற்பனை
sale	சேணம்
sukhothai	சுகோத்தாய்
biographical	biographical
storia	storia
khay	தட்டு
lantan	இலந்தனம்
kristen	கிறிஸ்டன்
aachen	ஆஃகன்
brendan	பிரெண்டன்
buzz	buzz
bastille	பாஸ்டில்
sabina	சபீனா
scan	வருடு
scan	ஸ்கேன்
penelope	பெனிலோப்
#efefef	#efefef
muỗng	கரண்டி
muỗng	கரண்டி
muỗng	நடக்கும்
anand	ஆனந்த்
skull	மண்டை
lawson	லாசன்
rhea	ரியா
vis	ஆகியவை
comments	கருத்துகளில்
comments	கருத்துக்களில்
comments	கருத்துகள்
comments	கருத்துக்கள்
rupert	ரூபர்ட்
ferreira	ஃபெரேரா
alec	அலெக்
montserrat	மொன்செராட்
bowie	போவி
karim	கரீம்
hipposideros	hipposideros
motorola	motorola
wiesbaden	wiesbaden
canaan	கானான்
alam	ஆலம்
beetles	beetles
lanata	lanata
vote	வாக்கு
wehrmacht	wehrmacht
boot	பூட்
stadt	stadt
pueblo	pueblo
naoh	naoh
hex	ஹெக்ஸ்
hex	தொகுப்பி
dìm	அமைதிப்படுத்தும்
moor	சோனகர்
moor	மூர்
nghẹt	நெரிசல்
uri	uri
uri	உரி
chakri	சக்ரி
mariae	mariae
afghan	ஆப்கான்
khm	khm
pls	தயவு
pls	pls
jill	ஜில்
rambo	ராம்போ
rowan	ரோவன்
murmansk	murmansk
courtney	கோர்ட்னி
maynard	மேனார்ட்
deborah	டெபோரா
bering	பெரிங்
dominican	டொமினிக்கன்
graves	விட்டனர்
nathaniel	நதானியேல்
comet	comet
underwood	அண்டர்வுட்
loud	சத்தம்
loud	சத்தமாக
loud	உரத்த
sage	முனிவர்
cicero	சிசெரோ
anpơ	ஆல்ப்ஸ்
wcw	wcw
mải	என்றென்றைக்கும்
mải	என்றென்றும்
mải	எப்போதும்
mải	நிரந்தரமாக
mải	நித்திய
emerson	எமர்சன்
closer	அருகாமையில்
hardin	ஹார்டின்
walton	வால்டன்
hói	வழுக்கை
harding	harding
cellpadding	cellpadding
heron	ஹெரான்
rữa	அழுகல்
felicia	ஃபெலிசியா
globalsecurity	globalsecurity
ramon	ரமோன்
hulk	ஹல்க்
monterey	மான்டெர்ரே
nhóc	குழந்தை
nhóc	குழந்தையாய்
sunny	சன்னி
sunny	வெயில்
sunny	வெய்யில்
schrödinger	சுரோடிங்கர்
enigma	எனிக்மா
nicaea	nicaea
bismil	பிசுமில்
holden	ஹோல்டன்
merkel	மேர்க்கெல்
corvus	காகம்
carbine	carbine
lit	எண்ணும்
hormon	ஹார்மோன்கள்
celsius	செல்சியஸ்
celsius	கால்சியம்
patterns	வடிவங்கள்
rough	தோராயமான
rough	கரடு
rough	கடினம்
cecilia	சிசிலியா
mah	mah
anas	அனஸ்
boo	பூ
stamp	தட்டும்
stamp	முத்திரை
internationale	internationale
cindy	சிண்டி
poison	நஞ்சு
poison	விஷம்
scorpion	தேள்
quây	சுற்றியுள்ள
rockefeller	ராக்ஃபெல்லர்
dioxide	ஈராக்சைடு
koga	கோகா
bagdad	பாக்தாத்
subgenus	subgenus
accra	அக்ரா
cassia	cassia
kao	kao
blast	வெடிப்பு
kedah	கடாரம்
kedah	கெடா
phết	கமா
hamlet	ஹாம்லெட்
kolbe	கோல்பே
eur	eur
darkness	இருள்
darkness	இருட்டு
arkhangelsk	arkhangelsk
mclaren	mclaren
methyl	மீத்தைல்
aleppo	அலெப்போ
verne	வேர்ண்
headerstyle	headerstyle
aol	aol
thrash	திராசு
kpa	kpa
kathmandu	காத்மாண்டு
terminator	டெர்மினேட்டர்
ursus	ursus
phalacrocorax	நீர்க்காகம்
ulm	உல்ம்
cdo	cdo
brent	பிரண்ட்
hiragana	hiragana
goebbels	கோயபெல்ஸ்
mccoy	மெக்காய்
alvin	ஆல்வின்
antonín	அன்டனின்
lbs	lbs
wifi	wifi
wifi	வைஃபை
gregor	கிரிகோர்
vanda	வாண்டா
judas	யூதாசு
telecom	டெலிகாம்
silvestris	silvestris
bhutto	பூட்டோ
pony	குதிரை
yusuf	யூசுஃப்
sgt	சார்ஜெண்ட்
alamein	alamein
aaa	aaa
toba	தோபா
astana	அஸ்தானா
lindsay	லின்ட்சே
jacksonville	ஜாக்சன்வில்
alexa	அலெக்சா
instituto	instituto
hezbollah	ஹிஸ்புல்லா
freddy	ஃப்ரெட்டி
vivaldi	விவால்டி
emanuel	இமானுவேல்
osama	ஒசாமா
hdtv	hdtv
secrets	ரகசியங்கள்
secrets	இரகசியங்கள்
jpn	jpn
dexter	டெக்ஸ்டர்
theresa	தெரேசா
lilly	லில்லி
johansson	ஜோஹான்சன்
insulin	இன்சுலின்
pizarro	பிசாரோ
jennings	ஜென்னிங்ஸ்
gesellschaft	gesellschaft
katrina	கத்ரீனா
sama	sama
sindh	சிந்த்
resistivity	resistivity
gagarin	ககாரின்
tcp	tcp
baxter	பாக்ஸ்டர்
khiêng	சுமந்து
cui	cui
cesar	சீசர்
saratov	saratov
barros	பரோஸ்
dunkerque	டன்கிர்க்
terminalia	terminalia
nobelprize	nobelprize
phelps	பெல்ப்ஸ்
tver	திவெர்
inchikey	inchikey
airline	ஏர்லைன்ஸ்
nestor	நெஸ்டர்
sasha	சாஷா
alison	அலிசன்
wilder	வைல்டர்
couple	ஜோடி
couple	தம்பதிகளின்
plo	plo
hertz	ஏர்ட்சு
kimono	கிமோனோ
scarborough	scarborough
saarland	saarland
cali	கலி
tibet	திபெத்
vodka	வோட்கா
goo	goo
pod	pod
munda	முண்டா
ata	ata
associates	கூட்டாளிகள்
guerre	guerre
gượng	வெள்ளம்
dillon	தில்லான்
whisky	விஸ்கி
gorilla	கொரில்லா
sulcata	sulcata
scorsese	ஸ்கோர்செசி
fibonacci	ஃபிபனாச்சி
buddy	நண்பா
múc	ஸ்கூப்
twins	இரட்டையர்
twins	இரட்டையர்கள்
ferrer	ஃபெரர்
nehru	நேரு
anion	anion
integrated	ஒருங்கிணைந்த
urbana	urbana
huxley	huxley
ripley	ripley
sagan	சேகன்
psi	psi
nike	நைக்
ulster	ulster
fans	ரசிகர்கள்
tex	டெக்ஸ்
perrin	பெரென்
salisbury	சாலிஸ்பரி
mojo	mojo
push	தள்ளு
push	புஷ்
sanchez	சான்செஸ்
fda	fda
hartford	hartford
raleigh	ராலே
tacoma	டகோமா
pretoria	பிரிட்டோரியா
ira	இரா
nic	நிக்
nic	nic
#không	#no
#không	#எந்த
broughton	புரோட்டன்
persica	persica
hess	எச்சு
grin	புன்முறுவல்
ares	ஏரிஸ்
oryol	oryol
islamabad	இஸ்லாமாபாத்
perak	பேராக்
eureka	eureka
saul	சவுல்
vnd	usd
cation	cation
ursula	ursula
sharif	ஷெரீப்
adi	ஆதி
clint	கிளின்ட்
bonnet	மிளகை
trainer	பயிற்சியாளர்
poor	por
goya	கோயா
brando	பிராண்டோ
bulldog	புல்டாக்
alexei	அலெக்சி
cad	cad
manipur	மணிப்பூர்
ney	நெ
cinderella	சிண்ட்ரெல்லா
fresno	fresno
dino	டினோ
shea	ஷீ
lothar	lothar
adolphe	அடோல்ஃப்
fatima	பாத்திமா
babylonia	பபிலோனியா
navarro	நவரோ
gon	கோன்
carnival	திருவிழா
debian	டெபியன்
linus	லினசு
nadia	நதியா
subic	சூபிக்
bose	போஸ்
pandora	பண்டார
pandora	பண்டோரா
chandra	சந்திர
chandra	சந்திரா
astrid	ஆஸ்ட்ரிட்
yap	யாப்
deluxe	டீலக்ஸ்
deluxe	உயர்
dent	டென்ட்
quote	மேற்கோள்
brahman	பிரம்மம்
peña	பெனா
qumran	கும்ரான்
cynthia	சிந்தியா
marcelo	மார்செலோ
facto	facto
diptera	diptera
lòi	ஸ்டிக்
lòi	குச்சி
nagorno	nagorno
humphrey	ஹம்ஃபிரே
cunha	குன்ஹா
megan	மேகன்
mohs	mohs
aleksandrovich	aleksandrovich
angelina	ஏஞ்சலினா
rss	ஆர்எஸ்எஸ்
rss	rss
charon	சரோன்
nelly	நெல்லி
lum	லம்
heracles	heracles
emedicinesubj	emedicinesubj
dow	dow
chừa	உதிரி
chừa	தவிர்க்க
kano	கானோ
asunción	அசுன்சியோன்
dns	dns
lithuania	லிதுவேனியா
null	திருப்பப்பட்டது
plug	அடைப்பை
arabian	அரேபிய
arabian	அரபிக்
imbricata	imbricata
airasia	ஏர்ஏசியா
doll	பொம்மையை
doll	பொம்மை
chon	குறுக்கு
chon	கிராஸ்
chon	சிலுவை
corona	corona
buteo	buzzard
terrestrial	புவிப்புறத்
uhfffaoysa	uhfffaoysa
bios	பயாஸ்
naked	நிர்வாண
naked	நிர்வாணமாக
supreme	உச்ச
parabol	பரவளையம்
ucla	ucla
hamid	ஹமீது
kush	குஷ்
thirty	முப்பது
jessie	ஜெஸ்ஸி
townsend	டவுன்சென்ட்
luz	லஸ்
streaming	ஸ்ட்ரீமிங்
ebay	ebay
balfour	balfour
pythagoras	பித்தாகரஸ்
hogan	ஹோகன்
phốtpho	பாஸ்பரஸ்
lepton	மென்மி
infraordo	infraordo
dumas	டூமா
resident	resident
bytes	பைட்டுகள்
#ff	#ff
nikola	nikola
heroin	நாயகி
mandarin	மாண்டரின்
brett	பிரெட்
arles	arles
gôn	கால்ஃப்
gôn	கோல்ஃப்
gôn	கோல்ப்
share	பகிர்வில்
share	பகிர்
share	பகிரவும்
niue	நியூ
niue	நியுவே
conn	கொன்
sas	sas
sas	saas
domenico	domenico
denton	டென்டன்
rabin	rabin
bragg	bragg
hidro	ஹைட்ரஜன்
gage	கேஜ்
hind	ஹிந்த்
chavez	சாவேஸ்
saussure	சோசர்
raptor	ராப்டர்ஸ்
giỡn	மெஸ்
giỡn	குழப்பம்
jeans	ஜீன்ஸ்
marlon	மார்லன்
bowling	பந்துவீச்சு
socrates	சாக்கிரட்டீசு
inst	inst
chow	சௌ
koro	கோரோ
lamar	லமார்
mom	அம்மா
amateur	அமெச்சூர்
pipistrellus	pipistrelle
ups	ups
mahal	மஹால்
puma	பூமா
gem	ஜெம்
estrogen	ஈஸ்ட்ரோஜென்
ginger	இஞ்சி
jurassic	ஜுராசிக்
duran	தூரன்
serinus	கேனரி
premium	பிரீமியம்
percival	பெர்சிவல்
bum	ஜே
bum	ஜெய்
lepus	ஹரே
rpm	rpm
nicki	நிக்கி
ipv	ipv
xxxx	xxxx
icd	icd
coli	coli
nsw	nsw
capture	இரை
mila	மிலா
allianz	அலையன்ஸ்
wolverine	wolverine
huygens	ஐகன்சு
kasparov	காஸ்பரொவ்
bone	எலும்பு
kilo	கிலோ
chekhov	செக்கோவ்
phenol	பீனால்
bigot	வைராக்கியம்
kippur	கிப்பூர்
mein	mein
altvar	altvar
selva	selva
modem	மோடம்
bridges	பாலங்கள்
triumph	வெற்றியாகும்
maradona	மரடோனா
yukio	யுகியோ
woodrow	woodrow
agatha	அகதா
ainu	ஐனு
dll	dll
lovers	காதலர்கள்
clarinet	கிளாரினெட்
htc	htc
spectrum	ஸ்பெக்ட்ரம்
nos	nos
ethnologue	ethnologue
tiển	தாக்கல்
burn	பழுப்பு
burn	எழுது
greer	கிரீர்
audition	ஒத்திகை
selangor	சிலாங்கூர்
banana	வாழை
banana	வாழைப்பழம்
mutabilis	mutabilis
gideon	கிடியன்
rhipidura	fantail
tirpitz	டிர்பிட்சு
#eee	#eee
gum	கம்
landau	landau
nebula	நெபுலா
mex	மெக்ஸ்
tba	tba
hafizullah	ஹஃபிசுல்லா
bmi	மாணவன்
bmi	மாணவர்
shelley	ஷெல்லி
semimajor	semimajor
kierkegaard	kierkegaard
burgess	பர்கெசு
amos	அமோஸ்
asa	ஆசா
bandar	பந்தர்
kurosawa	குரோசாவா
luciano	லூசியானோ
aspirin	ஆஸ்பிரின்
rèm	திரைச்சீலைகள்
rèm	தடித்த
rèm	திரைச்சீலை
melanesia	மெலனீசியா
chau	சாவ்
temps	temps
hicks	ஹிக்ஸ்
hydrogen	ஹைட்ரஜன்
endemic	endemic
itu	itu
sana	சனா
wikipe	wikipe
tomas	தோமசு
sho	ஷோ
jstor	jstor
icc	icc
harriet	ஹேரியட்
cure	குணப்படுத்த
fanny	fanny
cbc	cbc
aceh	அச்சே
kiwi	கிவி
alberti	alberti
funny	வெறும்
funny	சும்மா
barbatus	barbatus
dunkirk	டன்கிர்க்
hawthorne	ஹாதோர்ன்
nagara	nagara
ast	ast
torpedo	torpedo
stephenson	ஸ்டீபென்சன்
bloomington	bloomington
irc	irc
bts	bts
kde	kde
willow	வில்லோ
pico	பிகோ
lutz	லூட்ஸ்
havana	ஹவானா
crom	குரோமியம்
abovestyle	abovestyle
cyclops	cyclops
virgo	கன்னி
souza	சோசா
sachs	சாச்ஸ்
deutscher	deutscher
dual	இரட்டை
sonia	சோனியா
jared	ஜாரெட்
amir	அமீர்
phosphate	பாசுபேட்டு
ronnie	ரோனி
builder	பில்டர்
bol	போல்
doppler	டாப்ளர்
mariano	mariano
hutton	ஹட்டன்
slim	ஸ்லிம்
aces	aces
divine	தெய்வீகம்
divine	தெய்வீக
reilly	ரெய்லி
sae	sae
skinner	ஸ்கின்னர்
kok	kok
kok	கோக்
xiao	xiao
eri	eri
hewitson	hewitson
sed	sed
banteay	பந்தியாய்
jens	jens
walls	சுவர்களில்
walls	சுவர்கள்
lego	lego
negev	நெகேவ்
orenburg	orenburg
sawyer	சாயர்
closeup	closeup
giants	அரக்கர்கள்
yugoslavia	யூகோசுலாவியா
dickson	டிக்சன்
iptv	iptv
richthofen	ரிச்தோஃபென்
bukit	புக்கிட்
initiative	முனைப்பு
kendall	கெண்டல்
kor	kor
irvine	இர்வின்
blonde	பொன்னிற
leben	leben
ting	டிங்
mui	ஹூட்
stripped	stripped
aryan	ஆரிய
aryan	ஆரியன்
aryan	ஆரியர்
javanicus	javanicus
académie	பிரான்சிய
brill	brill
maroon	அரக்கு
dấm	வினிகர்
saha	சாஃகா
coffea	coffea
longman	longman
zac	சாக்
pepsi	பெப்சி
caspian	காசுப்பியன்
sparks	தடித்த
cacao	கொக்கோ
isp	isp
barrow	பாரோ
jasmine	மல்லிகை
lourdes	லூர்து
pid	pid
devi	தேவி
rít	பூரான்
darth	டார்த்
periapsis	periapsis
yue	காந்தோநீசிய
twelve	பன்னிரெண்டு
twelve	பன்னிரண்டு
bicornis	bicornis
bernoulli	bernoulli
remy	ரெமி
sputnik	இசுப்புட்னிக்
hank	ஹாங்க்
nsa	nsa
iupac	iupac
taj	தாஜ்
kathleen	காத்லீன்
espn	espn
karma	கர்மா
mall	மால்
nickel	நிக்கல்
nava	நவா
avar	அவர
marian	மரியான்
nacl	nacl
fabian	ஃபேபியன்
boxing	குத்துச்சண்டை
tyumen	tyumen
crisp	மிருதுவான
moves	நகர்வுகள்
dat	dat
erin	எரின்
kris	க்ரிஸ்
russo	ரூசோ
pil	மாத்திரை
marcellus	மர்செல்லுஸ்
carcharhinus	சுறா
kam	காம்
walters	வால்டர்ஸ்
cyber	சைபர்
sid	சித்
drummondii	drummondii
mba	mba
mba	எம்பிஏ
eastwood	ஈஸ்ட்வுட்
gohan	கோஹன்
cod	cod
txt	txt
alzheimer	அல்சைமர்
mesopotamia	மெசொப்பொத்தேமியா
eragon	எராகன்
genius	மேதை
twist	திருப்பம்
twist	ட்விஸ்ட்
grenoble	கிரனோபிள்
kita	kita
finding	கண்டுபிடித்தல்
cid	சிஐடி
günter	கூன்டர்
tigers	புலிகள்
nicky	நிக்கி
christi	கிறிஸ்டி
commando	கமாண்டோ
labs	லேப்ஸ்
stearns	ஸ்டெர்ன்ஸ்
wonderland	wonderland
monet	மோனெ
harcourt	harcourt
lse	lse
lata	லதா
panic	பீதி
panic	திகில்
prometheus	prometheus
garuda	கருட
centauri	செண்டாரி
garibaldi	garibaldi
ngàng	ஆச்சரியமான
lola	லோலா
obj	obj
hada	ஹதா
lip	லிப்
lip	உதடு
lip	உதட்டு
gladiator	கிளாடியேட்டர்
judea	யூதேயா
casting	நடிக்க
ellie	எள்ளி
lunar	சந்திர
antique	பழங்கால
bayan	பயான்
cara	காரா
jsp	jsp
khùng	பைத்தியம்
ravi	ரவி
seenplatte	vorpommern
swahili	சுவாகிலி
melinda	மெலிண்டா
jeep	ஜீப்
taking	எடுக்கும்
taking	எடுக்கிறார்
taking	எடுத்து
bautista	பாடிஸ்டா
ing	ing
cheetah	சிவிங்கிப்புலி
nghiến	அரை
hideki	ஹிடேகி
lap	மடியில்
soma	சோமா
mizuki	மிசுகி
na+	na+
combo	சேர்க்கை
slide	படவில்லை
rashid	ரசீட்
silvio	சில்வியோ
zion	zion
bild	bild
welch	வெல்ச்
rodin	ரொடான்
golan	கோலான்
twice	இருமுறை
bingham	பிங்கம்
rockwell	ராக்வெல்
silvia	சில்வியா
muscat	மஸ்கட்
hedley	ஹெட்லி
mak	mak
phễu	புனல்
mystic	மிஸ்டிக்
gonzalo	gonzalo
worm	புழு
seville	செவீயா
gemini	ஜெமினி
gemini	மிதுனம்
skype	ஸ்கைப்
skype	skype
laptop	மடிக்கணினி
laptop	லேப்டாப்
atom	அணு
roe	சினை
ems	ems
phd	phd
phd	முனைவர்
ins	இன்கள்
brahma	பிரம்மா
ike	ஐக்
ruhr	ரூர்
finger	விரலை
finger	விரல்
cfa	cfa
sammy	சாம்மி
cum	cum
clash	மோதல்கள்
rockstar	ராக்ஸ்டார்
nino	நினோ
bentley	பென்ட்லி
tiny	மிகச்சிறிய
elba	எல்பா
martina	மார்டினா
polymerase	polymerase
belowclass	belowclass
aeronautical	aeronautical
napier	நேப்பியர்
gareth	காரெத்
niagara	நயாகரா
weston	வெஸ்டன்
sil	sil
saud	சௌத்
heisenberg	ஐசன்பர்க்
hydra	ஹைட்ரா
assault	தாக்குதல்
pauline	பாலின்
rec	ரெக்
illiger	illiger
arbor	அச்சாணி
dipodomys	கங்காரு
maguindanao	மகின்டனாவ்
origami	ஓரிகாமி
strings	தொடர்கள்
samba	சம்பா
samba	சாம்பா
pennington	pennington
granite	கிரானைட்
granite	கருங்கல்
scouts	சாரணர்கள்
rangoon	ரங்கோன்
kẻo	இல்லையெனில்
tasman	டாஸ்மான்
excel	எக்செல்
shenyang	shenyang
vaccine	தடுப்பூசி
mubarak	முபாரக்
pac	pac
mathew	மேத்யூ
mirza	மிர்சா
priscilla	பிரிசில்லா
