castel	castel
sumer	sumerian
irene	irene
cartoon	cartoon
penang	penang
gớm	pamamaga
vocals	vocals
kahn	kahn
toro	toro
gaon	gaon
sủa	bark
carr	carr
betty	betty
wilkinson	wilkinson
cholesterol	kolesterol
cholesterol	cholesterol
constantinople	constantinople
allmusic	allmusic
chihuahua	chihuahua
ancona	ancona
descartes	descartes
tran	tran
madeira	madeira
micro	micro
micro	mikropono
thìa	kutsara
bath	paliguan
bath	naliligo
blanc	blanc
medici	medici
gien	genes
gien	gene
cornwall	cornualles
uae	uae
marche	marche
hormone	hormone
hormone	hormon
hormone	hormones
udine	udine
kan	kan
lens	lens
lens	lente
lens	leak
lens	makalabas
beirut	beirut
hahn	hahn
yamada	yamada
dot	tuldok
dot	dot
andersson	andersson
elip	elipso
lafayette	lafayette
willem	willem
tatar	tatar
boom	bang
boom	boom
luigi	luigi
boone	boone
dumbledore	dumbledore
reo	rang
reo	pagdududa
reo	duda
reo	doubt
reo	alinlangan
garrison	garison
fiction	fiction
sidney	sidney
musashi	musashi
pluto	pluto
adobe	adobe
shizuka	shizuka
lindsey	lindsey
hyundai	hyundai
direct	direktang
direct	direct
direct	direkta
vermont	vermont
sụn	cartilage
craven	craven
kato	kato
nomura	nomura
diane	diane
thrace	thrace
borealis	borealis
anders	anders
sugar	asukal
sugar	sugar
doc	doc
khalip	kalipa
antiochos	antiochus
kyushu	kyushu
cremona	cremona
handel	handel
talbot	talbot
piston	piston
kyle	kyle
dale	dale
gloria	gloria
oder	oder
lange	lange
shannon	shannon
liti	lityo
mehmed	mehmed
cayman	calgary
summit	summit
summit	tuktok
gotha	gotha
wanda	wanda
martino	martino
saxophone	saxophone
friedman	friedman
vanessa	vanessa
baghdad	baghdad
ryukyu	kilusang
kanon	kanon
schwartz	schwartz
hohenzollern	hohenzollern
howell	howell
tolstoy	tolstoy
palawan	palawan
neptune	neptuno
jupiter	jupiter
velvet	velvet
mia	mia
alfonso	alfonso
lara	lara
bromley	bromley
proxy	proxy
djibouti	djibouti
hattori	hattori
training	pagsasanay
musa	musa
acta	acta
akb	akb
marcello	marcello
gilles	gilles
norodom	norodom
funk	funk
robustus	robustus
jharkhand	jharkhand
shepard	shepard
zanzibar	zanzibar
lil	lil
dmitry	dmitry
apiaceae	apiaceae
cowan	cowan
randolph	randolph
oakland	oakland
toscana	tuscany
ambrose	ambrose
ambrose	ambrosio
aurelius	aurelius
antioquia	antioquia
sheikh	sheikh
krai	krai
gear	tempo
gear	gear
andorra	podgorica
olympique	olympique
benedict	benedict
benedict	benedicto
palmer	palmer
irving	irving
trau	pagod
trau	napagod
bison	bison
lat	lat
lat	tamad
coruña	coruña
crane	crane
ôtô	kotse
clement	clemente
darren	darren
beaver	beaver
paulus	paulus
chopin	chopin
canterbury	canterbury
gerhard	gerhard
ariel	ariel
fujiwara	fujiwara
indie	indie
konrad	konrad
castillo	castillo
championships	championships
animax	animax
martha	martha
bloom	bloom
bloom	pamumulaklak
marius	marius
helmut	helmut
avril	avril
mbar	mbar
kure	kure
khuya	late
khuya	huli
suffolk	suffolk
liststyle	liststyle
kimi	kimi
beaufort	beaufort
maui	maui
tone	tone
tone	tono
rue	rue
michoacán	michoacán
ferrari	ferrari
stan	stan
rebel	rebel
rebel	rebelde
loi	loi
regina	regina
cherry	cherry
cherry	seresa
cherry	seresa
scout	pakikipagsapalaran
scout	scout
coburg	coburg
lozère	lozère
pereira	pereira
interscope	interscope
orissa	orissa
bruxelles	bruxelles
bruxelles	brussels
gaston	gaston
clannad	clannad
citation	citation
sakai	sakai
curie	curie
chuck	chuck
dora	dora
aerospace	aerospace
donau	danubio
punctatus	punctatus
dengeki	dengeki
romagna	romagna
bergen	bergen
hora	hora
vols	vols
scottish	scottish
turkish	turko
trinity	trinity
trinity	trinidad
antigonos	antigonus
possible	posible
shop	shop
shop	tindahan
shop	mamili
roche	roche
lamiaceae	lamiaceae
parva	parva
gallo	gallo
kafka	kafka
sonora	sonora
leiden	leiden
meteor	bulalakaw
meteor	meteor
hubert	hubert
schumacher	schumacher
bertrand	bertrand
turin	turin
sylvia	sylvia
wikitext	wikitext
valentin	valentin
thriller	thriller
holly	holly
sensu	sensu
fidel	fidel
ivanovich	ivanovich
ash	ash
brittany	brittany
ret	ret
gentry	gentry
giặt	laba
giặt	hugasan
wrestlemania	wrestlemania
middlesbrough	middlesbrough
barker	barker
philipp	philipp
andre	andre
andre	andré
hibiscus	gumamela
barton	barton
pierce	pierce
rfc	rfc
catania	catania
canary	canary
santana	santana
hilton	hilton
blankname	blankname
sexy	sexy
vinyl	vinyl
cược	taya
lars	lars
jia	jia
krasnodar	krasnodar
chẻ	butas
rainer	rainer
vilnius	vilna
trieste	trieste
phineas	phineas
sirius	sirius
arafat	arafat
leonid	leonid
fuller	fuller
kino	kino
phoebe	phoebe
benevento	benevento
seok	seok
cervus	cervus
boleslav	boleslav
sec	sec
natalie	natalie
halloween	undas
halloween	halloween
midland	midland
narcissus	narcissus
nottingham	nottingham
angelica	angelica
labrador	labrador
shinichi	shinichi
shinichi	kudo
mono	mono
charlton	charlton
rót	ibuhos
sites	site
sites	sites
skin	balat
doyle	doyle
cedar	cedar
saturn	saturn
container	lalagyan
kerch	kerch
thom	thom
gamespot	gamespot
tít	marinig
tít	maririnig
tít	naririnig
nitrat	nitrate
hilbert	hilbert
rising	pagsikat
rising	sumisikat
rising	rising
eight	walong
eight	otso
eight	walo
cobain	cobain
leigh	leigh
núm	suso
cody	cody
mitra	mitra
biếng	tamad
massa	massa
shiva	shiva
shiva	siva
merlin	merlin
gmelin	gmelin
anchor	anchor
ascii	ascii
vice	bisyo
vice	vice
phillip	phillip
surrey	surrey
barset	barset
bolzano	bolzano
martinez	martinez
nmi	nmi
teaser	teaser
gill	gill
hilaire	hilaire
globe	globo
globe	globe
edison	edison
orton	orton
djokovic	djokovic
chằng	ligament
oppenheimer	oppenheimer
sẹo	galos
sẹo	scar
bravo	bravo
tahiti	tahiti
bauer	bauer
kalinin	kalinin
hopper	makatagpo
goa	goa
nicholson	nicholson
dhabi	dhabi
smirnova	smirnova
tigris	tigris
soft	malambot
laguna	laguna
theodosius	theodosius
coca	coke
coca	coca
pixel	pixel
pixel	pixel
pixel	pixels
brevis	brevis
breed	lahi
philippi	philippi
titlestyle	titlestyle
lcd	lcd
sphinx	sphinx
tsubasa	tsubasa
anemone	anemone
rogue	pusong
crimea	crimea
breslau	breslau
factbook	factbook
bonus	bonus
điốt	diode
abkhazia	abkhazia
mồm	bunganga
mồm	bibig
burma	burma
pepper	paminta
baptist	baptist
jammu	jammu
koh	koh
eyed	eyed
dome	dome
ramsey	ramsey
infinity	infinity
hayes	hayes
lombard	lombard
bịp	trick
molina	molina
composite	pinaghalo
andrés	andrés
medieval	medyebal
tonumber	tonumber
cornelius	cornelius
tvxq	tvxq
brie	brie
robbie	robbie
sally	sally
zurich	zurich
jyp	jyp
mứt	jam
mứt	marmalade
patton	patton
drew	drew
bernhard	bernhard
hpa	hpa
benny	benny
hindenburg	hindenburg
smile	smile
smile	ngiti
attila	attila
tbilisi	tbilisi
vandel	vandel
rochester	rochester
rugby	rugby
kira	kira
kaoru	wada
marguerite	marguerite
navbox	navbox
laden	laden
laden	karga
benito	benito
aka	aka
ramesses	ramses
ramesses	ramesses
ngứa	pangangati
ngứa	makati
ngứa	kati
ngứa	itch
ngứa	kuko
rebecca	rebecca
satoshi	satoshi
stones	bato
panorama	panorama
schultz	schultz
prop	prop
trumpet	trumpeta
desc	desc
pot	pot
pot	palayok
heian	heian
patterson	patterson
sengoku	sengoku
obi	obi
alma	alma
bốt	bota
bốt	boots
haryana	haryana
hwan	hwan
homer	homer
weasley	weasley
myers	myers
kombat	kombat
fourier	fourier
hub	hub
tivi	telebisyon
argentine	argentine
benin	benin
intercontinental	intercontinental
aquino	aquino
tina	tina
saddam	saddam
mystery	misteryo
ruth	ruth
carolyn	carolyn
stall	pwesto
monde	monde
beetle	salagubang
picasso	picasso
bien	nakikita
bien	bien
bien	skies
hoffmann	hoffmann
heather	heather
geo	geo
sussex	sussex
joey	joey
silicon	silicon
silicon	silicone
isabel	isabel
damascus	damasco
batista	batista
highland	highland
avenue	avenue
avenue	abenida
alegre	alegre
aspx	aspx
toyotomi	toyotomi
anemia	anemia
schwarzenegger	schwarzenegger
una	una
niels	niels
fountain	fountain
fountain	balong
imp	imp
bandai	bandai
vaucluse	vaucluse
smackdown	smackdown
kalimantan	kalimantan
sinai	sinai
albus	albus
pmid	pmid
beckham	beckham
reyes	reyes
gin	gin
camille	camille
wendy	wendy
blackwell	blackwell
phoiac	phoiac
oxit	oxide
eteeq	eteeq
echo	echo
tbs	tbs
holiday	pista
holiday	holiday
ribera	ribera
chocolate	tsokolate
chocolate	chocolate
transistor	transistor
hemingway	hemingway
táp	kagat
spl	spl
psoe	psoe
capcom	capcom
viz	viz
hybrid	hybrid
gibbs	gibbs
canis	canis
battlefield	battlefield
pushkin	pushkin
neutrino	neutrino
elton	elton
fiat	fiat
herminia	herminia
circus	circus
subspecies	subspecies
montpellier	montpellier
atatürk	atatürk
dawson	dawson
ivoire	ivoire
stress	stress
sei	sei
tak	tak
pattern	pattern
greece	gresya
oliva	oliva
brain	utak
ferb	ferb
landmark	palatandaan
levant	levant
fragilis	fragilis
vila	vila
sapporo	sapporo
davao	davao
buchanan	buchanan
alive	buhay
rodriguez	rodriguez
comba	comba
cent	cent
lẻn	tumakas
sandy	sandy
fra	fra
cuốc	random
cuốc	sapalaran
ftp	ftp
desmond	desmond
terra	terra
tudor	tudor
neville	neville
novara	novara
pal	pal
champs	champs
charmed	charmed
ceylon	ceylon
menu	menu
menu	menu
kelvin	kelvin
korlević	korlević
sergio	sergio
hawking	hawking
pitt	pitt
trier	trier
quezon	quezon
nihon	nihon
medium	katamtaman
jakob	jakob
somali	somalia
somali	somali
shane	shane
cal	cal
cool	astig
cool	cool
hardcore	hardcore
sizedefault	sizedefault
waltz	balse
moreno	moreno
telegraph	telegraph
hcv	hcv
milk	gatas
milk	milk
daphne	daphne
jackie	jackie
livingston	livingston
eos	eos
thierry	thierry
rupestris	rupestris
serena	serena
graz	graz
malus	malus
haleakala	haleakala
flo	flo
mons	mons
quest	quest
zhuravleva	zhuravleva
kangaroo	kangaroo
chrome	chrome
douglass	douglass
ismail	ismail
irkutsk	irkutsk
isla	isla
debilis	debilis
alejandro	alejandro
friuli	friuli
lancashire	lancashire
albedo	albedo
cundinamarca	cundinamarca
infinite	infinite
castello	castello
myspace	myspace
buri	buri
saab	saab
zhao	zao
draco	draco
hale	hale
gloucester	gloucester
hamburger	hamburger
sarajevo	sarajevo
res	res
marvin	marvin
lift	angat
inn	inn
inn	otel
sonny	sonny
neill	neill
esp	esp
encyclopædia	encyclopædia
aguilar	aguilar
gore	madugong
gore	gore
hayashi	hayashi
fuscus	fuscus
sega	sega
donna	donna
halle	halle
ulrich	ulrich
checkuser	checkuser
gap	puwang
gap	gap
tirana	tirana
beaumont	beaumont
hàu	shells
hàu	talaba
erie	erie
ogg	ogg
ulsan	ulsan
frances	frances
adriatic	adriatic
viva	viva
cafe	kape
cafe	coffee
cafe	cafe
farm	bukid
kwang	kwang
vanilla	kulog
vanilla	banilya
vanilla	vanilla
société	société
extreme	grabe
extreme	grave
bilbao	bilbao
bun	bulgaro
bun	bun
auschwitz	auschwitz
multi	multi
newark	newark
isidro	isidro
woody	woody
fat	taba
fat	mataba
luffy	luffy
corleone	corleone
mẹo	tips
mẹo	tip
pegasus	pegasus
seymour	seymour
haw	haw
browne	browne
monogatari	monogatari
wilde	wilde
glycine	glycine
plato	plato
olympus	olympus
lex	lex
fukushima	fukushima
episodes	episodes
muñoz	muñoz
muñoz	munoz
herb	herb
ringo	ringo
nicola	nicola
burgundy	borgonya
mew	mew
minami	minami
bleach	bleach
stub	stub
avengers	avengers
weiss	weiss
rousseau	rousseau
mecca	meka
kamakura	kamakura
augsburg	augsburg
switch	switch
switch	lumipat
herald	herald
fide	fide
melanie	melanie
holloway	holloway
hume	hume
tama	tama
kar	kar
ngơ	binabalewala
muse	muse
spw	spw
chamberlain	chamberlain
kazakh	kazakh
bye	bye
cằm	baba
cằm	chin
pioneer	pioneer
paula	paula
imdb	imdb
toulon	toulon
romano	romano
wizard	wizard
selim	selim
yom	yom
damian	damian
hokage	hokage
haifa	haifa
cash	cash
sorbonne	sorbonne
lugo	lugo
runner	runner
teo	teo
villanueva	villanueva
twilight	twilight
kenji	kenji
hispaniola	hispaniola
entropy	entropy
sardegna	sardegna
nur	nur
voltaire	voltaire
nhăn	kulubot
robson	robson
mask	mask
mask	maskara
merton	merton
coa	coa
cluj	cluj
sinclair	sinclair
rojas	rojas
salmon	salmon
dahl	dahl
nhả	bitawan
nhả	ilabas
nhả	pakawalan
charlemagne	carlomagno
heathrow	heathrow
jenkins	jenkins
pack	pack
tbd	tbd
machado	machado
lions	lions
buckingham	palasyong
kitty	kitty
omer	omer
samara	samara
petersen	petersen
mona	mona
elsa	elsa
maritima	maritima
madeleine	madeleine
baba	baba
ost	ost
backstreet	backstreet
nagano	nagano
spielberg	spielberg
kana	kana
coventry	coventry
pbs	pbs
pau	pau
baek	baek
ararat	ararat
lhasa	lhasa
calvert	calvert
polymer	polimero
nolan	nolan
kom	kom
fitzgerald	fitzgerald
treviso	treviso
mama	mama
romeo	romeo
liguria	liguria
joyce	joyce
wai	wai
meet	matugunan
meet	kilalanin
meet	magkita
alexis	alexis
radiata	radiata
hajime	hajime
kin	kin
avenger	avenger
greenwich	greenwich
caserta	caserta
kinabalu	kinabalu
usaf	usaf
revue	revue
titus	titus
hayek	hayek
messenger	messenger
por	por
lagos	lagos
stream	batis
stream	daloy
petra	petra
palmas	palmas
jacobs	jacobs
sikorsky	sikorsky
ensign	ensign
nưa	anymore
niigata	niigata
carlsen	carlsen
achilles	achilles
phalanx	phalanx
gerard	gerrard
gerard	gerard
yerevan	yerevan
bergman	bergman
cast	cast
oran	oran
ortiz	ortiz
bogotá	bogotá
constance	constancia
guiana	guiana
boca	boca
nếm	lasa
nếm	natikman
nếm	pagsubok
ski	ski
guetta	guetta
dhaka	dhaka
seem	sem
amour	amour
amor	amor
zara	zara
richelieu	richelieu
cappadocia	cappadocia
michele	michele
swansea	swansea
guadalupe	guadalupe
españa	bulebar
mendoza	mendoza
judo	judo
gmt+	gmt+
myung	myung
tunis	tunis
nigel	nigel
sue	sue
garfield	garfield
aff	aff
hermes	hermes
alicia	alicia
registry	pagpapatala
eindhoven	eindhoven
archipelago	kapuluan
kakashi	kakashi
gogh	gogh
jedi	jedi
iglesias	iglesias
nirvana	nirvana
harley	harley
wanted	wanted
truong	truong
survivor	survivor
gauge	daambakal
gauge	sukatin
reno	reno
eleocharis	eleocharis
suu	suu
nháp	draft
roque	roque
chát	chat
lahore	lahore
melody	melody
comte	comte
sterling	sterling
chambers	chambers
mari	mari
sikh	sikh
sikh	pugong
humbert	humbert
vaux	vaux
ivy	ivy
judith	judith
constantius	constantius
shirley	shirley
nairobi	nairobi
lou	lou
advance	pauna
advance	advance
boulogne	boulogne
pulitzer	pulitzer
pocket	bulsa
akbar	akbar
sandra	sandra
krasnoyarsk	krasnoyarsk
buch	buch
elite	pili
elite	elite
interwiki	interwiki
angry	magalit
angry	galit
angry	nagagalit
lisboa	lisboa
cotton	bulak
cotton	cotton
stamford	stamford
faust	faust
klm	klm
kansai	kansai
marca	marca
mannheim	mannheim
everest	everest
nationale	nationale
ida	ida
berber	berber
atm	atm
deutsch	deutsch
cantor	cantor
dorset	dorset
dover	dover
tarsus	tarsus
suleiman	suleiman
bohr	bohr
lamb	lamb
lamb	cordero
noir	noir
brezhnev	brežnev
attenuata	attenuata
bray	bray
giỏ	bulsa
giỏ	basket
giỏ	baskets
sap	dagta
sap	sap
lauren	lauren
marta	marta
tạt	mustard
ars	ars
iana	iana
hana	hana
scipio	scipio
tristan	tristan
cascade	cascade
howe	howe
saunders	saunders
wyatt	wyatt
katherine	katherine
manitoba	manitoba
cật	kidney
almeida	almeida
eliot	eliot
tea	tsaa
tea	tsa
stern	stern
teddy	teddy
breaking	paglabag
breaking	breaking
othername	othername
alien	alien
raja	raja
raja	raha
lydia	lydia
fun	masaya
fun	katuwaan
kumamoto	kumamoto
jungle	gubat
jungle	jungle
lorenz	lorenz
bouches	bouches
hillary	hillary
clermont	clermont
dalton	dalton
gottfried	gottfried
genie	genie
mangan	manganese
byrne	byrne
lesser	lesser
bluetooth	bluetooth
compton	compton
mgm	mgm
brock	brock
msn	msn
schuster	schuster
fleming	fleming
topo	topo
eumenes	eumenes
snyder	snyder
glucose	glucose
credit	credit
carrie	carrie
axel	axel
daimyo	daimyo
corp	corp
punic	punic
molotov	molotov
novosibirsk	novosibirsk
galápagos	galápagos
frost	frost
bratislava	bratislava
utrecht	utrecht
herschel	herschel
wiltshire	wiltshire
endangered	endangered
lausanne	lausanne
jacqueline	jacqueline
café	cafe
café	cafe
café	café
norris	norris
freiburg	freiburg
sui	sui
amadeus	amadeus
gekko	gekko
nikita	nikita
giacomo	giacomo
reprinted	reprinted
dudley	dudley
davy	davy
magdalena	magdalene
magdalena	magdalena
arras	arras
tot	tot
điếc	bingi
lupus	lupus
subfamilia	subfamilia
xxi	xxi
occidental	occidental
concept	konsepto
archimedes	archimedes
neu	neu
casino	kasino
casino	casino
sami	sami
marilyn	marilyn
hyuk	hyuk
hyde	hyde
geisei	geisei
koyama	koyama
simone	simone
ulysses	ulysses
gifu	gifu
rệp	bugs
rệp	gumapang
sina	sina
bourg	bourg
tanganyika	tanganyika
sacramento	sacramento
genji	genji
lecco	lecco
wallis	wallis
hoét	thrush
jericho	jericho
thatcher	thatcher
byron	byron
vandal	vandal
khz	khz
faber	faber
ying	ying
zip	zip
toni	toni
moravia	morabya
tagawa	tagawa
fermat	fermat
surigao	surigao
alexios	alexios
wiener	wiener
colt	colt
danzig	danzig
clarence	clarence
watt	watt
watt	watts
yoko	yoko
livingstone	livingstone
caracas	caracas
ned	ned
bomb	bomba
sarkozy	sarkozy
jerzy	jerzy
gracile	gracile
koi	koi
pole	pole
pole	poste
judy	judy
astronomy	astronomiya
crassus	crassus
pom	pom
mầu	kulay
poker	poker
shaun	shaun
higgins	higgins
tal	tal
aya	aya
nevis	nevis
vẫy	kumakaway
germania	germania
dorothy	dorothy
mcmahon	mcmahon
hartley	hartley
epstein	epstein
safari	safari
atr	atr
bonnie	bonnie
zamboanga	zamboanga
som	som
campobasso	campobasso
gnome	gnome
gutenberg	gutenberg
guild	guild
guild	kapisanan
rumble	rumble
novo	novo
doubleday	doubleday
vita	vita
nantes	nantes
stay	mananatiling
stay	manatili
stay	manatiling
stay	stay
panthera	panthera
psyche	psyche
worms	bulate
stefano	stefano
tripura	tripura
enrico	enrico
mei	mei
gọt	pagbabalat
nháy	flash
nháy	kukurap
nháy	blink
alfredo	alfredo
dayton	dayton
takeo	takeo
vulcan	vulcan
superman	superman
champ	champ
kochi	kochi
aves	aves
perez	perez
jerome	jerome
pacifica	pacifica
gupta	gupta
nomen	nomen
trọc	kalbo
als	als
meiji	meiji
neal	neal
sạc	charger
sạc	singil
sạc	charge
imax	imax
fossil	fossil
bart	bart
rightarm	rightarm
karachi	karachi
suvarnabhumi	suvarnabhumi
commonwealth	commonwealth
bourne	bourne
esther	ester
esther	esther
leroy	leroy
laurence	laurence
callas	callas
dinamo	dinamo
lester	lester
carson	carson
ichi	ichi
mitterrand	mitterrand
doug	doug
aoi	aoi
arroyo	arroyo
alpine	alpine
henrik	henrik
geoffroy	geoffroy
sicily	sicilia
sicily	sicily
sicily	sicilian
cream	cream
grimm	grimm
antony	antonius
zack	zack
reeves	reeves
finn	finn
cassette	cassette
laplace	laplace
ufo	ufo
inuyasha	inuyasha
sioux	sioux
mendes	mendes
cristiano	cristiano
aberdeen	aberdeen
sprague	sprague
platinum	platinum
arad	arad
wikitable	wikitable
castelnau	castelnau
gfdl	gfdl
savoy	savoy
cyprus	cypress
bio	bio
kuban	kuban
fig	fig
electra	elektra
electra	electra
nervosa	nervosa
trip	trip
trip	biyahe
minimus	minimus
morocco	morocco
vít	birador
garde	garde
trois	trois
camden	camden
tara	tara
shia	shia
hittite	hittite
airplay	airplay
guthrie	guthrie
tap	contestant
penalty	parusa
sts	sts
jeolla	jeolla
pinyin	pinyin
brandon	brandon
hoover	hoover
rodney	rodney
foo	foo
sida	aids
sutton	sutton
zoom	zoom
flynn	flynn
gwangju	gwangju
negros	negros
frontalis	frontalis
lover	lover
honshu	honshū
kirov	kirov
tor	tor
tor	thor
capo	capo
rụi	dinurog
rụi	durog
orient	orient
hebrides	hebrides
romanov	romanov
lakes	lakes
suharto	suharto
natalia	natalia
miwa	miwa
capitata	capitata
salazar	salazar
diocletianus	diocleciano
annapolis	annapolis
abrams	abrams
giles	giles
magister	magister
warwick	warwick
whole	whole
whole	buo
whole	buong
aid	aid
aid	lunas
râm	lilim
râm	shade
milwaukee	milwaukee
edith	edith
noah	noe
noah	noah
canavese	canavese
caucasus	kaukasya
gillespie	gillespie
lynx	musang
lynx	lynx
ayuntamiento	ayuntamiento
app	app
presley	presley
brook	brook
vhs	vhs
troll	awitin
osiris	osiris
cassius	cassius
sora	sora
ethernet	ethernet
peso	piso
peso	pesos
peso	piso
hime	hime
fontainebleau	fontainebleau
perugia	perugia
keng	keng
isonzo	isonzo
muon	gustong
muon	gusto
muon	want
muon	nais
myeon	myeon
shock	shock
tutu	tutu
serviceyears	serviceyears
bend	bend
artiodactyla	artiodactyla
tchaikovsky	tchaikovsky
fusion	fusion
xoang	sinus
xoang	gilagid
kat	kat
königsberg	königsberg
vitex	vitex
coffee	kape
coffee	coffee
task	gawain
ger	ger
bak	bak
troia	troia
sulfat	sulfato
tobias	tobias
pla	pla
iroquois	iroquois
rivers	ilog
kew	kew
flemish	flemish
legion	legion
ala	ala
cctld	cctld
dash	dash
isis	isis
trek	trek
lowe	lowe
hikari	hikari
pizza	pizza
shikoku	shikoku
uchiha	uchiha
cobra	cobra
akatsuki	akatsuki
naraku	naraku
mindoro	mindoro
unicef	unicef
kissinger	kissinger
dee	dee
rsa	rsa
hockey	hockey
xỉn	lasing
bow	bow
sars	sars
vic	vic
nico	nico
fed	fed
fed	sawang
antoinette	antoinette
kuril	kuril
jardin	jardin
ramsay	ramsay
nizhny	nizhny
trevor	trevor
limburg	limburg
sherlock	sherlock
avatar	avatar
sinatra	sinatra
ivanov	ivanov
chhattisgarh	chhattisgarh
briggs	briggs
julio	julio
ricky	ricky
reader	reader
harald	harald
fortune	fortune
domodedovo	domodedovo
doo	doo
faraday	faraday
tate	tate
rand	rand
arborea	arborea
cristóbal	cristóbal
shinigami	shinigami
rubin	rubin
cana	cana
wiktionary	wiktionary
erebus	erebus
pteropus	pteropus
rowling	rowling
rapid	mabilisan
potosí	potosí
clyde	clyde
kiribati	kiribati
beverly	beverly
goodman	goodman
cowboy	cowboy
samantha	samantha
analog	analog
kei	kei
memoirs	memoirs
takashi	takashi
shih	shih
kerry	kerry
muller	muller
ramón	ramón
ramón	ramon
horst	horst
merry	maligayang
merry	merry
chirac	chirac
pagan	pagano
mendelssohn	mendelssohn
perseus	perseus
ria	ria
olivia	olivia
mem	mem
dodge	dodge
augustine	augustine
houghton	houghton
matsumoto	matsumoto
gangnam	gangnam
horizonte	horizonte
aruba	aruba
hawkins	hawkins
burt	burt
avignon	avignon
monarch	monarch
sala	sala
ashikaga	ashikaga
olive	olive
femme	femme
tuva	tuva
bowman	bowman
sqft	sqft
kitts	kits
kitts	kitts
magellan	magellanic
magellan	magellan
equus	equus
voyage	voyage
agnes	agnes
dốt	ignorante
calgary	calgary
inkigayo	inkigayo
jena	jena
thessaloniki	tesalonica
gol	gol
juno	juno
sumner	sumner
bock	bock
dalmatia	dalmatia
haydn	haydn
murad	murad
malik	malik
escape	makatakas
escape	escape
salon	salon
durban	durban
lama	lama
oswald	oswald
mara	mara
bikini	bikini
tomoya	tomoya
ita	ita
mika	mika
lia	lia
hegel	hegel
maggie	maggie
bua	bua
jürgen	jürgen
siết	yakap
visa	visa
tokusatsu	tokusatsu
francois	francois
francois	françois
button	button
duc	duc
köhler	köhler
alger	algae
gong	gong
natsu	natsu
subtemplates	subtemplates
pompey	pompey
gerd	gerd
pet	pet
pet	alaga
pet	katalinuhan
drum	tambol
drum	drum
daewoo	daewoo
martini	martini
clarkson	clarkson
manfred	manfred
amman	aman
nazi	fascist
nazi	nazi
mohr	mohr
jiménez	jiménez
brazilian	brazilian
khabarovsk	khabarovsk
creed	creed
atra	atra
freiherr	freiherr
modestus	modestus
ceres	ceres
lag	lag
trail	trail
bosco	bosco
shore	shore
shore	baybayin
lipid	lipid
yamagata	yamagata
kaze	kaze
prentice	prentice
zahn	zahn
hyo	hyo
billie	billie
chaos	nagkagulo
chaos	kaguluhan
umbrella	payong
candida	candida
karaoke	karaoke
oskar	oskar
takao	takao
ebert	ebert
textcolor	textcolor
aziz	aziz
vargas	vargas
pomerania	pomerania
ping	ping
feat	feat
marin	marin
nazareth	nazareno
nazareth	nazareth
plana	plana
abs	abs
keller	keller
boyle	boyle
nod	tumango
spot	spot
kuznetsov	kuznetsov
cctv	cctv
dar	dar
rocca	rocca
herodotus	herodotus
schumann	schumann
geun	geun
kyu	kyu
vidal	vidal
jaya	jaya
melissa	melissa
fujiko	fujiko
tar	tar
braunschweig	braunschweig
riemann	riemann
tribune	tribune
aden	aden
erectus	erectus
juliet	juliet
elias	elias
angus	angus
horus	horus
yui	yui
cas	cas
cas	cass
hamas	hamas
reinhard	reinhard
chevalier	chevalier
sakurai	sakurai
systematics	systematics
guillermo	guillermo
rutherford	rutherford
loc	loc
merriam	merriam
jansen	jansen
ensemble	ensemble
ishikawa	ishikawa
frozen	frozen
frozen	nagyeyelo
poincaré	poincaré
huron	huron
wadi	wadi
cunningham	cunningham
dyer	dyer
shawn	shawn
pieve	pieve
cauca	cauca
vogue	vogue
josephine	josephine
ilocos	ilocos
xíu	tiny
ilyich	ilyich
decatur	decatur
atlantis	atlantis
dewey	dewey
westmoreland	westmoreland
sulu	sulu
barbuda	barbuda
sepia	sepia
akita	akita
margarita	margarita
soto	soto
dreamworks	dreamworks
charter	charter
oliveira	oliveira
geoff	geoff
pamplona	pamplona
kyiv	kyiv
bark	bark
mêtan	methane
