doris	도리스	doris	도리스		
myth	신화	myth	신화		
moody	무디	moody	무디		
simmons	시몬스	simmons	시몬스		
observer	옵저버	observer	옵저버		
observer	관찰자	observer	관찰자		
observer	옵서버	observer	옵서버		
dolls	인형	dolls	인형	N	N
mitch	미치	mitch	미치		
akagi	아카기	akagi	아카기		
marks	마르크	marks	마르크		
marks	마크스	marks	마크스		
langley	랭글리	langley	랭글리		
astrakhan	아스트라한	astrakhan	아스트라한		
marty	마티	marty	마티		
nichols	니컬스	nichols	니컬스		
nichols	니콜스	nichols	니콜스		
void	무효	void	무효	N	N
daejeon	대전	daejeon	대전	N	N
daejeon	대전광역시	daejeon	대전광+역시	N	N
tuvalu	투발루의	tuvalu	투발루+의	N	N
sởi	홍역	sởi	홍역	N	N
torch	토치	torch	토치		
torch	횃불	torch	횃불		
panda	팬더	panda	팬더		
sếp	과장	sếp	과장	N	N
sếp	사장님	sếp	사장님	N	N
giầy	신발	giầy	신발	N	N
matthews	매튜스	matthews	매튜스		
plastic	성형	plastic	성형	N	N
magnitude	등급	magnitude	등급		
lies	거짓말	lies	거짓말		
apink	에이핑크	apink	에이핑크	N	N
travis	트레비스	travis	트레비스		
wise	지혜	wise	지혜		
kathy	캐시	kathy	캐시	N	N
hathaway	해서웨이	hathaway	해서웨+이		
burger	햄버거	burger	햄버거		
burger	버거	burger	버거		
deck	갑판	deck	갑판	N	N
holst	홀스트	holst	홀스트		
serial	직렬	serial	직렬	N	N
mos	모스	mos	모스		
bombardier	봄바디어	bombardier	봄바디어	N	N
guernsey	건지	guernsey	거+이+ㄴ지		
unity	통일	unity	통일	N	N
unity	단결	unity	단결	N	N
artemis	아르테미스	artemis	아르테미스		
bra	브라질	bra	브라질		
nộm	더미	nộm	더미	N	N
frankie	프랑키	frankie	프랑키		
frankie	프랭키	frankie	프랭키		
enter	입력합니다	enter	입력+하+ㅂ니다	V	V
enter	입력하기	enter	입력+하+기	V	V
bride	신부	bride	신부		
nikki	니키	nikki	니키		
survival	생존	survival	생존	N	N
sandwich	샌드위치	sandwich	샌드위치		
trend	추세	trend	추세	N	N
trend	경향	trend	경향	N	N
ole	ole	ole	ole		
forks	포크	forks	포크		
forks	포크스	forks	포크스		
views	견해	views	견해		
views	조회	views	조회		
shepherd	양치기	shepherd	양치+기		
shepherd	셰퍼드	shepherd	셰퍼드		
sale	세일	sale	세일		
khay	쟁반	khay	쟁반	N	N
scan	스캔	scan	스희+ㄴ		
muỗng	숟가락	muỗng	숟가락	N	N
muỗng	숟가락	muỗng	숟가락	N	N
muỗng	스푼	muỗng	스푼	N	N
comments	댓글	comments	댓글	N	N
boot	부트	boot	부트	N	N
boot	부츠	boot	부츠	N	N
boot	부팅	boot	부팅	N	N
wilbur	윌버	wilbur	윌버		
pls	pls	pls	pls		
oka	오카	oka	오카		
comet	혜성	comet	혜성	N	N
mải	영원한	mải	영원+하+ㄴ	V	V
mải	영원한	mải	영원+하+ㄴ	V	V
emerson	에머슨	emerson	에머슨		
closer	가까워	closer	가깝+어		
hói	대머리	hói	대머리	N	N
hói	대머리	hói	대머리	N	N
harding	하딩	harding	하딩		
hiroyuki	히로유키	hiroyuki	히로유키		
nhóc	키드	nhóc	키드		
sunny	써니	sunny	쓰+었+다		
sunny	맑음	sunny	맑음		
vase	꽃병	vase	꽃병	N	N
corvus	까마귀자리	corvus	까마넬리리		
corvus	까마귀	corvus	까마귀		
corvus	까마귀	corvus	까마귀		
hormon	호르몬	hormon	호르몬	N	N
hormon	호르몬	hormon	호르몬	N	N
celsius	섭씨	celsius	섭씨	N	N
patterns	패턴	patterns	패턴	N	N
imperator	임페라토르	imperator	임페라토르		
stamp	스탬프	stamp	스탬프		
poison	독도	poison	독도		
scorpion	스콜피온	scorpion	스콜피온		
horizon	지평선	horizon	지평선		
horizon	호라이즌	horizon	호라이즌		
blast	폭발	blast	폭발	N	N
welles	웰스	welles	웰스		
phết	쉼표	phết	쉼표	N	N
darkness	암흑	darkness	암흑		
methyl	메틸	methyl	메너+ㄴ	N	N
terminator	터미네이터	terminator	터미레이터		
parabellum	패러벨럼	parabellum	패러+처럼		
suzanne	수잰	suzanne	수잰		
cdo	cdo	cdo	cdo		
brent	브렌트	brent	브렌트		
ghibli	지브리	ghibli	지브리		
lbs	파운드	lbs	파운드		
wifi	와이파이	wifi	와이파이	N	N
gregor	그레고어	gregor	그레고어		
pony	포니	pony	포니		
supplement	보완	supplement	보완		
jpn	jpn	jpn	jpn		
fix	고치	fix	고치		
fix	고치기	fix	고치+기		
dexter	덱스터	dexter	덱스터		
theresa	테레사	theresa	테레사		
katrina	카트리나	katrina	카트리+나		
astro	아스트로	astro	아스트+로		
alison	앨리슨	alison	앨리슨		
hertz	허츠	hertz	허츠		
hertz	헤르츠	hertz	헤르츠		
dillon	딜런	dillon	디런		
spd	spd	spd	spd		
buddy	버디	buddy	버디		
twins	쌍둥이	twins	쌍둥이		
twins	트윈스	twins	트윈스		
woodward	우드워드	woodward	우드워드		
ripley	리플리	ripley	리플리		
véc	조각	véc	조각	N	N
ariana	아리아나	ariana	아리아나		
vnd	usd	vnd	usd		
vnd	미화	vnd	미화		
adi	아디	adi	아디		
trainer	트레이너	trainer	트레이너		
turks	터키인	turks	터키인	N	N
cad	cad	cad	cad		
colbert	콜베어	colbert	콜베어		
cinderella	신데렐라	cinderella	신데렐라		
galapagos	갈라파고스	galapagos	갈라파고스	N	N
sakamoto	사카모토	sakamoto	사카모토		
carnival	카니발	carnival	카니발	N	N
debian	데비안	debian	데비안	N	N
linus	linus	linus	linus		
linus	리노	linus	리노		
nadia	나디아	nadia	나디아		
pandora	판도라	pandora	판도+라		
astrid	아스트리드	astrid	아스트리드		
deluxe	디럭스	deluxe	디럭스		
dent	덴트	dent	덴트		
sitcom	시트콤	sitcom	시트콤	N	N
cynthia	신시아	cynthia	신시아		
mohs	모스	mohs	모스		
molise	몰리세	molise	몰리세		
kano	카누	kano	카누	N	N
topic	주제	topic	주제	N	N
plug	플러그	plug	플러그	N	N
arabian	아라비아어	arabian	아라비아어		
riverside	리버사이드	riverside	리버사이드		
kassel	카셀	kassel	카셀		
corona	코로나	corona	코로나		
terrestrial	지상	terrestrial	지상		
covers	커버	covers	커버		
bios	바이오스	bios	바이오스	N	N
supreme	슈프림	supreme	슈프림		
thirty	삼십	thirty	삼십		
thirty	서른	thirty	서른		
jessie	제시	jessie	제시	N	N
townsend	타운센드	townsend	타운센드		
ebay	이베이	ebay	이베이		
granger	그레인저	granger	그레이저		
hitomi	히토미	hitomi	히토미		
resident	레지던트	resident	레지던트		
resident	상주	resident	상주		
arias	아리아스	arias	아리아스		
mandarin	만다린	mandarin	만다리+ㄴ		
mandarin	중국어	mandarin	중국어		
gôn	골프	gôn	골프	N	N
eli	엘리	eli	엘리		
adaptation	적응	adaptation	적응	N	N
irina	이리나	irina	이리+나		
share	공유해	share	공유+하+어	V	V
share	공유하기	share	공유+하+기	V	V
rabin	라빈	rabin	라비+ㄴ		
hidro	수소	hidro	수소	N	N
bowling	볼링	bowling	볼링	N	N
weinberg	와인버그	weinberg	와인버그		
lamar	라마	lamar	라마		
estrogen	에스트로겐	estrogen	에스트+로게	N	N
duran	듀란	duran	듀라+ㄴ		
premium	프리미엄	premium	프리미엄		
lepus	산토끼	lepus	산토끼		
volkswagen	폭스바겐	volkswagen	폭스+바럽+ㄴ		
daisuke	다이스케	daisuke	다이스케		
capture	먹이	capture	먹이	N	N
vest	조끼	vest	조끼	N	N
chekhov	체호프	chekhov	체호프	N	N
passer	참새	passer	참새		
passer	스패로	passer	스패+로		
qualcomm	퀄컴	qualcomm	퀄컴	N	N
modem	모뎀	modem	모뎀	N	N
bridges	브리지스	bridges	브리지스		
bridges	다리	bridges	다리		
bridges	브리지	bridges	브리+지		
bridges	브릿지	bridges	브릿지		
woodrow	우드로	woodrow	우드+로		
tamura	타무라	tamura	타무라		
tamura	다무라	tamura	다무라		
ainu	아이누	ainu	아이누	N	N
ikeda	이케다	ikeda	이+하+ㄴ다		
morrow	모로	morrow	모+로		
miki	미키	miki	미키		
greer	그리어	greer	그리어		
audition	오디션	audition	오디션	N	N
hayden	헤이든	hayden	헤이든		
shelley	셸리	shelley	셸리		
kierkegaard	키르케고르	kierkegaard	키르케고르		
burgess	버지스	burgess	버지스		
flint	플린트	flint	플린트		
amos	아모스	amos	아모스		
otaku	오타쿠	otaku	오타쿠		
okada	오카다	okada	오카다		
katharine	캐서린	katharine	캐+서+이+ㄴ		
hydrogen	수소	hydrogen	수소	N	N
torpedo	어뢰	torpedo	어뢰	N	N
stephenson	스티븐슨	stephenson	스티븐슨		
bts	방탄소년단	bts	방탄+소년단	N	N
bts	방탄	bts	방탄	N	N
pico	피코	pico	피코		
adrien	아드리앵	adrien	아드리앵		
moro	모로	moro	모+로		
dual	듀얼	dual	듀+얼	N	N
toru	토루	toru	토루		
sonia	소니아	sonia	소니아		
candace	캔디스	candace	캔디스		
amir	아미르	amir	아미르		
mint	민트	mint	민트		
slim	슬림	slim	슬림		
duo	듀오	duo	듀오	N	N
reilly	라일리	reilly	라일리		
sae	sae	sae	sae		
valery	발레리	valery	발레리	N	N
dominion	자치령	dominion	자치령		
walls	성벽	walls	성벽		
sawyer	소이어	sawyer	소이어		
giants	자이언트	giants	자이언트		
sic	sic	sic	sic		
kendall	켄들	kendall	앙+들		
kendall	켄달	kendall	켄달		
metcalf	멧커프	metcalf	멧커프		
karin	카린	karin	카리+ㄴ		
blonde	금발	blonde	금발	N	N
dấm	식초	dấm	식초	N	N
nicholls	니컬스	nicholls	니컬스		
nimitz	니미츠	nimitz	니미츠		
sparks	스파크	sparks	스파크		
chevrolet	쉐보레	chevrolet	쉐보레	N	N
hiroki	히로키	hiroki	히로키		
aksu	아커쑤	aksu	아커쑤		
remy	도레미	remy	도레미		
delphi	델파이	delphi	델파+이		
kyoko	쿄코	kyoko	쿄코		
mall	쇼핑몰	mall	쇼핑몰	N	N
ddg	ddg	ddg	ddg		
nickel	니켈	nickel	니켈	N	N
cop	경찰	cop	경찰	N	N
marian	마리안	marian	마리안		
boxing	복싱	boxing	복싱	N	N
pil	알약	pil	알약	N	N
viper	독사	viper	독사		
cyber	사이버	cyber	사이버		
sid	시드	sid	시드		
eastwood	이스트우드	eastwood	이스트우드		
alzheimer	알츠하이머	alzheimer	알리하이터	N	N
misa	메사	misa	메사		
intro	소개	intro	소개	N	N
twist	트위스트	twist	트위스트		
tigers	타이거즈	tigers	타이거즈		
tigers	타이거스	tigers	타이거스		
tigers	호랑이	tigers	호랑이		
nicky	니키	nicky	니키		
commando	특공대	commando	특공대	N	N
wonderland	원더랜드	wonderland	원더랜드		
confessions	고백	confessions	고백	N	N
stanton	스탠턴	stanton	스탠턴		
lola	롤라	lola	롤라		
lip	입술	lip	입술	N	N
gladiator	검투사	gladiator	검투사	N	N
antique	골동품	antique	골동품	N	N
bayan	바얀	bayan	바쁘+ㄴ		
gent	헨트	gent	헨트		
lavender	라벤더	lavender	라벤더		
ravi	라비	ravi	라비		
jeep	지프	jeep	지프	N	N
hideki	히데키	hideki	히데키		
lap	무릎	lap	무릎		
combo	콤보	combo	콤보	N	N
rashid	라시드	rashid	라시드		
dulles	덜레스	dulles	덜레스		
misaki	미사키	misaki	미사키		
mystic	미스틱	mystic	미스틱		
weekend	주말	weekend	주말		
skype	스카이프	skype	스카이프	N	N
laptop	랩톱	laptop	랩톱	N	N
laptop	노트북	laptop	노트북	N	N
atom	아톰	atom	아톰		
ems	ems	ems	ems		
jetstar	제트스타	jetstar	제트스타	N	N
transformers	트랜스포머	transformers	트랜스포머	N	N
mckenzie	매켄지	mckenzie	매앙지		
layla	라일라	layla	라일라		
pusan	부산	pusan	부산		
coupe	쿠페	coupe	쿠페	N	N
weston	웨스턴	weston	웨스턴		
riviera	리비에라	riviera	리비+에+라		
hydra	히드라	hydra	히드라		
assault	폭행	assault	폭행	N	N
assault	공격	assault	공격	N	N
gina	지나	gina	지나+아		
steyr	슈타이어	steyr	슈타+이+어		
gregg	그레그	gregg	그레그		
origami	종이접기	origami	종이+접기	N	N
strings	문자열	strings	문자열	N	N
granite	화강암	granite	화강암	N	N
scouts	스카우트	scouts	스카우트		
vaccine	백신	vaccine	백신	N	N
ecstasy	엑스터시	ecstasy	엑스터시		
hashimoto	하시모토	hashimoto	하시모토		
afp	afp	afp	afp		
creole	크리올	creole	크리오+ㄹ		
kinshasa	킨샤사	kinshasa	킨샤사		
pier	부두	pier	부두		
cats	고양이	cats	고양+이		
fractions	분수	fractions	분수		
dau	두꺼비	dau	두꺼비		
activision	액티비전	activision	액티비전		
slayer	슬레이어	slayer	슬레이어		
bỉm	기저귀	bỉm	기저귀	N	N
daly	데일리	daly	데일리		
ingram	잉그램	ingram	잉그램		
audi	아우디	audi	아우디	N	N
tvn	tvn	tvn	tvn		
sumo	스모	sumo	스모	N	N
athletics	육상	athletics	육상	N	N
exile	망명	exile	망명	N	N
wheel	바퀴	wheel	바퀴	N	N
yusuke	유스케	yusuke	유스케		
dickens	디킨스	dickens	디킨스		
magie	마그네슘	magie	마그네슘	N	N
ezra	에즈라	ezra	에즈라		
gibbon	긴팔원숭이	gibbon	긴팔+원인+이	N	N
spiral	나선	spiral	나서+ㄴ		
spiral	나선형	spiral	나선형		
matilda	마틸다	matilda	마틸+ㄴ다		
goldwyn	골드윈	goldwyn	골드윈		
grimes	그라임스	grimes	그라임스		
cossack	카자크	cossack	카자크	N	N
tời	응답	tời	응답	N	N
tời	정답	tời	정답	N	N
tời	대답	tời	대답	N	N
tời	답변	tời	답변	N	N
playoff	플레이오프	playoff	플레이오프		
mortimer	모티머	mortimer	모티머		
cgi	cgi	cgi	cgi		
emir	아미르	emir	아미르		
emir	에미르	emir	에미르		
sketch	스케치	sketch	스케치	N	N
unique	고유	unique	고유		
halley	핼리	halley	핼리		
ventura	벤츄라	ventura	벤찌라		
enchanted	매혹	enchanted	매혹		
vir	vor	vir	vor		
oxide	산화물	oxide	산화물	N	N
oxide	산화	oxide	산화	N	N
benghazi	벵가지	benghazi	이가+지		
azuma	아즈마	azuma	아즈마		
bud	버드	bud	버드		
nate	네이트	nate	네이트		
outlook	아웃룩	outlook	아웃룩	N	N
petrie	페트리	petrie	페트리		
thori	토륨	thori	토륨	N	N
hirst	허스트	hirst	허스트		
denise	데니스	denise	데니스		
hideo	히데오	hideo	히데오		
buckley	버클리	buckley	버클리		
rương	트렁크	rương	트렁크	N	N
đít	엉덩이	đít	엉덩이		
đít	엉덩이	đít	엉덩이		
anonymous	익명	anonymous	익명		
pap	pap	pap	pap		
peach	복숭아	peach	복숭아		
peach	피치	peach	피치		
takagi	다카기	takagi	다카기		
takagi	타카기	takagi	타카기		
gerry	제리	gerry	제리		
arkham	아캄	arkham	아캄		
daryl	대릴	daryl	대리+ㄹ		
kellogg	켈로그	kellogg	켈로그		
paine	페인	paine	페인		
grunge	그런지	grunge	그렇+ㄴ지		
ritchie	리치	ritchie	리치		
grozny	그로즈니	grozny	그로즈니		
cygnus	백조자리	cygnus	백조+자리	N	N
agricola	아그리콜라	agricola	아그리콜라		
scots	스코트어	scots	스코트어		
catfish	메기	catfish	메기	N	N
gandalf	간달프	gandalf	간달프		
armani	아르마니	armani	아르마니		
alley	골목길	alley	골목길		
alley	앨리	alley	앨리		
jets	제트	jets	제트	N	N
jets	제트기	jets	제트기	N	N
slater	슬레이터	slater	슬레이터		
dyson	다이슨	dyson	다이슨		
ass	조수	ass	조수		
uranus	천왕성	uranus	천왕성	N	N
nệm	매트리스	nệm	매트리스	N	N
nệm	매트리스	nệm	매트리스	N	N
sco	sco	sco	sco		
ota	ota	ota	ota		
crowley	크롤리	crowley	크롤리		
dầy	두껍게	dầy	두껍+게	ADJ	ADJ
dầy	두꺼운	dầy	두껍+ㄴ	ADJ	ADJ
lala	lala	lala	lala		
mango	망고	mango	망고		
trafalgar	트라팔가르	trafalgar	트라팔가르		
trafalgar	트라팔가	trafalgar	트라팔+가		
imo	imo	imo	imo		
orwell	오웰	orwell	오웰		
brody	브로디	brody	브로디		
ferris	페리스	ferris	페리스		
araki	아라키	araki	아라키		
polaris	폴라리스	polaris	폴라리스		
punch	펀치	punch	펀치		
watchmen	왓치맨	watchmen	증치맨		
wow	우와	wow	우+와		
wow	와우	wow	와우		
ces	ces	ces	ces		
tachi	다치	tachi	다치		
gbu	gbu	gbu	gbu		
raytheon	레이시온	raytheon	레이시온		
raid	습격	raid	습격	N	N
dupont	듀폰	dupont	듀폰	N	N
cisco	시스코	cisco	시스코	N	N
curry	커리	curry	커리		
curry	카레	curry	카레		
muslim	이슬람교	muslim	이슬람교	N	N
muslim	무슬림	muslim	무슬림	N	N
erika	에리카	erika	에리카		
zoe	조이	zoe	종이		
collin	콜린	collin	콜린		
toshi	토시로	toshi	토시+로		
toshi	토시	toshi	토시		
elaine	일레인	elaine	일레인		
essen	에센	essen	에세+ㄴ		
ssn	ssn	ssn	ssn		
scala	스칼라	scala	스칼라		
cassandra	카산드라	cassandra	카산드+라		
clone	클론	clone	클론	N	N
amoni	암모늄	amoni	암모늄	N	N
telenovela	텔레노벨라	telenovela	텔레노벨+라		
ryazan	랴잔	ryazan	랴잔		
maverick	매버릭	maverick	매버릭		
graphic	그래픽	graphic	그래픽		
defender	수비수	defender	수비수	N	N
ans	ans	ans	ans		
tori	토리	tori	토리		
predator	프레데터	predator	프레데터		
kherson	헤르손	kherson	헤르손		
firmware	펌웨어	firmware	증웨어	N	N
daigo	다이고	daigo	다이+고		
socket	소켓	socket	소켓	N	N
socket	소켓	socket	소켓	N	N
ott	오트	ott	오트		
sibir	시베리아	sibir	시베리아		
guayaquil	과야킬	guayaquil	과야+하+ㄹ		
upc	upc	upc	upc		
cedric	세드릭	cedric	세드릭		
leonidas	레오니다스	leonidas	레오니다스		
hemoglobin	헤모글로빈	hemoglobin	헤모트로+이+ㄴ	N	N
collar	칼라	collar	칼+라		
collar	쇄골	collar	쇄골		
valerie	밸러리	valerie	밸러리		
masamune	마사무네	masamune	마사무네		
nasdaq	나스닥	nasdaq	나스닥	N	N
cato	카토	cato	카토		
cato	케이토	cato	케이토		
garage	주차장	garage	주차장	N	N
murata	무라타	murata	무라타		
kaori	카오리	kaori	카오리		
dove	비둘기	dove	비둘기		
nwa	nwa	nwa	nwa		
colón	콜론	colón	콜론		
gorge	계곡	gorge	계곡		
clearwater	클리어워터	clearwater	클리어워터		
galactic	은하	galactic	은하	N	N
łódź	우치	łódź	우치		
doping	도핑	doping	도핑	N	N
oxygen	산소	oxygen	산소	N	N
gwen	그웬	gwen	그웬		
carole	캐롤	carole	캐롤		
monk	몽크	monk	몽크		
fai	fai	fai	fai		
reconnaissance	정찰	reconnaissance	정찰	N	N
goldberg	골드버그	goldberg	골드버그		
blaine	블레인	blaine	블레인		
dlc	dlc	dlc	dlc		
eliza	엘리자	eliza	엘리자		
salomon	솔로몬	salomon	솔로몬		
valentina	발렌티노	valentina	발렌티노		
superstar	슈퍼스타	superstar	슈퍼+스타	N	N
antarctic	남극	antarctic	남극	N	N
foreground	전경	foreground	전경	N	N
taro	타로	taro	타+로		
jacket	자켓	jacket	자켓	N	N
sentinel	센티넬	sentinel	센티넬		
sentinel	센티널	sentinel	센티널		
aizu	아이즈	aizu	아이즈		
gracie	그레이시	gracie	그레이시		
massage	안마	massage	안마	N	N
massage	안마	massage	안마	N	N
camel	카멜	camel	카멜		
ronan	로넌	ronan	로쁘+ㄴ		
kimberley	킴벌리	kimberley	킴벌리		
owens	오언스	owens	오언스		
colonia	콜로니아	colonia	콜로니아		
gulfstream	걸프스트림	gulfstream	걸프스트림		
nikon	니콘	nikon	니콘	N	N
priestley	프리스틀리	priestley	프리스틀리		
percussion	타악기	percussion	타악기	N	N
prada	프라다	prada	프라+이+다		
siberian	시베리아	siberian	시베리아		
downs	다운	downs	다우+ㄴ		
downs	다운스	downs	다운스		
ariadne	아리아드네	ariadne	아리아드네		
conti	콘티	conti	콘티		
receptor	수용체	receptor	수용체	N	N
serre	세르	serre	세르		
lolita	롤리타	lolita	롤리타		
lolita	로리타	lolita	로리타		
gangster	깡패	gangster	깡패		
gangster	갱스터	gangster	갱스터		
marengo	마렝고	marengo	마렝고		
vance	밴스	vance	밴스		
dap	dap	dap	dap		
bed	침대	bed	침대	N	N
lithium	리튬	lithium	리튬	N	N
nakahara	나카하라	nakahara	나카하+라		
burbank	버뱅크	burbank	버뱅크		
shining	빛나	shining	빛나+아		
seventeen	열일곱	seventeen	열일곱		
seventeen	세븐틴	seventeen	세븐틴		
winning	우승	winning	우승	N	N
winning	승리	winning	승리	N	N
saki	사키	saki	사키		
asakura	아사쿠라	asakura	아사쿠라		
birch	자작나무	birch	자작나무		
reaper	리퍼	reaper	리퍼		
alaric	알라리크	alaric	알라리크		
kari	캐리	kari	캐리		
foods	음식	foods	음식	N	N
foods	식품	foods	식품	N	N
dreamcast	드림캐스트	dreamcast	드림캐스트		
mckay	매케이	mckay	매케+이		
dönitz	되니츠	dönitz	되+다니		
miriam	미리엄	miriam	미리엄		
miriam	미리암	miriam	미리암		
masaki	마사키	masaki	마사키		
chick	병아리	chick	병+아리		
nvidia	엔비디아	nvidia	엔비디아	N	N
hound	하운드	hound	하운드		
dorian	도리안	dorian	도리안		
maureen	모린	maureen	모리+ㄴ		
kingsley	킹슬리	kingsley	킹슬리		
kingsley	킹즐리	kingsley	킹즐리		
sia	sia	sia	sia		
aqua	아쿠아	aqua	아쿠아		
kimberly	킴벌리	kimberly	킴벌리		
cookie	쿠키	cookie	쿠키	N	N
cookie	쿠키	cookie	쿠키	N	N
nih	nih	nih	nih		
router	라우터	router	라우터	N	N
atmosphere	분위기	atmosphere	분위기		
ticket	버니	ticket	버니		
dancer	댄서	dancer	대+서	N	N
beckett	베켓	beckett	베켓		
jubilee	주빌리	jubilee	주빌리		
goodwin	굿윈	goodwin	B뚜		
gaming	게이밍	gaming	게이밍		
vintage	빈티지	vintage	빈티지		
sabbath	안식일	sabbath	안식+이+ㄹ		
cary	캐리	cary	캐리		
hani	하니	hani	하+니		
ust	ust	ust	ust		
bound	바운드	bound	바운드		
minamata	미나마타	minamata	미나마타		
metropolis	메트로폴리스	metropolis	메트로폴리스		
dreamgirls	드림걸즈	dreamgirls	드림걸즈		
glaucidium	부엉이	glaucidium	부엉+이		
arai	아라이	arai	아라이		
sera	세라	sera	세라		
orchard	과수원	orchard	과수원	N	N
majestic	마제스틱	majestic	마제스틱		
marble	대리석	marble	대리석	N	N
lounge	라운지	lounge	라운지		
guardiola	과르디올라	guardiola	과르디르+라		
holocene	홀로세	holocene	홀로세		
sole	발바닥	sole	발바닥		
drury	드루리	drury	드루리		
utf	utf	utf	utf		
gút	매듭	gút	매듭	N	N
bachelor	총각	bachelor	총각		
sharma	샤르마	sharma	샤르마		
toshio	토시오	toshio	토시오		
peptide	펩타이드	peptide	펩타이드	N	N
vivian	비비언	vivian	비비언		
vivian	비비안	vivian	비비안		
glover	글로버	glover	글로버		
yuka	히라타	yuka	히라타		
akiko	아키코	akiko	아키코		
espresso	에스프레소	espresso	에스프레소		
helios	헬리오스	helios	헬리오스		
schmitt	슈미트	schmitt	슈미트		
opus	오푸스	opus	오푸스		
aron	아론	aron	아론		
ghosts	귀신	ghosts	귀신		
chipset	칩셋	chipset	칩셋	N	N
salamis	살라미스	salamis	살라미스		
asano	아사노	asano	아사노		
graffiti	낙서	graffiti	낙서	N	N
patti	패티	patti	패티		
odense	오덴세	odense	오덴세		
shelter	쉼터	shelter	쉼터		
temp	온도	temp	온도	N	N
otis	오티스	otis	오티스		
stuff	물건	stuff	물건		
coding	부호화	coding	부호화	N	N
courier	택배	courier	택배	N	N
ghoul	구울	ghoul	구울		
cathy	캐시	cathy	캐시	N	N
barre	바레	barre	바레		
lombardi	롬바르디	lombardi	롬바르디		
liza	리자	liza	리자		
hok	hok	hok	hok		
cutler	커틀러	cutler	크틀러		
cốp	트렁크	cốp	트렁크	N	N
hussain	후세인	hussain	후세+이+ㄴ	N	N
macy	메이시	macy	메이시		
macy	macy	macy	macy		
nxt	nxt	nxt	nxt		
lollipop	롤리팝	lollipop	롤리팝		
spell	철자	spell	철자	N	N
brick	벽돌	brick	벽돌	N	N
miracles	기적	miracles	기적		
rosetta	로제타	rosetta	로제타		
rear	후방	rear	후방	N	N
amundsen	아문센	amundsen	아문물		
haines	헤인스	haines	헤인스		
turkmen	투르크멘어	turkmen	투르크멘어		
