paz	paz	paz	paz		
dante	dante	dante	dant		
pilosa	pilosa	pilosa	pilos		
gérard	gérard	gérard	gürar		
gérard	gerard	gérard	gerar		
moy	moy	moy	moy		
rolls	rulo	rolls	rulo		
rolls	rolls	rolls	rolls		
bauhinia	bauhinia	bauhinia	bauh	N	N;NOM;SG;3
ekman	ekman	ekman	ekman		
bari	bari	bari	bari		
guillaumin	guillaumin	guillaumin	guillam	N	N;GEN;SG;3
sturm	sturm	sturm	stur		
taekwondo	taekwondo	taekwondo	taekwondo	N	N;NOM;SG;3
patricia	patricia	patricia	patricia		
eduard	eduard	eduard	eduar		
ranger	ranger	ranger	ranger		
ranger	korucu	ranger	korucu		
yard	yard	yard	yard		
konstantinos	constantine	konstantinos	constant	N	N;DAT;SG;3
rufus	rufus	rufus	rufus		
dynamo	dinamo	dynamo	dinamo	N	N;NOM;SG;3
hon	sevgili	hon	sevgili		
sứa	denizanası	sứa	denizana	N	N;NOM;SG;3
rabaul	rabaul	rabaul	rabaul		
plain	sade	plain	sade		
plain	düz	plain	düz		
plain	apaçık	plain	apaçık		
plain	yalın	plain	yalın		
rán	kızartma	rán	kızar	N	N;NOM;PL;3
rán	kızartma	rán	kızar	N	N;NOM;PL;3
maxon	maxon	maxon	maxon		
endl	endl	endl	endl		
capparis	capparis	capparis	capparis		
andaman	andaman	andaman	andam	N	N;NOM;SG;3
dam	barajı	dam	barajı	N	N;NOM;SG;3
lori	lori	lori	None		
canyon	kanyon	canyon	kanyon	N	N;NOM;SG;3
canyon	canyon	canyon	canyon	N	N;NOM;SG;3
canyon	kanyonu	canyon	kanyon	N	N;ACC;SG;3
dominique	dominique	dominique	domin		
garnier	garnier	garnier	garnier		
ultimate	nihai	ultimate	nihai		
gleason	gleason	gleason	gleason		
crimean	kırım	crimean	kırım		
uta	uta	uta	uta		
fleet	filosu	fleet	filo	N	N;NOM;SG;3
tours	turlar	tours	tur	N	N;NOM;PL;3
tours	turları	tours	tur	N	N;ACC;PL;3
canadensis	canadensis	canadensis	canadensis	N	N;NOM;SG;3
sharon	sharon	sharon	sharon		
suite	suit	suite	suit		
woodson	woodson	woodson	ooo		
aurea	aurea	aurea	aurea		
mirror	ayna	mirror	ayna		
aristotle	aristo	aristotle	aristo		
xxx	xxx	xxx	xxx		
reef	resif	reef	resif	N	N;NOM;SG;3
spectabilis	spectabilis	spectabilis	spectabilis		
malcolm	malcolm	malcolm	malcolm		
joker	joker	joker	joker		
joker	şakacı	joker	şakacı		
yves	yves	yves	yves		
juss	juss	juss	juss		
japonicus	japonicus	japonicus	japonicus	N	N;ACC;SG;3
tanikawa	tanikawa	tanikawa	tanikawa		
nhấp	tıklama	nhấp	tıkla	V	V;PFV;NOM;IND;POS;PRS;V.MSDR
nhấp	tıklayın	nhấp	tıkla	V	V;PFV;IMP;PL;2;POS;PRS
chronicle	chronicle	chronicle	chronic		
pumila	pumila	pumila	pumila		
antilles	antilleri	antilles	antil	N	N;NOM;PL;3
ekaterina	ekaterina	ekaterina	ekater	N	N;DAT;SG;3
shark	köpekbalığı	shark	köpekbalık	N	N;NOM;SG;3
messina	messina	messina	messina	N	N;DAT;SG;3
infraclassis	infraclassis	infraclassis	infraclassis		
sếu	vinç	sếu	vinç	N	N;NOM;SG;3
sếu	vinç	sếu	vinç	N	N;NOM;SG;3
metallica	metallica	metallica	metallica	N	N;NOM;SG;3
ramírez	ramirez	ramírez	ramirez		
scorea	scorea	scorea	scor		
altlink	altlink	altlink	altlink		
picta	picta	picta	picta		
verdun	verdun	verdun	ver	N	N;NOM;SG;3
macau	macau	macau	macau	N	N;NOM;SG;3
hare	hare	hare	hare		
hare	tavşan	hare	tavşan		
tristis	tristis	tristis	tristis		
emirates	emirlikleri	emirates	emirlik	N	N;ACC;PL;3
sum	toplam	sum	toplam		
sum	sum	sum	sum		
sum	toplamı	sum	toplam		
valenciennes	valenciennes	valenciennes	valenciennes	N	N;DAT;SG;3
lives	yaşar	lives	yaşa		
agm	agm	agm	agm		
cecil	cecil	cecil	cecil		
besançon	besançon	besançon	besançon		
javascript	javascript	javascript	javascript	N	N;NOM;SG;3
adventures	macera	adventures	macera		
origins	köken	origins	kök		
orléans	orléans	orléans	orléans		
lutea	lutea	lutea	lutea		
btr	btr	btr	btr		
leslie	leslie	leslie	lesli		
kirby	kirby	kirby	kirby		
messerschmitt	messerschmitt	messerschmitt	messerschmitt	N	N;NOM;SG;3
esp}}	esp}}	esp}}	esp}}		
banner	yolları	banner	yol	N	N;NOM;PL;3
banner	yollar	banner	yol	N	N;NOM;PL;3
seth	seth	seth	seth		
mega	mega	mega	mega		
claire	claire	claire	claire		
africanus	africanus	africanus	africanus	N	N;ACC;SG;3
tribus	tribus	tribus	tribus		
makoto	makoto	makoto	makoto		
dubia	dubia	dubia	dubia		
empires	imparatorluklar	empires	imparatorluk	N	N;NOM;PL;3
ark	ark	ark	ark		
marsh	bataklık	marsh	bataklık	N	N;NOM;SG;3
gómez	gómez	gómez	gómez	V	V;IPFV;IND;SG;3;NEG
leach	leach	leach	leach		
olga	olga	olga	olga		
carnegie	carnegie	carnegie	carnegie		
rod	rod	rod	rod		
rod	çubuk	rod	çubuk		
hermione	hermione	hermione	hermion		
earl	earl	earl	earl		
earl	reis	earl	reis		
demetrios	demetrius	demetrios	demetrius	N	N;NOM;SG;3
amber	amber	amber	amber		
kenny	kenny	kenny	kenny		
pallidus	pallidus	pallidus	pallidus		
tracy	tracy	tracy	tracy		
grenada	grenada	grenada	grena	N	N;ESS;SG;3
toei	toei	toei	toe		
stella	stella	stella	stel		
car	araba	car	araba		
car	araç	car	araç		
elliot	elliot	elliot	elliot		
pasteur	pasteur	pasteur	paste		
mat	yemekler	mat	yemek	N	N;NOM;PL;3
mat	yemek	mat	yemek	N	N;NOM;SG;3
pounder	pounder	pounder	pounder	N	N;NOM;SG;3
gsub	gsub	gsub	gsub		
yuki	yuki	yuki	yuki		
namedata	namedata	namedata	namedat	N	N;ESS;SG;3
blackwall	blackwall	blackwall	blackoll		
quýt	mandalina	quýt	mandal	N	N;DAT;SG;3
eve	havva	eve	havva		
node	düğümü	node	düğüm	N	N;ACC;SG;3
hacker	hacker	hacker	hacker		
hacker	hacker	hacker	hacker		
hacker	hack	hacker	hack		
ruby	ruby	ruby	ruby		
ruby	yakut	ruby	yakut		
selena	selena	selena	selena		
comoros	komorlar	comoros	komor	N	N;NOM;PL;3
xavier	xavier	xavier	xavier		
candy	şeker	candy	şeker		
candy	seker	candy	sek		
candy	candy	candy	candy		
griffin	griffin	griffin	griffin		
menzies	menzies	menzies	menzies		
khuấy	karıştırılmış	khuấy	karış	V	V;PFV;NFH;IND;POS;PST;PASS
khuấy	karıştırın	khuấy	karış	V	V;PFV;IMP;PL;2;POS;PRS;CAUS
boa	boa	boa	boa		
cube	küp	cube	küp		
resort	resort	resort	resort	N	N;NOM;SG;3
benz	benz	benz	benz		
göring	goering	göring	goering		
göring	göring	göring	göring		
quinn	quinn	quinn	quinn		
bmw	bmw	bmw	bmw	N	N;NOM;SG;3
irene	irene	irene	iren		
cartoon	karikatür	cartoon	karikat		
cartoon	çizgi	cartoon	çizgi		
scheer	scheer	scheer	sche		
carr	carr	carr	carr		
betty	betty	betty	bet		
wilkinson	wilkinson	wilkinson	wilkinson		
chihuahua	chihuahua	chihuahua	chihuah	N	N;NOM;SG;3
bath	banyo	bath	banyo		
gien	genler	gien	gen	N	N;NOM;PL;3
hormone	hormonlar	hormone	hormon	N	N;NOM;PL;3
lens	lens	lens	lens		
lens	objektif	lens	objektif		
lens	mercek	lens	mercek		
lens	sızıntı	lens	sızıntı		
lafayette	lafayette	lafayette	lafayet	N	N;ESS;SG;3
luigi	luigi	luigi	luigi		
polygonum	polygonum	polygonum	polygon		
reo	çalıyor	reo	çal	V	V;PROG;IND;SG;3;POS;INFM;PRS
lexikon	lexikon	lexikon	lexikon		
lindsey	lindsey	lindsey	lindsey		
direct	direk	direct	direk		
direct	direkt	direct	direkt		
direct	doğrudan	direct	doğrudan		
craven	craven	craven	craven		
diane	diane	diane	diane		
rivière	rivière	rivière	rivière		
sugar	şeker	sugar	şeker		
sugar	şekerli	sugar	şekerli		
sugar	seker	sugar	sek		
doc	doc	doc	doc		
doc	doktor	doc	doktor		
schalke	schalke	schalke	schalke	N	N;NOM;SG;3
turing	turing	turing	turing		
kyle	kyle	kyle	kyle		
dale	dale	dale	dale		
gloria	gloria	gloria	gloria		
shannon	shannon	shannon	shan		
summit	zirvede	summit	zirve	N	N;ESS;SG;3
summit	zirvesi	summit	zirve	N	N;NOM;SG;3
martinique	martinique	martinique	martiniğu	N	N;NOM;SG;3
wilcox	wilcox	wilcox	wilcox		
obscurus	obscurus	obscurus	obscurus		
saxophone	saksafon	saxophone	saksafon	N	N;NOM;SG;3
friedman	friedman	friedman	friedman		
vanessa	vanessa	vanessa	vanessa		
schwartz	schwartz	schwartz	schwartz		
neptune	neptune	neptune	nept	N	N;DAT;SG;3
jupiter	jüpiter	jupiter	jüpiter	N	N;NOM;SG;3
velvet	kadife	velvet	kadife		
mia	mia	mia	mia		
lara	lara	lara	None		
proxy	proxy	proxy	proxy	N	N;NOM;SG;3
robustus	robustus	robustus	robustus		
shepard	shepard	shepard	shepard		
lil	lil	lil	lil		
